,Player_ID,Year,TeamA,TeamB,Serve_Points,Serve_Errors,Serve_Attempts,Total_Serves,Match_Date,Set_Successes,Set_Errors,Set_Attempts,Total_Sets,Attack_Success,Attack Errors,Attack_Attempts,Total_Attacks,Block_Successful,Block_Errors,Block_Rebounds,Total_Blocks,Reception_Successful,Reception_Errors,Reception_Attemps,Total_Receptions,Dig_Success,Dig_Errors,Dig_Attempts,Total_Digs
0,160209,2021,Belgium,Canada,1,1,2,4,20/06/2021,2,0,10,12,0,0,0,0,1,0,1,2,0,0,0,0,1,0,1,2
1,160209,2021,Belgium,Italy,0,0,0,0,19/06/2021,0,0,0,0,0,0,0,0,0,0,0,0,0,0,0,0,0,0,0,0
2,160209,2021,Thailand,Belgium,0,0,0,0,18/06/2021,0,0,2,2,0,0,0,0,0,0,0,0,0,0,0,0,0,0,0,0
3,160209,2021,Belgium,Japan,0,0,0,0,14/06/2021,0,0,0,0,0,0,0,0,0,0,0,0,0,0,0,0,0,0,0,0
4,160209,2021,Türkiye,Belgium,0,0,0,0,13/06/2021,0,0,0,0,0,0,0,0,0,0,0,0,0,0,0,0,0,0,0,0
5,160209,2021,USA,Belgium,0,0,0,0,12/06/2021,1,0,2,3,0,0,0,0,0,0,0,0,0,0,0,0,0,0,0,0
6,160209,2021,Belgium,Serbia,0,0,0,0,08/06/2021,1,0,6,7,0,0,0,0,0,0,0,0,0,0,0,0,0,0,0,0
7,160209,2021,Belgium,Brazil,0,1,2,3,07/06/2021,3,0,20,23,0,0,0,0,0,0,1,1,0,0,0,0,0,1,0,1
8,160209,2021,China,Belgium,0,0,6,6,06/06/2021,4,0,12,16,0,0,0,0,2,0,0,2,0,0,0,0,0,1,0,1
9,160209,2021,Belgium,Poland,0,0,0,0,01/06/2021,0,0,0,0,0,0,0,0,0,0,0,0,0,0,0,0,0,0,0,0
10,160209,2021,Germany,Belgium,0,0,0,0,27/05/2021,0,0,1,1,0,0,1,1,0,0,0,0,0,0,0,0,0,0,0,0
11,160209,2021,Netherlands,Belgium,0,0,0,0,25/05/2021,0,0,0,0,0,0,0,0,0,0,0,0,0,0,0,0,0,0,0,0
12,152042,2021,Belgium,Canada,3,3,8,14,20/06/2021,0,0,2,2,23,3,17,43,0,4,1,5,2,0,10,12,14,1,0,15
13,152042,2021,Belgium,Italy,0,1,12,13,19/06/2021,0,0,1,1,33,10,24,67,1,4,1,6,6,0,11,17,4,1,1,6
14,152042,2021,Thailand,Belgium,1,3,11,15,18/06/2021,0,0,2,2,31,5,22,58,1,1,0,2,11,0,17,28,6,6,1,13
15,152042,2021,Belgium,Japan,0,2,10,12,14/06/2021,0,0,6,6,23,9,36,68,3,3,2,8,7,0,17,24,8,1,1,10
16,152042,2021,Türkiye,Belgium,0,4,10,14,13/06/2021,0,0,1,1,11,4,25,40,0,1,1,2,7,1,7,15,4,2,1,7
17,152042,2021,Belgium,Serbia,0,3,11,14,08/06/2021,0,0,4,4,27,7,43,77,1,7,1,9,3,0,4,7,13,4,3,20
18,152042,2021,Belgium,Brazil,0,0,7,7,07/06/2021,0,0,0,0,12,4,11,27,0,3,0,3,5,0,14,19,2,1,2,5
19,152042,2021,China,Belgium,1,2,10,13,06/06/2021,0,0,2,2,26,8,33,67,1,3,1,5,2,0,3,5,7,4,2,13
20,152042,2021,Belgium,Korea,2,1,13,16,02/06/2021,0,0,6,6,26,5,39,70,4,5,10,19,6,1,11,18,6,2,2,10
21,152042,2021,Belgium,Poland,1,2,13,16,01/06/2021,0,0,5,5,19,8,26,53,0,5,5,10,0,0,3,3,9,3,5,17
22,152042,2021,Belgium,Dominican Republic,0,2,16,18,31/05/2021,0,0,0,0,32,5,29,66,1,5,5,11,2,0,8,10,14,4,0,18
23,152042,2021,Germany,Belgium,1,2,6,9,27/05/2021,0,0,2,2,11,4,17,32,0,1,0,1,4,1,9,14,0,0,0,0
24,152042,2021,Belgium,Russia,2,1,17,20,26/05/2021,0,0,3,3,27,13,28,68,0,4,2,6,6,0,7,13,15,3,2,20
25,152042,2021,Netherlands,Belgium,0,2,5,7,25/05/2021,0,0,0,0,13,3,20,36,0,2,6,8,10,1,7,18,2,0,1,3
26,135880,2021,Belgium,Canada,0,0,0,0,20/06/2021,0,0,0,0,0,0,0,0,0,0,0,0,0,0,0,0,0,0,0,0
27,135880,2021,Belgium,Italy,0,0,3,3,19/06/2021,0,0,1,1,0,0,0,0,0,1,0,1,0,0,0,0,0,0,0,0
28,135880,2021,Thailand,Belgium,1,0,17,18,18/06/2021,0,0,2,2,1,0,2,3,2,2,3,7,0,0,1,1,3,1,0,4
29,135880,2021,Belgium,Japan,0,2,4,6,14/06/2021,0,0,0,0,1,1,3,5,1,2,10,13,0,0,0,0,1,0,0,1
30,135880,2021,Türkiye,Belgium,0,0,0,0,13/06/2021,0,0,0,0,0,0,0,0,0,0,0,0,0,0,0,0,0,0,0,0
31,135880,2021,USA,Belgium,0,0,5,5,12/06/2021,0,0,0,0,4,0,5,9,2,0,7,9,0,0,0,0,1,0,0,1
32,135880,2021,Belgium,Serbia,0,0,0,0,08/06/2021,0,0,0,0,0,0,0,0,0,0,1,1,0,0,0,0,0,0,0,0
33,135880,2021,Belgium,Brazil,0,0,0,0,07/06/2021,0,0,0,0,0,0,0,0,0,0,0,0,0,0,0,0,0,0,0,0
34,135880,2021,China,Belgium,0,0,0,0,06/06/2021,0,0,0,0,0,0,0,0,0,0,0,0,0,0,0,0,0,0,0,0
35,135880,2021,Belgium,Korea,0,0,3,3,02/06/2021,0,0,0,0,0,0,2,2,0,3,1,4,0,0,0,0,0,0,0,0
36,135880,2021,Belgium,Poland,0,0,0,0,01/06/2021,0,0,0,0,0,0,0,0,0,0,0,0,0,0,0,0,0,0,0,0
37,135880,2021,Belgium,Dominican Republic,0,1,9,10,31/05/2021,0,0,0,0,2,0,3,5,0,5,5,10,0,0,0,0,4,0,0,4
38,135880,2021,Germany,Belgium,0,0,0,0,27/05/2021,0,0,0,0,0,0,0,0,0,0,0,0,0,0,0,0,0,0,0,0
39,135880,2021,Belgium,Russia,0,0,12,12,26/05/2021,0,0,0,0,0,0,2,2,1,1,2,4,0,0,0,0,3,0,0,3
40,156326,2021,Belgium,Canada,0,2,2,4,20/06/2021,0,0,2,2,1,0,3,4,0,2,4,6,1,0,0,1,1,0,0,1
41,156326,2021,Belgium,Italy,0,1,15,16,19/06/2021,0,0,1,1,6,1,10,17,0,2,0,2,1,0,2,3,4,1,0,5
42,156326,2021,Thailand,Belgium,0,0,0,0,18/06/2021,0,0,0,0,1,1,1,3,0,0,0,0,1,0,1,2,0,0,0,0
43,156326,2021,Belgium,Japan,0,0,1,1,14/06/2021,0,0,0,0,0,0,0,0,0,0,0,0,0,0,5,5,0,0,0,0
44,156326,2021,Türkiye,Belgium,0,2,5,7,13/06/2021,0,0,0,0,1,2,10,13,1,3,0,4,3,2,6,11,4,3,0,7
45,156326,2021,USA,Belgium,0,0,2,2,12/06/2021,0,0,0,0,0,0,6,6,0,0,0,0,2,0,10,12,2,0,0,2
46,156326,2021,Belgium,Serbia,2,3,15,20,08/06/2021,0,1,3,4,9,7,21,37,3,2,2,7,3,1,20,24,15,4,2,21
47,156326,2021,Belgium,Brazil,1,1,5,7,07/06/2021,0,0,1,1,1,1,8,10,0,6,0,6,3,1,13,17,2,2,2,6
48,156326,2021,China,Belgium,2,1,6,9,06/06/2021,0,0,4,4,2,2,14,18,0,2,5,7,3,0,13,16,12,3,0,15
49,156326,2021,Belgium,Korea,0,2,15,17,02/06/2021,0,1,3,4,12,3,12,27,0,3,3,6,14,0,10,24,15,3,1,19
50,156326,2021,Belgium,Poland,0,3,21,24,01/06/2021,0,0,3,3,11,6,13,30,0,8,2,10,6,0,14,20,12,0,2,14
51,156326,2021,Belgium,Dominican Republic,1,2,14,17,31/05/2021,0,0,0,0,14,6,24,44,3,5,3,11,7,1,3,11,15,5,4,24
52,156326,2021,Germany,Belgium,0,1,5,6,27/05/2021,0,0,1,1,3,2,6,11,0,0,0,0,6,2,3,11,1,0,0,1
53,156326,2021,Belgium,Russia,0,1,12,13,26/05/2021,0,0,0,0,7,8,9,24,0,4,5,9,3,1,7,11,5,0,1,6
54,156326,2021,Netherlands,Belgium,0,2,7,9,25/05/2021,0,0,0,0,5,2,10,17,0,0,2,2,1,1,4,6,1,2,0,3
55,181274,2021,Belgium,Canada,0,0,0,0,20/06/2021,0,0,0,0,0,0,0,0,0,0,0,0,0,0,0,0,0,0,0,0
56,181274,2021,Belgium,Italy,0,0,0,0,19/06/2021,0,0,0,0,0,0,0,0,0,0,0,0,0,0,0,0,0,0,0,0
57,181274,2021,Belgium,Japan,0,0,0,0,14/06/2021,0,0,0,0,0,0,0,0,0,0,0,0,0,0,0,0,0,0,0,0
58,181274,2021,Türkiye,Belgium,0,0,1,1,13/06/2021,0,0,0,0,0,1,3,4,0,1,0,1,0,0,0,0,0,1,0,1
59,181274,2021,USA,Belgium,0,1,4,5,12/06/2021,0,0,2,2,4,6,21,31,0,5,3,8,0,1,6,7,6,0,1,7
60,181274,2021,Belgium,Serbia,0,0,0,0,08/06/2021,0,0,0,0,0,0,3,3,0,0,0,0,0,0,1,1,0,0,0,0
61,181274,2021,China,Belgium,0,0,0,0,06/06/2021,0,0,0,0,0,1,2,3,0,1,0,1,0,0,1,1,0,0,0,0
62,181274,2021,Belgium,Korea,0,0,0,0,02/06/2021,0,0,0,0,0,0,0,0,0,0,0,0,0,0,0,0,0,0,0,0
63,181274,2021,Belgium,Poland,0,0,0,0,01/06/2021,0,0,0,0,2,1,2,5,0,0,0,0,0,0,0,0,0,0,0,0
64,181274,2021,Belgium,Dominican Republic,0,0,0,0,31/05/2021,0,0,0,0,0,0,0,0,0,0,0,0,0,0,0,0,0,0,0,0
65,181274,2021,Germany,Belgium,0,2,1,3,27/05/2021,0,0,0,0,1,1,3,5,0,1,0,1,0,0,1,1,0,0,0,0
66,181274,2021,Belgium,Russia,0,0,0,0,26/05/2021,0,0,0,0,2,1,1,4,0,0,0,0,0,0,0,0,0,0,0,0
67,181274,2021,Netherlands,Belgium,0,0,0,0,25/05/2021,0,0,0,0,0,0,0,0,0,0,0,0,0,0,0,0,0,0,0,0
68,151117,2021,Belgium,Canada,2,0,11,13,20/06/2021,0,0,1,1,12,2,12,26,0,1,6,7,5,0,15,20,11,1,1,13
69,151117,2021,Belgium,Italy,1,2,16,19,19/06/2021,0,0,0,0,9,4,14,27,2,3,0,5,10,0,24,34,7,0,1,8
70,151117,2021,Thailand,Belgium,2,1,13,16,18/06/2021,0,0,1,1,10,4,22,36,0,2,2,4,16,1,14,31,6,3,0,9
71,151117,2021,Belgium,Japan,0,2,16,18,14/06/2021,0,0,2,2,11,4,19,34,0,7,7,14,8,1,38,47,8,1,1,10
72,151117,2021,Türkiye,Belgium,0,1,7,8,13/06/2021,0,0,3,3,3,2,14,19,0,2,0,2,0,0,4,4,1,3,0,4
73,151117,2021,USA,Belgium,2,0,8,10,12/06/2021,0,0,3,3,4,1,8,13,0,2,1,3,1,0,12,13,8,5,0,13
74,151117,2021,Belgium,Serbia,1,1,15,17,08/06/2021,0,0,2,2,8,3,23,34,1,4,1,6,14,2,40,56,19,3,3,25
75,151117,2021,Belgium,Brazil,0,0,7,7,07/06/2021,0,0,1,1,8,4,15,27,1,0,2,3,2,1,9,12,6,4,1,11
76,151117,2021,China,Belgium,3,0,14,17,06/06/2021,0,0,2,2,11,4,13,28,1,7,7,15,12,0,31,43,11,2,1,14
77,151117,2021,Belgium,Korea,0,1,17,18,02/06/2021,0,0,3,3,13,8,17,38,2,1,2,5,2,0,7,9,13,3,1,17
78,151117,2021,Belgium,Poland,1,0,12,13,01/06/2021,0,0,1,1,12,4,16,32,2,2,6,10,11,1,37,49,13,4,1,18
79,151117,2021,Belgium,Dominican Republic,4,0,18,22,31/05/2021,0,0,0,0,9,4,17,30,0,5,4,9,12,0,20,32,18,4,0,22
80,151117,2021,Germany,Belgium,1,0,10,11,27/05/2021,0,0,0,0,8,4,10,22,0,1,0,1,5,3,14,22,1,0,0,1
81,151117,2021,Belgium,Russia,0,1,12,13,26/05/2021,0,0,2,2,9,6,10,25,0,1,3,4,15,1,22,38,15,5,0,20
82,151117,2021,Netherlands,Belgium,1,2,8,11,25/05/2021,0,0,2,2,4,1,12,17,0,5,2,7,7,1,10,18,3,1,0,4
83,181275,2021,Belgium,Canada,0,0,0,0,20/06/2021,0,0,0,0,0,0,0,0,0,0,0,0,0,0,0,0,0,0,0,0
84,181275,2021,Belgium,Italy,0,0,0,0,19/06/2021,0,0,0,0,0,0,0,0,0,0,0,0,0,0,0,0,0,0,0,0
85,181275,2021,Thailand,Belgium,0,0,0,0,18/06/2021,0,0,0,0,0,0,0,0,0,0,0,0,0,0,0,0,0,0,0,0
86,181275,2021,Belgium,Japan,0,0,0,0,14/06/2021,0,1,16,17,0,0,0,0,0,0,0,0,5,1,4,10,22,7,4,33
87,181275,2021,Türkiye,Belgium,0,0,0,0,13/06/2021,0,0,0,0,0,0,0,0,0,0,0,0,0,0,0,0,0,0,0,0
88,181275,2021,USA,Belgium,0,1,1,2,12/06/2021,0,0,0,0,0,0,0,0,0,0,0,0,1,0,0,1,1,1,0,2
89,181275,2021,Belgium,Serbia,0,0,0,0,08/06/2021,0,0,0,0,0,0,0,0,0,0,0,0,0,0,0,0,0,1,0,1
90,181275,2021,Belgium,Brazil,0,0,0,0,07/06/2021,0,0,0,0,0,0,0,0,0,0,0,0,0,0,0,0,0,0,0,0
91,181275,2021,China,Belgium,0,0,0,0,06/06/2021,0,0,0,0,0,0,0,0,0,0,0,0,0,0,0,0,0,0,0,0
92,181275,2021,Belgium,Korea,0,0,0,0,02/06/2021,0,0,0,0,0,0,0,0,0,0,0,0,0,0,0,0,0,0,0,0
93,181275,2021,Belgium,Poland,0,0,0,0,01/06/2021,0,0,0,0,0,0,0,0,0,0,0,0,0,0,0,0,0,0,0,0
94,181275,2021,Belgium,Dominican Republic,0,0,0,0,31/05/2021,0,0,0,0,0,0,0,0,0,0,0,0,0,0,0,0,0,0,0,0
95,181275,2021,Germany,Belgium,0,0,0,0,27/05/2021,0,0,0,0,0,0,0,0,0,0,0,0,0,0,0,0,0,0,0,0
96,181275,2021,Belgium,Russia,0,0,0,0,26/05/2021,0,0,0,0,0,0,0,0,0,0,0,0,0,0,1,1,0,0,0,0
97,181275,2021,Netherlands,Belgium,0,0,0,0,25/05/2021,0,0,0,0,0,0,0,0,0,0,0,0,0,0,0,0,0,0,0,0
98,119429,2021,Belgium,Canada,2,0,8,10,20/06/2021,0,0,1,1,1,0,2,3,0,4,6,10,0,0,0,0,5,1,1,7
99,119429,2021,Belgium,Italy,0,1,4,5,19/06/2021,0,0,0,0,1,0,1,2,1,1,1,3,0,0,0,0,0,1,0,1
100,119429,2021,Thailand,Belgium,0,0,0,0,18/06/2021,0,0,0,0,0,0,0,0,0,0,0,0,0,0,0,0,0,0,0,0
101,119429,2021,Belgium,Japan,0,0,2,2,14/06/2021,0,0,0,0,2,0,1,3,1,1,0,2,0,0,0,0,0,1,0,1
102,119429,2021,Türkiye,Belgium,0,0,1,1,13/06/2021,0,0,2,2,0,0,3,3,4,1,0,5,0,0,1,1,1,0,0,1
103,119429,2021,USA,Belgium,0,1,2,3,12/06/2021,0,0,0,0,1,1,5,7,0,2,2,4,0,0,0,0,0,0,1,1
104,119429,2021,Belgium,Serbia,0,0,0,0,08/06/2021,0,0,0,0,0,0,0,0,0,0,0,0,0,0,0,0,0,0,0,0
105,119429,2021,Belgium,Brazil,0,2,4,6,07/06/2021,0,1,0,1,3,0,1,4,1,2,0,3,0,0,0,0,1,0,1,2
106,119429,2021,China,Belgium,0,0,0,0,06/06/2021,0,0,0,0,0,1,1,2,0,0,0,0,0,0,0,0,1,0,0,1
107,119429,2021,Belgium,Korea,0,0,0,0,02/06/2021,0,0,0,0,0,0,0,0,0,0,0,0,0,0,0,0,0,0,0,0
108,119429,2021,Belgium,Poland,0,0,4,4,01/06/2021,0,0,0,0,1,2,4,7,0,3,4,7,0,1,0,1,2,0,0,2
109,119429,2021,Belgium,Dominican Republic,0,0,4,4,31/05/2021,0,0,0,0,1,0,5,6,0,5,2,7,0,0,0,0,1,0,0,1
110,119429,2021,Germany,Belgium,0,0,4,4,27/05/2021,0,0,0,0,2,1,3,6,2,2,0,4,0,0,0,0,2,0,0,2
111,119429,2021,Belgium,Russia,0,2,3,5,26/05/2021,0,0,0,0,5,2,9,16,6,8,12,26,0,0,0,0,2,0,0,2
112,119429,2021,Netherlands,Belgium,0,2,3,5,25/05/2021,0,0,0,0,2,1,4,7,0,5,4,9,1,0,0,1,0,0,1,1
113,152039,2021,Türkiye,Belgium,0,0,0,0,13/06/2021,0,0,0,0,0,0,0,0,0,0,0,0,0,0,0,0,0,0,0,0
114,152039,2021,USA,Belgium,0,0,0,0,12/06/2021,0,0,0,0,0,0,0,0,0,0,0,0,0,0,1,1,0,0,0,0
115,156325,2021,Belgium,Canada,2,0,11,13,20/06/2021,0,0,0,0,4,2,5,11,2,4,5,11,0,0,0,0,2,4,1,7
116,156325,2021,Belgium,Italy,6,2,10,18,19/06/2021,0,0,0,0,9,4,4,17,1,4,2,7,0,0,2,2,2,0,0,2
117,156325,2021,Thailand,Belgium,2,3,12,17,18/06/2021,1,0,0,1,7,0,12,19,2,3,2,7,0,0,0,0,2,4,0,6
118,156325,2021,Belgium,Japan,3,4,11,18,14/06/2021,0,0,1,1,11,1,6,18,8,1,5,14,0,0,1,1,3,0,0,3
119,156325,2021,Türkiye,Belgium,1,1,5,7,13/06/2021,0,0,0,0,2,0,3,5,1,1,2,4,0,0,0,0,1,0,0,1
120,156325,2021,Belgium,Serbia,2,2,16,20,08/06/2021,0,0,2,2,10,2,10,22,1,4,9,14,0,0,0,0,4,0,3,7
121,156325,2021,Belgium,Brazil,0,0,7,7,07/06/2021,0,0,0,0,4,1,2,7,1,2,0,3,0,0,0,0,2,3,0,5
122,156325,2021,China,Belgium,1,2,12,15,06/06/2021,0,0,2,2,7,0,11,18,9,5,6,20,0,0,0,0,1,1,0,2
123,156325,2021,Belgium,Korea,1,2,11,14,02/06/2021,0,0,0,0,12,2,6,20,1,5,5,11,0,0,0,0,3,1,1,5
124,156325,2021,Belgium,Poland,3,0,12,15,01/06/2021,0,0,1,1,9,4,6,19,7,3,4,14,0,0,1,1,4,1,0,5
125,156325,2021,Belgium,Dominican Republic,2,2,15,19,31/05/2021,0,1,0,1,8,1,5,14,5,7,4,16,0,0,0,0,5,0,1,6
126,156325,2021,Germany,Belgium,0,0,7,7,27/05/2021,0,0,1,1,2,4,3,9,1,0,1,2,0,0,0,0,2,0,0,2
127,156325,2021,Belgium,Russia,0,0,0,0,26/05/2021,0,0,0,0,0,0,0,0,0,0,0,0,0,0,0,0,0,0,0,0
128,156325,2021,Netherlands,Belgium,0,2,10,12,25/05/2021,0,0,0,0,10,1,5,16,1,5,2,8,0,0,0,0,3,0,0,3
129,119420,2021,Thailand,Belgium,0,0,0,0,18/06/2021,0,0,0,0,0,0,0,0,0,0,0,0,0,0,0,0,0,0,0,0
130,119420,2021,Belgium,Japan,0,0,1,1,14/06/2021,0,0,0,0,0,0,0,0,0,0,0,0,0,0,1,1,0,0,0,0
131,119420,2021,USA,Belgium,0,0,5,5,12/06/2021,0,0,1,1,3,3,8,14,2,1,2,5,0,0,1,1,1,4,1,6
132,119420,2021,Belgium,Brazil,0,1,3,4,07/06/2021,0,0,0,0,3,3,3,9,0,0,4,4,0,0,1,1,2,0,0,2
133,119420,2021,Belgium,Korea,0,0,0,0,02/06/2021,0,0,0,0,0,0,0,0,0,0,0,0,0,0,0,0,0,0,0,0
134,119420,2021,Belgium,Dominican Republic,0,0,0,0,31/05/2021,0,0,0,0,0,0,0,0,0,0,0,0,0,0,0,0,0,0,0,0
135,119420,2021,Netherlands,Belgium,0,0,0,0,25/05/2021,0,0,0,0,0,0,0,0,0,0,0,0,0,0,0,0,0,0,0,0
136,160208,2021,Belgium,Canada,0,0,0,0,20/06/2021,0,0,0,0,0,0,0,0,0,0,0,0,0,0,0,0,0,0,0,0
137,160208,2021,Belgium,Italy,0,0,1,1,19/06/2021,0,0,2,2,0,0,1,1,0,0,0,0,0,0,0,0,0,0,0,0
138,160208,2021,Thailand,Belgium,0,0,0,0,18/06/2021,0,0,0,0,0,0,0,0,0,0,0,0,0,0,0,0,0,0,0,0
139,160208,2021,Belgium,Japan,0,0,1,1,14/06/2021,2,1,7,10,0,0,0,0,0,0,0,0,0,0,0,0,0,0,0,0
140,160208,2021,USA,Belgium,0,0,0,0,12/06/2021,0,0,0,0,0,0,0,0,0,0,0,0,0,0,0,0,0,0,0,0
141,160208,2021,Belgium,Serbia,0,0,0,0,08/06/2021,0,0,0,0,0,0,0,0,0,0,0,0,0,0,0,0,0,0,0,0
142,160208,2021,China,Belgium,0,0,0,0,06/06/2021,0,0,0,0,0,0,0,0,0,0,0,0,0,0,0,0,0,0,0,0
143,160208,2021,Belgium,Korea,0,0,2,2,02/06/2021,0,1,8,9,0,0,0,0,0,0,0,0,0,0,0,0,1,0,0,1
144,160208,2021,Belgium,Poland,0,0,0,0,01/06/2021,0,0,0,0,0,0,0,0,0,0,0,0,0,0,0,0,0,0,0,0
145,160208,2021,Belgium,Dominican Republic,0,0,0,0,31/05/2021,0,0,0,0,0,0,0,0,0,0,0,0,0,0,0,0,0,0,0,0
146,160208,2021,Germany,Belgium,0,0,0,0,27/05/2021,0,0,0,0,0,0,0,0,0,0,0,0,0,0,0,0,0,0,0,0
147,160208,2021,Belgium,Russia,0,0,0,0,26/05/2021,0,0,3,3,0,0,0,0,0,0,0,0,0,0,0,0,0,0,1,1
148,160208,2021,Netherlands,Belgium,0,0,0,0,25/05/2021,0,0,0,0,0,0,0,0,0,0,0,0,0,0,0,0,0,0,0,0
149,119537,2021,Belgium,Canada,1,0,6,7,20/06/2021,9,0,66,75,0,0,0,0,0,2,3,5,0,0,0,0,4,1,2,7
150,119537,2021,Belgium,Italy,1,2,13,16,19/06/2021,7,2,123,132,0,0,1,1,2,1,5,8,0,1,0,1,3,5,0,8
151,119537,2021,Thailand,Belgium,0,1,19,20,18/06/2021,24,1,110,135,0,0,3,3,0,3,1,4,0,0,0,0,9,5,0,14
152,119537,2021,Belgium,Japan,0,2,12,14,14/06/2021,25,1,85,111,0,0,1,1,0,8,5,13,0,0,1,1,12,2,4,18
153,119537,2021,Türkiye,Belgium,2,1,10,13,13/06/2021,2,0,77,79,0,0,3,3,0,1,0,1,0,0,0,0,3,3,0,6
154,119537,2021,USA,Belgium,0,1,11,12,12/06/2021,7,0,66,73,0,1,2,3,0,1,1,2,0,0,0,0,8,2,2,12
155,119537,2021,Belgium,Serbia,2,1,18,21,08/06/2021,40,1,117,158,0,0,2,2,0,2,9,11,0,0,0,0,19,4,3,26
156,119537,2021,Belgium,Brazil,0,0,3,3,07/06/2021,11,2,30,43,0,0,1,1,0,0,1,1,0,0,0,0,6,4,0,10
157,119537,2021,China,Belgium,0,0,17,17,06/06/2021,33,0,87,120,0,0,1,1,0,2,0,2,0,0,0,0,16,3,3,22
158,119537,2021,Belgium,Korea,0,2,19,21,02/06/2021,22,0,121,143,0,0,0,0,1,9,2,12,0,0,0,0,13,2,2,17
159,119537,2021,Belgium,Poland,1,0,17,18,01/06/2021,31,0,105,136,0,0,0,0,0,1,4,5,0,0,0,0,9,3,2,14
160,119537,2021,Belgium,Dominican Republic,4,1,17,22,31/05/2021,22,0,0,22,0,0,3,3,0,5,3,8,0,0,2,2,16,5,0,21
161,119537,2021,Germany,Belgium,0,1,8,9,27/05/2021,1,0,81,82,0,0,0,0,0,1,1,2,0,0,0,0,0,0,0,0
162,119537,2021,Belgium,Russia,0,1,13,14,26/05/2021,26,1,120,147,2,0,2,4,0,4,4,8,0,0,0,0,12,1,3,16
163,119537,2021,Netherlands,Belgium,1,0,10,11,25/05/2021,32,0,59,91,1,0,1,2,1,3,0,4,0,1,0,1,3,1,0,4
164,168160,2021,Belgium,Canada,0,0,0,0,20/06/2021,0,0,6,6,0,0,0,0,0,0,0,0,4,3,10,17,14,2,2,18
165,168160,2021,Belgium,Italy,0,0,0,0,19/06/2021,0,0,5,5,0,0,0,0,0,0,0,0,10,3,12,25,12,5,0,17
166,168160,2021,Thailand,Belgium,0,0,0,0,18/06/2021,0,0,8,8,0,0,0,0,0,0,0,0,14,2,6,22,20,14,1,35
167,168160,2021,Türkiye,Belgium,0,0,0,0,13/06/2021,0,0,3,3,0,0,0,0,0,0,0,0,13,2,17,32,11,12,0,23
168,168160,2021,USA,Belgium,0,0,0,0,12/06/2021,0,0,13,13,0,0,0,0,0,0,0,0,6,1,17,24,8,5,2,15
169,168160,2021,Belgium,Serbia,0,0,0,0,08/06/2021,0,0,17,17,0,0,0,0,0,0,0,0,5,1,4,10,25,9,7,41
170,168160,2021,Belgium,Brazil,0,0,0,0,07/06/2021,0,0,8,8,0,0,0,0,0,0,0,0,4,0,12,16,7,1,3,11
171,168160,2021,China,Belgium,0,0,0,0,06/06/2021,0,1,11,12,0,0,0,0,0,0,0,0,10,0,14,24,23,5,5,33
172,168160,2021,Belgium,Korea,0,0,0,0,02/06/2021,1,0,8,9,0,0,0,0,0,0,0,0,17,2,21,40,19,8,0,27
173,168160,2021,Belgium,Poland,0,0,0,0,01/06/2021,0,0,10,10,0,0,0,0,0,0,0,0,4,0,9,13,17,5,5,27
174,168160,2021,Belgium,Dominican Republic,0,0,0,0,31/05/2021,1,1,0,2,0,0,0,0,0,0,0,0,14,2,18,34,11,5,0,16
175,168160,2021,Germany,Belgium,0,0,0,0,27/05/2021,0,1,2,3,0,0,0,0,0,0,0,0,5,2,10,17,2,0,0,2
176,168160,2021,Belgium,Russia,0,0,0,0,26/05/2021,0,0,6,6,0,0,0,0,0,0,0,0,10,2,20,32,16,2,2,20
177,168160,2021,Netherlands,Belgium,0,0,0,0,25/05/2021,0,0,4,4,0,0,0,0,0,0,0,0,11,1,8,20,5,3,0,8
178,152040,2021,Belgium,Canada,0,0,8,8,20/06/2021,0,0,0,0,4,1,5,10,1,1,0,2,0,1,0,1,1,1,1,3
179,152040,2021,Belgium,Italy,2,1,12,15,19/06/2021,0,0,0,0,5,2,7,14,0,3,3,6,0,0,0,0,6,1,0,7
180,152040,2021,Thailand,Belgium,0,3,5,8,18/06/2021,0,0,0,0,20,0,11,31,1,1,0,2,0,0,0,0,9,3,1,13
181,152040,2021,Belgium,Japan,0,2,13,15,14/06/2021,0,0,0,0,6,1,11,18,1,3,4,8,0,0,0,0,5,3,2,10
182,152040,2021,Türkiye,Belgium,0,0,5,5,13/06/2021,0,0,0,0,2,0,4,6,0,1,1,2,0,0,0,0,0,0,0,0
183,152040,2021,USA,Belgium,1,0,7,8,12/06/2021,0,0,0,0,5,2,3,10,1,3,1,5,0,0,0,0,5,0,0,5
184,152040,2021,Belgium,Serbia,1,1,15,17,08/06/2021,0,0,2,2,11,3,11,25,7,6,8,21,0,0,0,0,6,1,1,8
185,152040,2021,Belgium,Brazil,1,0,4,5,07/06/2021,0,0,2,2,2,3,1,6,2,0,3,5,0,0,1,1,3,0,0,3
186,152040,2021,China,Belgium,1,1,19,21,06/06/2021,0,0,3,3,9,0,14,23,4,6,2,12,1,0,0,1,3,1,2,6
187,152040,2021,Belgium,Korea,1,1,13,15,02/06/2021,0,0,2,2,5,0,10,15,0,5,4,9,1,0,0,1,2,1,2,5
188,152040,2021,Belgium,Poland,2,1,10,13,01/06/2021,0,0,0,0,7,0,1,8,1,1,2,4,0,1,0,1,5,0,1,6
189,152040,2021,Belgium,Dominican Republic,0,0,0,0,31/05/2021,0,0,0,0,1,0,0,1,0,1,0,1,0,0,0,0,0,0,0,0
190,152040,2021,Germany,Belgium,0,2,0,2,27/05/2021,0,0,0,0,3,0,3,6,1,0,0,1,0,0,0,0,1,0,0,1
191,152040,2021,Belgium,Russia,1,2,8,11,26/05/2021,0,0,1,1,6,2,12,20,1,10,6,17,0,0,0,0,2,1,1,4
192,152040,2021,Netherlands,Belgium,0,0,1,1,25/05/2021,0,0,0,0,0,0,1,1,0,0,0,0,0,0,0,0,0,0,0,0
193,152057,2021,Belgium,Canada,0,1,1,2,20/06/2021,0,0,0,0,0,0,0,0,0,0,0,0,0,0,0,0,0,1,0,1
194,152057,2021,Belgium,Italy,0,1,0,1,19/06/2021,0,0,0,0,0,0,0,0,0,0,0,0,0,0,0,0,0,0,0,0
195,152057,2021,Thailand,Belgium,0,0,4,4,18/06/2021,0,0,1,1,0,0,0,0,0,0,0,0,0,0,0,0,0,0,0,0
196,152057,2021,Belgium,Japan,0,1,1,2,14/06/2021,0,0,0,0,0,0,0,0,0,0,0,0,0,0,0,0,1,1,0,2
197,152057,2021,Türkiye,Belgium,0,0,1,1,13/06/2021,0,0,0,0,0,0,0,0,0,0,0,0,0,0,0,0,0,0,0,0
198,152057,2021,USA,Belgium,1,1,1,3,12/06/2021,0,0,0,0,0,1,0,1,0,1,1,2,0,0,0,0,0,0,0,0
199,152057,2021,Belgium,Serbia,0,1,2,3,08/06/2021,0,0,0,0,0,1,1,2,0,0,0,0,0,0,0,0,2,0,0,2
200,152057,2021,Belgium,Brazil,0,0,0,0,07/06/2021,0,0,0,0,0,0,0,0,0,0,0,0,0,0,1,1,0,0,0,0
201,152057,2021,China,Belgium,1,0,8,9,06/06/2021,0,0,2,2,0,1,4,5,0,1,0,1,1,0,3,4,3,1,2,6
202,152057,2021,Belgium,Korea,0,0,0,0,02/06/2021,0,0,0,0,0,0,0,0,0,0,0,0,0,0,0,0,0,0,0,0
203,152057,2021,Belgium,Poland,0,0,1,1,01/06/2021,0,0,0,0,0,0,0,0,0,0,0,0,0,0,0,0,0,1,0,1
204,152057,2021,Belgium,Dominican Republic,0,0,3,3,31/05/2021,0,0,0,0,0,0,0,0,0,0,0,0,0,0,0,0,0,0,0,0
205,152057,2021,Germany,Belgium,0,1,1,2,27/05/2021,0,0,0,0,0,0,0,0,0,0,0,0,0,0,0,0,0,0,0,0
206,152057,2021,Belgium,Russia,0,1,8,9,26/05/2021,0,0,0,0,1,0,3,4,0,0,0,0,0,0,0,0,4,0,0,4
207,152057,2021,Netherlands,Belgium,0,1,3,4,25/05/2021,0,0,0,0,0,0,0,0,0,0,0,0,0,0,0,0,0,0,0,0
208,113245,2021,Brazil,USA,0,0,13,13,25/06/2021,0,0,2,2,9,0,3,12,3,4,7,14,0,0,0,0,3,0,2,5
209,113245,2021,Brazil,Japan,1,0,18,19,24/06/2021,0,0,3,3,4,1,9,14,3,4,6,13,0,0,0,0,6,0,0,6
210,113245,2021,Brazil,Türkiye,0,0,13,13,20/06/2021,0,0,3,3,7,2,2,11,0,4,1,5,0,0,1,1,1,0,0,1
211,113245,2021,Brazil,Netherlands,0,0,12,12,19/06/2021,0,0,5,5,7,0,3,10,0,3,3,6,0,0,1,1,6,0,0,6
212,113245,2021,Korea,Brazil,2,0,11,13,18/06/2021,0,1,1,2,5,1,2,8,1,1,2,4,0,0,2,2,5,3,0,8
213,113245,2021,Poland,Brazil,0,2,8,10,12/06/2021,0,0,1,1,4,1,4,9,3,5,3,11,0,0,1,1,3,0,0,3
214,113245,2021,China,Brazil,1,2,7,10,08/06/2021,0,0,3,3,16,1,7,24,2,7,12,21,0,0,1,1,4,1,0,5
215,113245,2021,Belgium,Brazil,0,1,5,6,07/06/2021,0,0,3,3,6,1,1,8,0,3,8,11,1,0,2,3,1,2,0,3
216,113245,2021,Brazil,Serbia,0,1,6,7,06/06/2021,0,0,3,3,1,0,4,5,2,3,2,7,1,0,1,2,3,0,1,4
217,113245,2021,Brazil,Italy,0,0,0,0,02/06/2021,0,0,0,0,0,0,0,0,0,0,0,0,0,0,0,0,0,0,0,0
218,113245,2021,Brazil,Russia,1,1,2,4,01/06/2021,0,0,3,3,7,1,5,13,2,4,7,13,1,0,0,1,5,0,0,5
219,113245,2021,Brazil,Japan,1,0,7,8,31/05/2021,0,0,1,1,2,0,2,4,1,4,0,5,0,0,0,0,3,0,0,3
220,113245,2021,Brazil,USA,0,1,4,5,27/05/2021,0,0,0,0,3,0,6,9,1,3,4,8,0,0,1,1,1,0,0,1
221,113245,2021,Brazil,Dominican Republic,0,0,12,12,26/05/2021,0,0,0,0,7,1,6,14,3,3,2,8,0,0,0,0,2,0,0,2
222,113245,2021,Brazil,Canada,0,0,0,0,25/05/2021,0,0,0,0,0,0,0,0,0,0,0,0,0,0,0,0,0,0,0,0
223,112625,2021,Brazil,USA,0,1,1,2,25/06/2021,1,0,12,13,0,0,0,0,0,0,0,0,0,0,0,0,0,2,0,2
224,112625,2021,Brazil,Türkiye,0,1,6,7,20/06/2021,3,0,14,17,0,0,0,0,0,0,0,0,0,0,0,0,3,1,1,5
225,112625,2021,Korea,Brazil,0,0,1,1,18/06/2021,1,0,3,4,0,0,0,0,0,0,0,0,0,0,0,0,0,0,0,0
226,112625,2021,Germany,Brazil,0,1,4,5,13/06/2021,0,1,13,14,0,0,0,0,0,0,0,0,0,0,0,0,0,0,0,0
227,112625,2021,China,Brazil,0,0,6,6,08/06/2021,4,1,14,19,0,0,0,0,0,0,0,0,0,0,0,0,2,0,2,4
228,112625,2021,Brazil,Serbia,0,2,3,5,06/06/2021,6,0,26,32,0,0,0,0,0,0,2,2,0,1,0,1,5,0,1,6
229,112625,2021,Brazil,Russia,0,1,1,2,01/06/2021,4,0,9,13,0,0,0,0,0,2,0,2,0,0,0,0,3,0,1,4
230,112625,2021,Brazil,USA,0,0,4,4,27/05/2021,6,0,17,23,0,0,0,0,0,0,1,1,0,0,0,0,2,0,0,2
231,112625,2021,Brazil,Canada,0,0,1,1,25/05/2021,0,0,13,13,0,0,0,0,1,1,0,2,0,0,0,0,3,0,0,3
232,113955,2021,Brazil,Japan,0,0,0,0,24/06/2021,0,0,0,0,0,0,0,0,0,0,0,0,0,0,0,0,0,0,0,0
233,113955,2021,Brazil,Netherlands,1,0,1,2,19/06/2021,0,0,1,1,1,0,1,2,0,0,1,1,0,0,0,0,0,0,1,1
234,113955,2021,Korea,Brazil,0,0,2,2,18/06/2021,0,0,0,0,2,0,2,4,1,5,0,6,0,0,0,0,1,1,0,2
235,113955,2021,Brazil,Thailand,0,0,10,10,14/06/2021,0,0,1,1,4,0,2,6,1,3,1,5,0,0,0,0,1,0,0,1
236,113955,2021,Germany,Brazil,0,0,0,0,13/06/2021,0,0,0,0,0,0,0,0,0,0,0,0,0,0,0,0,0,0,0,0
237,113955,2021,Poland,Brazil,0,0,2,2,12/06/2021,0,0,0,0,0,0,1,1,0,2,0,2,0,0,0,0,0,0,0,0
238,113955,2021,China,Brazil,0,0,0,0,08/06/2021,0,0,0,0,0,0,0,0,0,0,0,0,0,0,0,0,0,0,0,0
239,113955,2021,Brazil,Serbia,0,0,1,1,06/06/2021,0,0,1,1,3,0,0,3,2,1,2,5,0,0,0,0,1,0,0,1
240,113955,2021,Brazil,Italy,0,0,0,0,02/06/2021,0,0,0,0,0,0,0,0,0,0,0,0,0,0,0,0,0,0,0,0
241,113955,2021,Brazil,Japan,0,0,0,0,31/05/2021,0,0,0,0,0,0,0,0,0,0,0,0,0,0,0,0,0,0,0,0
242,113955,2021,Brazil,USA,1,0,6,7,27/05/2021,0,0,1,1,3,2,4,9,2,5,2,9,0,0,1,1,1,0,0,1
243,113955,2021,Brazil,Canada,0,0,0,0,25/05/2021,0,0,0,0,0,0,0,0,0,0,0,0,0,0,0,0,0,0,0,0
244,152135,2021,Brazil,USA,0,0,0,0,25/06/2021,0,0,0,0,0,0,0,0,0,0,0,0,0,0,0,0,0,0,0,0
245,152135,2021,Brazil,Japan,0,0,0,0,24/06/2021,0,0,0,0,0,0,0,0,0,0,0,0,0,0,0,0,0,0,0,0
246,152135,2021,Brazil,Türkiye,0,0,0,0,20/06/2021,0,0,0,0,0,0,0,0,0,0,0,0,0,0,0,0,0,0,0,0
247,152135,2021,Brazil,Netherlands,0,0,0,0,19/06/2021,0,0,0,0,0,0,0,0,0,0,0,0,0,0,0,0,0,0,0,0
248,152135,2021,Korea,Brazil,0,0,0,0,18/06/2021,0,0,0,0,0,0,0,0,0,0,0,0,0,0,0,0,0,0,0,0
249,152135,2021,Brazil,Thailand,0,0,0,0,14/06/2021,0,0,0,0,0,0,0,0,0,0,0,0,0,0,2,2,2,0,0,2
250,152135,2021,Germany,Brazil,0,0,0,0,13/06/2021,0,0,0,0,0,0,0,0,0,0,0,0,0,0,0,0,0,0,0,0
251,152135,2021,Poland,Brazil,0,0,0,0,12/06/2021,0,0,0,0,0,0,0,0,0,0,0,0,0,0,0,0,0,0,0,0
252,152135,2021,China,Brazil,0,0,0,0,08/06/2021,0,0,0,0,0,0,0,0,0,0,0,0,0,0,0,0,0,0,0,0
253,152135,2021,Belgium,Brazil,0,0,0,0,07/06/2021,0,0,0,0,0,0,0,0,0,0,0,0,0,0,0,0,0,0,0,0
254,152135,2021,Brazil,Serbia,0,0,0,0,06/06/2021,0,0,2,2,0,0,0,0,0,0,0,0,1,0,2,3,3,2,1,6
255,152135,2021,Brazil,Italy,0,0,0,0,02/06/2021,0,0,0,0,0,0,0,0,0,0,0,0,0,0,0,0,0,0,0,0
256,152135,2021,Brazil,Russia,0,0,0,0,01/06/2021,0,0,0,0,0,0,0,0,0,0,0,0,0,0,0,0,0,0,0,0
257,152135,2021,Brazil,Japan,0,0,0,0,31/05/2021,0,0,0,0,0,0,0,0,0,0,0,0,0,0,0,0,0,0,0,0
258,152135,2021,Brazil,USA,0,0,0,0,27/05/2021,0,0,0,0,0,0,0,0,0,0,0,0,0,0,0,0,0,0,0,0
259,152135,2021,Brazil,Dominican Republic,0,0,0,0,26/05/2021,0,0,0,0,0,0,0,0,0,0,0,0,0,0,0,0,0,0,0,0
260,152135,2021,Brazil,Canada,0,0,0,0,25/05/2021,0,0,0,0,0,0,0,0,0,0,0,0,0,0,0,0,0,0,0,0
261,136897,2021,Brazil,USA,0,0,0,0,25/06/2021,0,0,0,0,2,1,3,6,0,0,1,1,0,0,0,0,0,0,0,0
262,136897,2021,Brazil,Japan,0,0,0,0,24/06/2021,0,0,0,0,4,0,2,6,1,0,1,2,0,0,0,0,0,0,0,0
263,136897,2021,Brazil,Türkiye,0,0,0,0,20/06/2021,0,0,0,0,2,2,3,7,0,2,0,2,0,0,0,0,1,0,0,1
264,136897,2021,Brazil,Netherlands,0,0,0,0,19/06/2021,0,0,0,0,0,0,0,0,0,0,0,0,0,0,0,0,0,0,0,0
265,136897,2021,Korea,Brazil,0,0,1,1,18/06/2021,0,0,0,0,1,0,0,1,0,0,0,0,0,0,0,0,0,1,0,1
266,136897,2021,Brazil,Thailand,1,1,5,7,14/06/2021,0,0,0,0,4,0,3,7,0,1,0,1,1,0,1,2,2,0,1,3
267,136897,2021,Germany,Brazil,0,0,0,0,13/06/2021,0,0,0,0,1,0,4,5,0,0,0,0,0,0,0,0,0,0,0,0
268,136897,2021,Poland,Brazil,0,0,0,0,12/06/2021,0,0,0,0,3,0,0,3,0,0,1,1,0,0,0,0,0,0,0,0
269,136897,2021,China,Brazil,0,0,0,0,08/06/2021,0,0,0,0,7,2,4,13,0,1,3,4,0,0,0,0,0,0,2,2
270,136897,2021,Belgium,Brazil,0,0,1,1,07/06/2021,0,0,0,0,4,0,1,5,0,0,1,1,0,0,0,0,0,0,1,1
271,136897,2021,Brazil,Serbia,0,0,0,0,06/06/2021,0,0,0,0,0,0,0,0,0,0,0,0,0,0,0,0,0,0,0,0
272,136897,2021,Brazil,Italy,1,2,11,14,02/06/2021,0,0,1,1,15,2,16,33,1,1,3,5,5,0,12,17,10,5,1,16
273,136897,2021,Brazil,Russia,0,0,0,0,01/06/2021,0,0,0,0,0,0,0,0,0,0,0,0,0,0,0,0,0,0,0,0
274,136897,2021,Brazil,Japan,0,0,0,0,31/05/2021,0,0,0,0,3,1,2,6,0,0,1,1,0,0,0,0,0,0,0,0
275,151187,2021,Brazil,USA,0,0,14,14,25/06/2021,21,2,81,104,0,0,0,0,0,2,3,5,0,1,0,1,10,2,2,14
276,151187,2021,Brazil,Japan,0,0,13,13,24/06/2021,34,1,75,110,0,0,1,1,1,3,3,7,0,0,0,0,12,2,0,14
277,151187,2021,Brazil,Türkiye,1,0,11,12,20/06/2021,20,0,75,95,0,0,1,1,0,3,4,7,0,0,0,0,9,0,0,9
278,151187,2021,Brazil,Netherlands,0,0,10,10,19/06/2021,15,0,73,88,0,0,3,3,0,3,1,4,0,0,1,1,9,4,0,13
279,151187,2021,Korea,Brazil,1,0,10,11,18/06/2021,26,0,55,81,0,0,1,1,0,3,2,5,0,0,0,0,5,2,1,8
280,151187,2021,Brazil,Thailand,1,1,6,8,14/06/2021,15,0,38,53,0,0,1,1,0,1,1,2,0,0,0,0,6,0,0,6
281,151187,2021,Germany,Brazil,0,1,10,11,13/06/2021,20,0,69,89,1,0,0,1,1,0,0,1,0,0,0,0,6,6,2,14
282,151187,2021,Poland,Brazil,1,0,15,16,12/06/2021,10,1,53,64,0,0,0,0,0,0,2,2,0,0,0,0,4,1,0,5
283,151187,2021,China,Brazil,0,1,16,17,08/06/2021,45,0,79,124,3,0,3,6,0,1,1,2,0,0,1,1,13,2,1,16
284,151187,2021,Belgium,Brazil,0,1,11,12,07/06/2021,25,0,39,64,0,0,0,0,1,1,2,4,0,0,0,0,2,0,0,2
285,151187,2021,Brazil,Serbia,0,0,3,3,06/06/2021,4,0,27,31,0,0,0,0,0,0,1,1,0,0,0,0,4,0,0,4
286,151187,2021,Brazil,Italy,0,0,2,2,02/06/2021,9,0,21,30,0,0,0,0,0,1,0,1,0,0,0,0,1,1,0,2
287,151187,2021,Brazil,Russia,1,1,5,7,01/06/2021,32,0,40,72,0,0,1,1,0,2,0,2,0,0,0,0,5,0,1,6
288,151187,2021,Brazil,Japan,0,0,14,14,31/05/2021,27,0,55,82,1,0,0,1,2,3,1,6,0,0,0,0,6,2,0,8
289,151187,2021,Brazil,USA,1,1,13,15,27/05/2021,18,1,84,103,0,0,2,2,0,4,2,6,0,1,0,1,11,5,2,18
290,151187,2021,Brazil,Dominican Republic,0,1,7,8,26/05/2021,12,0,63,75,0,0,2,2,3,1,2,6,0,0,0,0,0,0,0,0
291,151187,2021,Brazil,Canada,0,0,10,10,25/05/2021,0,1,20,21,0,0,0,0,0,2,0,2,0,0,1,1,1,1,0,2
292,119575,2021,Brazil,Japan,0,0,2,2,24/06/2021,3,0,11,14,0,0,0,0,0,0,0,0,0,0,0,0,2,0,0,2
293,119575,2021,Brazil,Netherlands,0,0,2,2,19/06/2021,1,0,2,3,0,0,0,0,0,0,0,0,0,0,0,0,1,0,0,1
294,119575,2021,Brazil,Thailand,0,0,3,3,14/06/2021,4,0,15,19,0,0,0,0,0,0,0,0,0,0,0,0,2,1,0,3
295,119575,2021,Poland,Brazil,0,1,4,5,12/06/2021,2,0,15,17,0,0,0,0,0,0,0,0,0,0,0,0,3,0,0,3
296,119575,2021,Belgium,Brazil,0,0,1,1,07/06/2021,2,0,9,11,0,0,0,0,0,0,0,0,0,0,0,0,1,0,0,1
297,119575,2021,Brazil,Italy,0,1,10,11,02/06/2021,20,0,63,83,0,0,1,1,0,1,3,4,0,0,1,1,7,3,2,12
298,119575,2021,Brazil,Japan,0,0,1,1,31/05/2021,1,0,8,9,0,0,0,0,0,0,0,0,0,0,0,0,3,0,0,3
299,119575,2021,Brazil,Dominican Republic,0,1,4,5,26/05/2021,0,0,14,14,0,0,0,0,0,0,0,0,0,0,0,0,0,0,0,0
300,136896,2021,Brazil,USA,0,2,22,24,25/06/2021,0,0,0,0,16,6,19,41,2,4,2,8,7,0,8,15,10,4,2,16
301,136896,2021,Brazil,Japan,1,1,19,21,24/06/2021,0,0,2,2,17,3,11,31,0,3,1,4,11,0,23,34,14,1,3,18
302,136896,2021,Brazil,Türkiye,1,1,8,10,20/06/2021,0,0,4,4,8,4,14,26,0,0,2,2,4,1,5,10,7,2,3,12
303,136896,2021,Brazil,Netherlands,1,0,14,15,19/06/2021,0,0,1,1,16,3,8,27,0,0,4,4,6,1,8,15,4,3,0,7
304,136896,2021,Korea,Brazil,0,0,16,16,18/06/2021,0,0,0,0,8,3,15,26,1,2,3,6,3,0,12,15,9,1,1,11
305,136896,2021,Brazil,Thailand,0,2,10,12,14/06/2021,0,0,1,1,8,0,8,16,2,0,0,2,12,0,6,18,8,0,0,8
306,136896,2021,Germany,Brazil,0,1,11,12,13/06/2021,0,0,0,0,19,5,10,34,2,5,2,9,7,2,17,26,8,3,1,12
307,136896,2021,Poland,Brazil,0,1,11,12,12/06/2021,0,0,0,0,12,3,10,25,3,3,1,7,5,2,9,16,7,2,0,9
308,136896,2021,China,Brazil,1,1,15,17,08/06/2021,0,0,3,3,15,5,10,30,3,1,3,7,11,0,21,32,21,3,4,28
309,136896,2021,Belgium,Brazil,2,1,11,14,07/06/2021,0,0,1,1,8,4,9,21,1,0,2,3,5,0,8,13,10,1,3,14
310,136896,2021,Brazil,Serbia,0,0,13,13,06/06/2021,0,0,0,0,6,2,3,11,0,0,1,1,9,0,6,15,12,0,2,14
311,136896,2021,Brazil,Italy,1,1,10,12,02/06/2021,0,0,2,2,7,4,11,22,0,1,1,2,12,0,10,22,14,1,2,17
312,136896,2021,Brazil,Russia,0,0,10,10,01/06/2021,0,0,0,0,1,4,11,16,1,1,2,4,4,1,11,16,16,2,1,19
313,136896,2021,Brazil,Japan,1,1,15,17,31/05/2021,0,0,3,3,8,5,6,19,1,2,4,7,1,0,5,6,14,1,0,15
314,136896,2021,Brazil,USA,0,1,14,15,27/05/2021,0,0,2,2,13,8,18,39,2,3,1,6,5,1,7,13,13,1,1,15
315,136896,2021,Brazil,Dominican Republic,0,3,6,9,26/05/2021,0,0,0,0,12,1,11,24,0,2,1,3,13,1,6,20,2,0,0,2
316,136896,2021,Brazil,Canada,0,0,16,16,25/05/2021,0,0,0,0,11,5,11,27,4,3,0,7,15,0,10,25,3,3,0,6
317,115958,2021,Brazil,USA,0,0,12,12,25/06/2021,0,0,2,2,15,7,14,36,2,6,1,9,0,0,1,1,6,3,4,13
318,115958,2021,Brazil,Japan,0,0,15,15,24/06/2021,0,0,2,2,22,4,21,47,1,3,9,13,0,0,0,0,15,3,2,20
319,115958,2021,Brazil,Türkiye,1,0,7,8,20/06/2021,0,0,2,2,17,1,18,36,1,3,3,7,0,0,0,0,11,1,0,12
320,115958,2021,Brazil,Netherlands,0,0,9,9,19/06/2021,0,0,0,0,12,3,10,25,1,5,3,9,0,0,0,0,11,3,3,17
321,115958,2021,Korea,Brazil,0,1,7,8,18/06/2021,0,0,2,2,13,3,11,27,0,2,3,5,0,0,0,0,7,0,1,8
322,115958,2021,Brazil,Thailand,2,1,10,13,14/06/2021,0,0,0,0,7,2,7,16,2,1,0,3,0,0,0,0,3,0,0,3
323,115958,2021,Germany,Brazil,1,0,18,19,13/06/2021,0,1,0,1,12,5,14,31,1,2,1,4,0,0,0,0,6,1,6,13
324,115958,2021,Poland,Brazil,0,1,7,8,12/06/2021,0,0,2,2,11,8,9,28,3,1,2,6,0,0,0,0,5,1,1,7
325,115958,2021,China,Brazil,0,0,17,17,08/06/2021,0,0,2,2,22,5,31,58,4,6,3,13,0,0,0,0,9,1,2,12
326,115958,2021,Belgium,Brazil,0,2,9,11,07/06/2021,0,0,1,1,16,1,7,24,1,3,1,5,0,0,0,0,3,2,2,7
327,115958,2021,Brazil,Serbia,0,1,10,11,06/06/2021,0,0,1,1,12,1,4,17,0,2,2,4,0,0,0,0,3,1,0,4
328,115958,2021,Brazil,Italy,0,0,17,17,02/06/2021,0,0,1,1,15,4,15,34,2,2,3,7,0,0,0,0,12,3,1,16
329,115958,2021,Brazil,Russia,1,1,6,8,01/06/2021,0,0,0,0,11,3,10,24,2,0,1,3,0,0,0,0,3,1,1,5
330,115958,2021,Brazil,Japan,0,0,13,13,31/05/2021,0,0,1,1,11,3,13,27,3,2,5,10,0,0,0,0,3,1,0,4
331,115958,2021,Brazil,USA,0,1,8,9,27/05/2021,0,0,2,2,11,4,21,36,2,2,6,10,0,0,0,0,5,1,2,8
332,115958,2021,Brazil,Dominican Republic,0,1,9,10,26/05/2021,0,0,0,0,14,4,4,22,0,0,0,0,0,0,0,0,4,0,0,4
333,115958,2021,Brazil,Canada,0,0,13,13,25/05/2021,0,0,0,0,13,4,13,30,0,2,1,3,0,1,0,1,3,3,0,6
334,115952,2021,Brazil,USA,0,0,7,7,25/06/2021,0,0,1,1,3,2,5,10,0,2,1,3,9,0,16,25,2,0,2,4
335,115952,2021,Brazil,Japan,0,0,3,3,24/06/2021,0,0,2,2,5,1,6,12,1,3,0,4,6,0,3,9,3,0,2,5
336,115952,2021,Brazil,Türkiye,0,0,12,12,20/06/2021,0,0,0,0,6,2,6,14,0,1,0,1,4,0,10,14,4,2,2,8
337,115952,2021,Brazil,Netherlands,0,0,1,1,19/06/2021,0,0,0,0,1,0,3,4,1,1,1,3,0,0,0,0,1,0,0,1
338,112366,2021,Brazil,Japan,0,0,0,0,24/06/2021,0,0,0,0,0,0,0,0,0,0,0,0,0,0,0,0,0,0,0,0
339,112366,2021,Brazil,Netherlands,0,1,0,1,19/06/2021,0,0,0,0,2,0,1,3,0,0,0,0,0,0,0,0,0,0,0,0
340,112366,2021,Korea,Brazil,0,0,0,0,18/06/2021,0,0,0,0,0,0,0,0,0,0,0,0,0,0,0,0,0,0,0,0
341,112366,2021,Brazil,Thailand,0,0,0,0,14/06/2021,0,0,0,0,0,0,0,0,0,0,0,0,0,0,0,0,0,0,0,0
342,112366,2021,Poland,Brazil,0,1,0,1,12/06/2021,0,0,0,0,1,0,4,5,0,0,1,1,0,0,0,0,0,0,0,0
343,112366,2021,Belgium,Brazil,0,0,0,0,07/06/2021,0,0,0,0,0,0,0,0,0,0,0,0,0,0,0,0,0,0,0,0
344,112366,2021,Brazil,Serbia,2,0,5,7,06/06/2021,0,0,0,0,3,0,3,6,0,1,0,1,0,0,0,0,2,0,0,2
345,112366,2021,Brazil,Russia,0,0,1,1,01/06/2021,0,0,0,0,3,2,1,6,0,1,1,2,0,0,0,0,1,0,0,1
346,112366,2021,Brazil,Japan,0,0,0,0,31/05/2021,0,0,0,0,0,0,0,0,0,0,0,0,0,0,0,0,0,0,0,0
347,112366,2021,Brazil,USA,0,1,0,1,27/05/2021,0,0,0,0,0,0,0,0,0,0,0,0,0,0,0,0,0,0,0,0
348,112366,2021,Brazil,Dominican Republic,0,0,1,1,26/05/2021,0,0,0,0,2,0,3,5,0,0,0,0,0,0,0,0,0,0,0,0
349,112366,2021,Brazil,Canada,0,0,0,0,25/05/2021,0,0,0,0,0,0,0,0,0,0,0,0,0,0,0,0,0,0,0,0
350,144866,2021,Brazil,USA,0,2,12,14,25/06/2021,0,0,2,2,9,3,4,16,8,6,8,22,0,0,0,0,0,1,0,1
351,144866,2021,Brazil,Japan,0,0,4,4,24/06/2021,0,0,0,0,2,0,1,3,2,1,1,4,0,0,0,0,0,0,0,0
352,144866,2021,Brazil,Türkiye,0,1,2,3,20/06/2021,0,0,0,0,4,0,1,5,1,4,1,6,0,0,0,0,0,0,0,0
353,144866,2021,Brazil,Thailand,0,0,4,4,14/06/2021,0,0,1,1,1,0,1,2,2,1,1,4,0,0,0,0,0,0,0,0
354,144866,2021,Germany,Brazil,0,2,16,18,13/06/2021,0,0,0,0,7,1,4,12,1,6,3,10,0,0,0,0,2,0,0,2
355,144866,2021,Poland,Brazil,0,1,5,6,12/06/2021,0,0,1,1,2,1,3,6,2,4,0,6,0,0,0,0,0,1,0,1
356,144866,2021,China,Brazil,0,1,10,11,08/06/2021,0,0,6,6,4,2,3,9,0,7,7,14,0,0,0,0,2,1,1,4
357,144866,2021,Belgium,Brazil,0,0,7,7,07/06/2021,0,0,1,1,3,0,0,3,2,5,2,9,0,0,0,0,1,0,0,1
358,144866,2021,Brazil,Serbia,0,2,6,8,06/06/2021,0,0,2,2,1,0,0,1,1,4,1,6,0,0,0,0,2,0,0,2
359,144866,2021,Brazil,Italy,1,3,16,20,02/06/2021,0,0,5,5,8,2,4,14,5,7,2,14,0,1,0,1,2,2,0,4
360,144866,2021,Brazil,Russia,6,1,18,25,01/06/2021,0,0,5,5,8,1,7,16,1,2,2,5,0,0,0,0,2,1,0,3
361,144866,2021,Brazil,Japan,1,1,9,11,31/05/2021,0,0,2,2,4,2,5,11,4,3,4,11,0,0,0,0,1,1,0,2
362,144866,2021,Brazil,Dominican Republic,0,0,0,0,26/05/2021,0,0,0,0,0,0,0,0,0,0,0,0,0,0,0,0,0,0,0,0
363,144866,2021,Brazil,Canada,1,1,16,18,25/05/2021,0,0,0,0,6,0,2,8,6,3,0,9,0,0,0,0,0,2,0,2
364,112641,2021,Brazil,USA,0,1,9,10,25/06/2021,0,0,0,0,6,4,8,18,0,3,1,4,11,1,21,33,6,3,2,11
365,112641,2021,Brazil,Japan,0,1,10,11,24/06/2021,0,0,0,0,12,3,15,30,1,2,1,4,3,0,7,10,10,1,3,14
366,112641,2021,Brazil,Türkiye,2,2,7,11,20/06/2021,0,0,2,2,9,1,20,30,2,4,5,11,5,1,5,11,10,0,2,12
367,112641,2021,Brazil,Netherlands,0,0,8,8,19/06/2021,0,0,1,1,6,2,17,25,0,4,4,8,9,0,12,21,9,3,2,14
368,112641,2021,Korea,Brazil,1,1,12,14,18/06/2021,0,0,2,2,10,2,9,21,2,0,0,2,4,1,17,22,6,3,2,11
369,112641,2021,Brazil,Thailand,0,0,6,6,14/06/2021,0,1,0,1,9,0,9,18,1,1,0,2,4,0,2,6,4,1,0,5
370,112641,2021,Germany,Brazil,0,0,21,21,13/06/2021,0,0,8,8,8,2,10,20,5,4,5,14,8,2,14,24,15,1,2,18
371,112641,2021,Poland,Brazil,0,2,10,12,12/06/2021,0,0,5,5,4,3,10,17,2,2,6,10,8,1,15,24,8,4,1,13
372,112641,2021,China,Brazil,0,1,13,14,08/06/2021,0,0,2,2,12,3,20,35,3,7,7,17,9,2,22,33,13,5,1,19
373,112641,2021,Belgium,Brazil,0,2,13,15,07/06/2021,0,0,1,1,9,3,10,22,0,2,3,5,7,1,10,18,6,2,1,9
374,112641,2021,Brazil,Serbia,0,1,4,5,06/06/2021,0,0,3,3,10,0,9,19,1,1,2,4,4,0,1,5,6,0,0,6
375,112641,2021,Brazil,Italy,0,0,0,0,02/06/2021,0,0,0,0,0,0,0,0,0,0,0,0,0,0,0,0,0,0,0,0
376,112641,2021,Brazil,Russia,0,1,12,13,01/06/2021,0,0,2,2,11,3,11,25,1,1,3,5,6,0,4,10,10,2,2,14
377,112641,2021,Brazil,Japan,0,1,8,9,31/05/2021,0,0,0,0,21,4,13,38,0,4,6,10,12,1,11,24,7,4,1,12
378,112641,2021,Brazil,USA,0,1,10,11,27/05/2021,0,0,1,1,17,1,16,34,1,4,1,6,19,3,24,46,11,5,2,18
379,112641,2021,Brazil,Dominican Republic,2,1,12,15,26/05/2021,0,0,0,0,11,1,9,21,1,1,2,4,6,0,7,13,1,1,1,3
380,112641,2021,Brazil,Canada,1,0,18,19,25/05/2021,0,0,1,1,10,0,14,24,3,2,1,6,8,0,3,11,5,2,1,8
381,173849,2021,Brazil,USA,0,0,0,0,25/06/2021,0,0,1,1,0,0,0,0,0,1,0,1,0,0,0,0,0,0,0,0
382,173849,2021,Brazil,Türkiye,0,1,1,2,20/06/2021,0,0,0,0,2,0,1,3,0,0,0,0,0,0,0,0,1,0,0,1
383,173849,2021,Korea,Brazil,0,0,2,2,18/06/2021,0,0,0,0,0,0,0,0,0,0,0,0,0,0,0,0,0,1,0,1
384,173849,2021,Germany,Brazil,0,0,0,0,13/06/2021,0,0,0,0,0,0,0,0,0,0,0,0,0,0,0,0,0,0,0,0
385,173849,2021,Poland,Brazil,0,0,2,2,12/06/2021,0,0,0,0,0,0,0,0,0,0,0,0,0,0,0,0,0,0,0,0
386,173849,2021,China,Brazil,0,0,0,0,08/06/2021,0,0,0,0,0,0,0,0,0,0,0,0,0,0,0,0,0,0,0,0
387,173849,2021,Brazil,Serbia,1,1,2,4,06/06/2021,0,0,0,0,3,1,3,7,1,1,0,2,0,0,3,3,1,1,0,2
388,173849,2021,Brazil,Italy,0,0,3,3,02/06/2021,0,0,0,0,0,0,5,5,0,0,0,0,2,3,2,7,0,0,1,1
389,173849,2021,Brazil,USA,0,0,0,0,27/05/2021,0,0,0,0,0,0,0,0,0,0,0,0,0,0,0,0,0,0,0,0
390,173849,2021,Brazil,Dominican Republic,0,0,0,0,26/05/2021,0,0,0,0,1,0,0,1,0,0,0,0,1,0,0,1,0,0,0,0
391,173849,2021,Brazil,Canada,0,0,0,0,25/05/2021,0,0,0,0,1,0,0,1,0,0,0,0,0,0,0,0,0,0,0,0
392,119241,2021,Brazil,USA,0,0,0,0,25/06/2021,0,0,13,13,0,0,0,0,0,0,0,0,4,1,12,17,17,1,1,19
393,119241,2021,Brazil,Japan,0,0,0,0,24/06/2021,0,0,15,15,0,0,0,0,0,0,0,0,8,4,17,29,10,3,1,14
394,119241,2021,Brazil,Türkiye,0,0,0,0,20/06/2021,0,0,9,9,0,0,0,0,0,0,0,0,13,2,20,35,21,2,2,25
395,119241,2021,Brazil,Netherlands,0,0,0,0,19/06/2021,0,0,7,7,0,0,0,0,0,0,0,0,10,0,6,16,12,2,1,15
396,119241,2021,Korea,Brazil,0,0,0,0,18/06/2021,0,0,3,3,0,0,0,0,0,0,0,0,6,1,11,18,12,1,1,14
397,119241,2021,Brazil,Thailand,0,0,0,0,14/06/2021,0,0,6,6,0,0,0,0,0,0,0,0,3,0,1,4,8,1,0,9
398,119241,2021,Germany,Brazil,0,0,0,0,13/06/2021,0,0,8,8,0,0,0,0,0,0,0,0,8,1,13,22,16,5,0,21
399,119241,2021,Poland,Brazil,0,0,0,0,12/06/2021,0,0,3,3,0,0,0,0,0,0,0,0,4,1,5,10,15,1,5,21
400,119241,2021,China,Brazil,0,0,0,0,08/06/2021,0,0,12,12,0,0,0,0,0,0,0,0,8,0,18,26,21,5,4,30
401,119241,2021,Belgium,Brazil,0,0,0,0,07/06/2021,0,0,3,3,0,0,0,0,0,0,0,0,5,1,5,11,16,1,1,18
402,119241,2021,Brazil,Serbia,0,0,0,0,06/06/2021,0,0,2,2,0,0,0,0,0,0,0,0,1,0,2,3,3,0,0,3
403,119241,2021,Brazil,Italy,0,0,0,0,02/06/2021,0,0,2,2,0,0,0,0,0,0,0,0,4,1,14,19,14,1,0,15
404,119241,2021,Brazil,Russia,0,0,0,0,01/06/2021,0,0,4,4,0,0,0,0,0,0,0,0,10,0,10,20,13,2,1,16
405,119241,2021,Brazil,Japan,0,0,0,0,31/05/2021,0,0,5,5,0,0,0,0,0,0,0,0,13,1,8,22,16,1,2,19
406,119241,2021,Brazil,USA,0,0,0,0,27/05/2021,0,0,12,12,0,0,0,0,0,0,0,0,9,1,18,28,16,1,2,19
407,119241,2021,Brazil,Dominican Republic,0,0,0,0,26/05/2021,0,0,2,2,0,0,0,0,0,0,0,0,8,0,5,13,6,1,0,7
408,119241,2021,Brazil,Canada,0,0,0,0,25/05/2021,0,0,0,0,0,0,0,0,0,0,0,0,4,0,8,12,11,3,0,14
409,119566,2021,Brazil,USA,0,0,0,0,25/06/2021,0,0,0,0,0,0,0,0,0,0,0,0,0,0,0,0,0,0,0,0
410,119566,2021,Brazil,Japan,1,2,12,15,24/06/2021,0,0,2,2,3,1,3,7,3,5,4,12,0,0,0,0,5,0,0,5
411,119566,2021,Brazil,Türkiye,1,1,17,19,20/06/2021,0,0,4,4,5,0,5,10,1,7,4,12,0,0,0,0,5,2,1,8
412,119566,2021,Brazil,Netherlands,1,0,10,11,19/06/2021,0,0,1,1,3,1,5,9,3,3,6,12,0,0,0,0,4,0,0,4
413,119566,2021,Korea,Brazil,0,0,6,6,18/06/2021,0,0,2,2,5,3,4,12,3,2,1,6,0,0,0,0,2,0,0,2
414,119566,2021,Brazil,Thailand,0,0,5,5,14/06/2021,0,0,0,0,4,0,3,7,3,3,1,7,0,0,0,0,0,0,0,0
415,119566,2021,Germany,Brazil,0,1,8,9,13/06/2021,0,0,2,2,10,1,5,16,2,6,7,15,0,0,1,1,2,0,0,2
416,119566,2021,China,Brazil,0,1,8,9,08/06/2021,0,0,1,1,2,0,2,4,0,2,7,9,0,0,1,1,2,0,1,3
417,119566,2021,Belgium,Brazil,0,0,3,3,07/06/2021,0,0,1,1,1,0,1,2,1,1,1,3,1,0,0,1,1,0,0,1
418,119566,2021,Brazil,Italy,1,2,11,14,02/06/2021,0,0,1,1,6,1,7,14,4,8,1,13,0,0,1,1,2,0,1,3
419,119566,2021,Brazil,Russia,0,0,0,0,01/06/2021,0,0,0,0,0,0,0,0,0,0,0,0,0,0,0,0,0,0,0,0
420,119566,2021,Brazil,Japan,0,0,0,0,31/05/2021,0,0,0,0,0,0,0,0,0,0,0,0,0,0,0,0,0,0,0,0
421,119566,2021,Brazil,USA,0,0,4,4,27/05/2021,0,0,1,1,1,0,2,3,0,3,3,6,0,0,1,1,2,1,0,3
422,119566,2021,Brazil,Dominican Republic,0,0,0,0,26/05/2021,0,0,0,0,0,0,0,0,0,0,0,0,0,0,0,0,0,0,0,0
423,119566,2021,Brazil,Canada,1,0,16,17,25/05/2021,0,0,0,0,5,2,7,14,5,1,1,7,0,0,1,1,1,0,0,1
424,141658,2021,Brazil,Thailand,1,0,4,5,14/06/2021,0,0,0,0,6,0,4,10,0,0,0,0,0,0,0,0,0,0,0,0
425,141658,2021,Germany,Brazil,0,0,1,1,13/06/2021,0,0,0,0,0,0,0,0,0,0,0,0,0,0,0,0,0,0,0,0
426,141658,2021,China,Brazil,0,0,4,4,08/06/2021,0,0,0,0,0,0,0,0,0,0,0,0,0,0,0,0,0,0,0,0
427,141658,2021,Belgium,Brazil,0,0,4,4,07/06/2021,0,0,0,0,0,0,0,0,0,0,0,0,0,0,0,0,1,0,0,1
428,141658,2021,Brazil,Italy,0,0,0,0,02/06/2021,0,0,0,0,1,0,3,4,0,0,1,1,0,0,0,0,1,0,0,1
429,141658,2021,Brazil,Russia,0,1,3,4,01/06/2021,0,0,0,0,1,0,0,1,0,0,0,0,0,0,0,0,0,0,1,1
430,141658,2021,Brazil,Japan,0,0,0,0,31/05/2021,0,0,0,0,0,0,0,0,0,0,0,0,0,0,0,0,0,0,0,0
431,141658,2021,Brazil,USA,0,0,4,4,27/05/2021,0,0,0,0,2,2,3,7,0,0,0,0,0,0,0,0,0,0,0,0
432,141658,2021,Brazil,Dominican Republic,0,0,0,0,26/05/2021,0,0,0,0,0,0,0,0,0,0,0,0,0,0,0,0,0,0,0,0
433,141658,2021,Brazil,Canada,0,0,3,3,25/05/2021,0,0,0,0,3,0,6,9,0,0,0,0,0,0,0,0,0,1,0,1
434,164673,2021,Brazil,USA,0,0,0,0,25/06/2021,0,0,0,0,0,0,0,0,0,0,0,0,0,0,0,0,0,0,0,0
435,164673,2021,Brazil,Türkiye,0,0,1,1,20/06/2021,0,0,0,0,3,0,0,3,1,1,3,5,0,0,0,0,0,0,0,0
436,164673,2021,Brazil,Netherlands,0,0,2,2,19/06/2021,0,0,0,0,1,0,0,1,0,1,1,2,0,0,0,0,0,0,0,0
437,164673,2021,Korea,Brazil,0,0,0,0,18/06/2021,0,0,0,0,0,0,0,0,0,0,0,0,0,0,0,0,0,0,0,0
438,164673,2021,Brazil,Thailand,0,1,0,1,14/06/2021,0,0,0,0,0,0,1,1,0,0,0,0,0,0,0,0,0,0,0,0
439,164673,2021,Germany,Brazil,0,0,0,0,13/06/2021,0,0,0,0,0,0,0,0,0,0,0,0,0,0,0,0,0,0,0,0
440,164673,2021,Poland,Brazil,0,0,0,0,12/06/2021,0,0,0,0,0,0,0,0,0,0,0,0,0,0,0,0,0,0,0,0
441,164673,2021,Belgium,Brazil,0,0,0,0,07/06/2021,0,0,0,0,0,0,0,0,0,0,0,0,0,0,0,0,0,0,0,0
442,164673,2021,Brazil,Serbia,2,0,7,9,06/06/2021,0,0,0,0,2,0,4,6,0,1,3,4,0,0,0,0,1,0,0,1
443,164673,2021,Brazil,Russia,0,0,0,0,01/06/2021,0,0,0,0,0,0,0,0,0,0,0,0,0,0,0,0,0,0,0,0
444,164673,2021,Brazil,USA,0,1,6,7,27/05/2021,0,0,2,2,8,0,3,11,1,1,1,3,1,0,2,3,1,0,1,2
445,164673,2021,Brazil,Dominican Republic,0,3,10,13,26/05/2021,0,0,0,0,2,2,2,6,1,2,0,3,0,0,0,0,0,0,0,0
446,174677,2021,Belgium,Canada,0,0,0,0,20/06/2021,0,0,6,6,0,0,0,0,0,0,0,0,2,1,6,9,9,2,0,11
447,174677,2021,Thailand,Canada,0,0,0,0,19/06/2021,0,0,4,4,0,0,0,0,0,0,0,0,2,1,16,19,8,3,1,12
448,174677,2021,Canada,Italy,0,0,0,0,18/06/2021,0,0,8,8,0,0,0,0,0,0,0,0,2,1,13,16,10,4,1,15
449,174677,2021,Korea,Canada,0,0,0,0,14/06/2021,1,0,14,15,0,0,0,0,0,0,0,0,1,1,14,16,12,7,2,21
450,174677,2021,Russia,Canada,0,0,0,0,13/06/2021,0,1,4,5,0,0,0,0,0,0,0,0,0,2,3,5,4,0,1,5
451,174677,2021,Canada,Serbia,0,0,0,0,12/06/2021,0,0,9,9,0,0,0,0,0,0,0,0,3,0,8,11,13,5,1,19
452,174677,2021,Canada,Netherlands,0,0,0,0,08/06/2021,0,0,3,3,0,0,0,0,0,0,0,0,1,2,15,18,8,4,0,12
453,174677,2021,Canada,Japan,0,0,0,0,07/06/2021,0,0,7,7,0,0,0,0,0,0,0,0,4,1,8,13,6,4,1,11
454,174677,2021,Canada,Poland,0,0,0,0,06/06/2021,0,0,9,9,0,0,0,0,0,0,0,0,6,1,6,13,11,6,1,18
455,174677,2021,Germany,Canada,0,0,0,0,02/06/2021,0,0,5,5,0,0,0,0,0,0,0,0,9,1,12,22,6,3,2,11
456,174677,2021,China,Canada,0,0,0,0,01/06/2021,0,0,11,11,0,0,0,0,0,0,0,0,8,2,15,25,12,10,3,25
457,174677,2021,Canada,Türkiye,0,0,0,0,31/05/2021,0,0,12,12,0,0,0,0,0,0,0,0,5,0,12,17,21,4,5,30
458,174677,2021,Canada,Dominican Republic,0,0,0,0,27/05/2021,0,0,0,0,0,0,0,0,0,0,0,0,0,0,0,0,0,0,0,0
459,174677,2021,USA,Canada,0,0,0,0,26/05/2021,0,0,0,0,0,0,0,0,0,0,0,0,0,0,1,1,0,0,0,0
460,174677,2021,Brazil,Canada,0,0,0,0,25/05/2021,0,1,10,11,0,0,0,0,0,0,0,0,2,1,14,17,3,3,0,6
461,168355,2021,Belgium,Canada,3,5,4,12,20/06/2021,0,0,2,2,15,2,10,27,0,5,1,6,5,0,8,13,9,2,0,11
462,168355,2021,Thailand,Canada,0,2,5,7,19/06/2021,0,0,3,3,8,1,14,23,0,2,3,5,2,1,5,8,5,1,1,7
463,168355,2021,Canada,Italy,0,1,11,12,18/06/2021,0,0,2,2,12,8,16,36,2,1,3,6,1,0,9,10,4,4,6,14
464,168355,2021,Korea,Canada,2,5,12,19,14/06/2021,0,0,7,7,21,7,19,47,1,7,2,10,3,0,5,8,19,5,5,29
465,168355,2021,Canada,Serbia,3,6,8,17,12/06/2021,0,0,2,2,17,5,17,39,1,3,5,9,0,0,0,0,9,3,2,14
466,168355,2021,Canada,Netherlands,0,2,5,7,08/06/2021,0,0,0,0,6,4,7,17,0,1,0,1,1,0,0,1,2,2,0,4
467,168355,2021,Canada,Japan,1,1,2,4,07/06/2021,0,0,2,2,6,1,7,14,2,3,2,7,0,1,5,6,1,0,2,3
468,168355,2021,Canada,Poland,2,6,6,14,06/06/2021,0,1,2,3,23,8,21,52,3,4,2,9,0,0,0,0,6,7,0,13
469,168355,2021,Germany,Canada,2,3,7,12,02/06/2021,0,0,3,3,16,8,11,35,0,2,1,3,0,0,1,1,2,0,1,3
470,168355,2021,China,Canada,2,4,11,17,01/06/2021,1,0,1,2,18,10,25,53,5,3,4,12,0,0,0,0,7,0,0,7
471,168355,2021,Canada,Türkiye,2,3,11,16,31/05/2021,0,0,4,4,24,12,24,60,1,2,6,9,4,0,12,16,13,3,3,19
472,168355,2021,Canada,Dominican Republic,1,2,10,13,27/05/2021,0,0,0,0,20,6,21,47,4,1,1,6,6,3,14,23,12,3,0,15
473,168355,2021,USA,Canada,0,1,3,4,26/05/2021,0,0,2,2,13,6,7,26,0,1,0,1,0,0,1,1,0,0,0,0
474,168355,2021,Brazil,Canada,0,3,6,9,25/05/2021,0,0,3,3,12,12,14,38,1,1,0,2,4,0,3,7,3,5,0,8
475,139517,2021,Belgium,Canada,0,0,0,0,20/06/2021,4,0,8,12,0,0,0,0,0,2,0,2,0,0,0,0,4,0,0,4
476,139517,2021,Canada,Italy,0,0,0,0,18/06/2021,0,0,0,0,0,0,0,0,0,0,0,0,0,0,0,0,0,0,0,0
477,139517,2021,Russia,Canada,0,1,1,2,13/06/2021,7,0,28,35,0,0,2,2,0,2,0,2,0,0,0,0,4,0,0,4
478,139517,2021,Canada,Serbia,0,0,0,0,12/06/2021,0,0,0,0,0,0,0,0,0,0,0,0,0,0,0,0,0,0,0,0
479,139517,2021,Canada,Poland,0,0,0,0,06/06/2021,1,0,2,3,0,0,0,0,0,0,0,0,0,0,0,0,0,1,0,1
480,139517,2021,Germany,Canada,0,0,0,0,02/06/2021,0,0,0,0,0,0,0,0,0,0,0,0,0,0,0,0,0,0,0,0
481,139517,2021,China,Canada,0,0,0,0,01/06/2021,1,0,9,10,0,0,0,0,0,0,0,0,0,0,0,0,0,0,0,0
482,139517,2021,Canada,Dominican Republic,0,0,0,0,27/05/2021,0,0,0,0,0,0,0,0,0,0,0,0,0,0,0,0,0,0,0,0
483,139517,2021,USA,Canada,0,0,2,2,26/05/2021,1,1,29,31,0,0,0,0,0,1,1,2,0,0,0,0,1,0,0,1
484,139517,2021,Brazil,Canada,0,1,0,1,25/05/2021,0,0,0,0,0,0,0,0,0,0,0,0,0,0,0,0,0,0,0,0
485,153629,2021,Canada,Italy,0,0,0,0,18/06/2021,0,0,0,0,0,0,0,0,0,0,0,0,0,0,0,0,0,0,0,0
486,153629,2021,Russia,Canada,0,0,4,4,13/06/2021,0,0,1,1,1,0,2,3,0,3,6,9,0,0,0,0,0,0,0,0
487,153629,2021,Canada,Serbia,0,0,0,0,12/06/2021,0,0,0,0,0,0,0,0,0,0,0,0,0,0,0,0,0,0,0,0
488,153629,2021,Canada,Netherlands,0,0,0,0,08/06/2021,0,0,0,0,0,0,0,0,0,0,0,0,0,0,0,0,0,0,0,0
489,153629,2021,Canada,Poland,0,0,0,0,06/06/2021,0,0,0,0,0,0,0,0,0,0,0,0,0,0,0,0,0,0,0,0
490,153629,2021,Germany,Canada,0,0,0,0,02/06/2021,0,0,0,0,0,0,0,0,0,0,0,0,0,0,0,0,0,0,0,0
491,153629,2021,Canada,Türkiye,0,0,0,0,31/05/2021,0,0,0,0,0,0,0,0,0,0,0,0,0,0,0,0,0,0,0,0
492,153629,2021,Canada,Dominican Republic,0,0,0,0,27/05/2021,0,0,0,0,0,0,0,0,0,0,0,0,0,0,0,0,0,0,0,0
493,153629,2021,USA,Canada,0,0,1,1,26/05/2021,0,0,0,0,0,1,2,3,0,0,0,0,0,0,0,0,0,0,0,0
494,153629,2021,Brazil,Canada,0,0,1,1,25/05/2021,0,0,0,0,0,0,1,1,0,0,0,0,0,0,0,0,0,0,0,0
495,163360,2021,Belgium,Canada,0,0,0,0,20/06/2021,0,0,0,0,0,0,0,0,0,0,0,0,0,0,0,0,0,0,0,0
496,163360,2021,Thailand,Canada,0,0,0,0,19/06/2021,0,0,0,0,0,0,0,0,0,0,0,0,0,0,0,0,0,0,0,0
497,163360,2021,Korea,Canada,0,0,0,0,14/06/2021,0,0,0,0,0,0,0,0,0,0,0,0,0,0,0,0,0,0,0,0
498,163360,2021,Russia,Canada,0,1,4,5,13/06/2021,0,0,0,0,3,0,4,7,1,3,6,10,0,0,1,1,1,1,0,2
499,163360,2021,Canada,Netherlands,0,0,0,0,08/06/2021,0,0,0,0,0,0,0,0,0,0,0,0,0,0,0,0,0,0,0,0
500,163360,2021,Canada,Japan,0,1,1,2,07/06/2021,0,0,0,0,0,0,2,2,0,0,0,0,0,0,0,0,1,0,0,1
501,163360,2021,China,Canada,0,0,0,0,01/06/2021,0,0,0,0,0,0,0,0,0,0,0,0,0,0,0,0,0,0,0,0
502,163360,2021,Brazil,Canada,0,0,0,0,25/05/2021,0,0,0,0,0,0,0,0,0,0,0,0,0,0,0,0,0,0,0,0
503,142777,2021,Belgium,Canada,0,0,0,0,20/06/2021,0,0,0,0,0,0,0,0,0,0,0,0,0,0,0,0,0,0,0,0
504,142777,2021,Thailand,Canada,0,0,0,0,19/06/2021,0,0,0,0,0,0,0,0,0,0,0,0,0,0,0,0,0,0,0,0
505,142777,2021,Canada,Italy,0,0,6,6,18/06/2021,0,0,0,0,1,0,0,1,1,2,4,7,0,0,1,1,2,2,0,4
506,142777,2021,Korea,Canada,0,0,0,0,14/06/2021,0,0,0,0,0,0,0,0,0,0,0,0,0,0,0,0,0,0,0,0
507,142777,2021,Russia,Canada,0,1,5,6,13/06/2021,0,0,0,0,4,1,1,6,2,1,0,3,0,0,0,0,1,1,0,2
508,142777,2021,Canada,Serbia,0,0,0,0,12/06/2021,0,0,0,0,0,0,0,0,0,0,0,0,0,0,0,0,0,0,0,0
509,142777,2021,Canada,Netherlands,0,0,10,10,08/06/2021,0,0,0,0,2,0,0,2,0,0,0,0,0,0,0,0,1,1,0,2
510,142777,2021,Canada,Japan,0,0,3,3,07/06/2021,0,0,0,0,2,0,0,2,1,2,0,3,0,0,0,0,0,0,0,0
511,142777,2021,Canada,Poland,0,0,0,0,06/06/2021,0,0,0,0,0,0,0,0,0,0,0,0,0,0,0,0,0,0,0,0
512,142777,2021,Germany,Canada,0,0,0,0,02/06/2021,0,0,0,0,0,0,0,0,0,0,0,0,0,0,0,0,0,0,0,0
513,142777,2021,China,Canada,0,0,0,0,01/06/2021,0,0,0,0,0,0,0,0,0,0,0,0,0,0,0,0,0,0,0,0
514,142777,2021,Canada,Türkiye,0,0,0,0,31/05/2021,0,0,0,0,0,0,0,0,0,0,0,0,0,0,0,0,0,0,0,0
515,132236,2021,Belgium,Canada,0,0,0,0,20/06/2021,0,0,0,0,0,0,0,0,0,0,0,0,0,0,1,1,2,0,0,2
516,132236,2021,Thailand,Canada,0,0,0,0,19/06/2021,0,0,0,0,0,0,0,0,0,0,0,0,1,0,0,1,0,0,0,0
517,132236,2021,Canada,Italy,0,0,0,0,18/06/2021,0,0,0,0,0,0,0,0,0,0,0,0,0,0,0,0,0,0,0,0
518,132236,2021,Russia,Canada,0,0,0,0,13/06/2021,0,0,0,0,0,0,0,0,0,0,0,0,0,0,2,2,0,0,0,0
519,132236,2021,Canada,Serbia,0,0,0,0,12/06/2021,0,0,0,0,0,0,0,0,0,0,0,0,1,2,3,6,0,0,0,0
520,132236,2021,Germany,Canada,0,0,0,0,02/06/2021,0,0,0,0,0,0,0,0,0,0,0,0,1,0,1,2,1,1,0,2
521,132236,2021,China,Canada,0,0,0,0,01/06/2021,0,0,0,0,0,0,0,0,0,0,0,0,0,0,2,2,0,1,0,1
522,132236,2021,Canada,Türkiye,0,0,0,0,31/05/2021,0,0,1,1,0,0,0,0,0,0,0,0,1,0,5,6,2,0,1,3
523,132236,2021,Canada,Dominican Republic,0,0,0,0,27/05/2021,0,0,16,16,0,0,0,0,0,0,0,0,7,6,16,29,12,4,0,16
524,132236,2021,USA,Canada,0,0,0,0,26/05/2021,0,0,8,8,0,0,0,0,0,0,0,0,1,1,16,18,3,1,0,4
525,132236,2021,Brazil,Canada,0,0,0,0,25/05/2021,0,0,0,0,0,0,0,0,0,0,0,0,0,0,0,0,0,0,0,0
526,173581,2021,Belgium,Canada,0,0,7,7,20/06/2021,0,0,4,4,7,3,13,23,1,1,3,5,5,3,16,24,4,0,0,4
527,173581,2021,Thailand,Canada,0,0,8,8,19/06/2021,0,0,1,1,2,2,8,12,0,1,0,1,1,1,7,9,2,1,0,3
528,173581,2021,Canada,Italy,0,0,10,10,18/06/2021,0,0,4,4,12,0,11,23,0,5,1,6,1,1,15,17,4,2,2,8
529,173581,2021,Korea,Canada,2,1,12,15,14/06/2021,0,0,1,1,16,3,22,41,1,2,4,7,8,4,25,37,7,5,2,14
530,173581,2021,Russia,Canada,0,0,3,3,13/06/2021,0,0,0,0,3,2,3,8,0,0,1,1,0,3,7,10,2,0,0,2
531,173581,2021,Canada,Serbia,2,3,14,19,12/06/2021,0,0,1,1,13,2,18,33,0,3,2,5,4,1,21,26,5,1,1,7
532,173581,2021,Canada,Netherlands,0,1,6,7,08/06/2021,0,1,3,4,8,5,11,24,0,1,0,1,4,1,16,21,2,2,0,4
533,173581,2021,Canada,Japan,1,2,5,8,07/06/2021,0,0,1,1,3,3,11,17,0,2,3,5,10,2,18,30,5,1,1,7
534,173581,2021,Canada,Poland,0,2,13,15,06/06/2021,0,0,0,0,13,6,14,33,0,5,0,5,7,2,36,45,1,3,0,4
535,173581,2021,Germany,Canada,2,1,12,15,02/06/2021,0,0,2,2,7,6,9,22,0,0,2,2,5,1,9,15,6,0,0,6
536,173581,2021,China,Canada,0,2,10,12,01/06/2021,0,0,1,1,17,4,24,45,0,3,2,5,12,2,20,34,4,3,2,9
537,173581,2021,Canada,Türkiye,1,2,11,14,31/05/2021,0,0,2,2,12,1,13,26,2,4,5,11,4,0,20,24,3,1,0,4
538,173581,2021,Canada,Dominican Republic,0,0,4,4,27/05/2021,0,0,1,1,3,3,2,8,1,0,0,1,0,0,5,5,1,1,0,2
539,173581,2021,USA,Canada,0,0,6,6,26/05/2021,0,0,2,2,3,2,16,21,0,0,2,2,4,1,16,21,2,0,0,2
540,173581,2021,Brazil,Canada,0,0,5,5,25/05/2021,0,0,0,0,8,6,13,27,0,3,2,5,9,2,24,35,2,0,0,2
541,139522,2021,Belgium,Canada,0,0,11,11,20/06/2021,0,0,2,2,3,1,4,8,2,4,4,10,0,0,0,0,3,1,1,5
542,139522,2021,Thailand,Canada,0,0,8,8,19/06/2021,0,0,0,0,6,1,0,7,0,1,9,10,0,0,0,0,2,1,0,3
543,139522,2021,Canada,Italy,0,0,11,11,18/06/2021,0,0,2,2,5,0,6,11,1,9,8,18,0,0,2,2,2,1,1,4
544,139522,2021,Korea,Canada,2,1,24,27,14/06/2021,0,0,1,1,4,0,4,8,2,3,2,7,0,0,0,0,2,0,1,3
545,139522,2021,Russia,Canada,0,0,0,0,13/06/2021,0,0,0,0,0,0,0,0,0,0,0,0,0,0,0,0,0,0,0,0
546,139522,2021,Canada,Serbia,1,0,19,20,12/06/2021,0,0,1,1,1,0,6,7,4,2,3,9,0,1,3,4,10,2,1,13
547,139522,2021,Canada,Netherlands,0,0,4,4,08/06/2021,0,0,0,0,1,1,5,7,0,0,1,1,0,0,0,0,0,1,0,1
548,139522,2021,Canada,Japan,0,1,5,6,07/06/2021,0,0,1,1,1,2,3,6,2,1,3,6,0,0,0,0,4,1,0,5
549,139522,2021,Canada,Poland,1,1,16,18,06/06/2021,0,0,2,2,4,4,6,14,4,3,4,11,1,1,0,2,5,0,1,6
550,139522,2021,Germany,Canada,1,0,12,13,02/06/2021,0,0,4,4,7,1,1,9,4,3,4,11,0,0,1,1,5,0,0,5
551,139522,2021,China,Canada,2,2,14,18,01/06/2021,0,0,0,0,7,3,4,14,4,3,5,12,0,0,1,1,0,0,0,0
552,139522,2021,Canada,Türkiye,1,1,20,22,31/05/2021,0,0,1,1,4,3,6,13,2,7,9,18,0,2,2,4,3,0,2,5
553,139522,2021,Canada,Dominican Republic,0,3,14,17,27/05/2021,0,0,1,1,6,2,6,14,1,4,2,7,0,0,0,0,4,0,0,4
554,139522,2021,USA,Canada,0,1,9,10,26/05/2021,0,0,1,1,1,0,3,4,0,1,0,1,0,0,1,1,0,0,0,0
555,139522,2021,Brazil,Canada,1,1,14,16,25/05/2021,0,0,1,1,6,2,5,13,1,4,2,7,0,0,0,0,2,2,0,4
556,173585,2021,Belgium,Canada,1,0,6,7,20/06/2021,19,1,48,68,1,0,3,4,1,1,1,3,0,0,0,0,8,1,1,10
557,173585,2021,Thailand,Canada,0,1,2,3,19/06/2021,12,0,52,64,0,1,0,1,0,2,2,4,0,0,0,0,2,0,2,4
558,173585,2021,Canada,Italy,0,0,8,8,18/06/2021,16,0,63,79,1,0,1,2,1,4,1,6,0,0,1,1,4,0,5,9
559,173585,2021,Korea,Canada,0,0,15,15,14/06/2021,37,1,83,121,1,0,4,5,2,5,2,9,0,0,1,1,7,1,3,11
560,173585,2021,Canada,Serbia,0,2,6,8,12/06/2021,24,0,86,110,1,0,2,3,2,2,0,4,0,1,0,1,12,6,2,20
561,173585,2021,Canada,Netherlands,1,0,4,5,08/06/2021,5,0,40,45,0,1,1,2,0,0,1,1,0,0,0,0,0,4,1,5
562,173585,2021,Canada,Japan,0,0,6,6,07/06/2021,3,1,35,39,0,0,1,1,0,2,0,2,0,0,0,0,3,1,2,6
563,173585,2021,Canada,Poland,1,1,12,14,06/06/2021,21,3,98,122,1,0,0,1,2,2,1,5,0,1,0,1,7,4,3,14
564,173585,2021,Germany,Canada,1,0,14,15,02/06/2021,10,2,62,74,3,0,1,4,0,5,1,6,0,0,0,0,12,2,2,16
565,173585,2021,China,Canada,3,1,13,17,01/06/2021,12,0,116,128,2,1,3,6,1,0,3,4,0,1,0,1,10,6,0,16
566,173585,2021,Canada,Türkiye,0,1,20,21,31/05/2021,28,0,101,129,3,0,1,4,1,3,3,7,0,0,0,0,15,6,2,23
567,173585,2021,Canada,Dominican Republic,2,4,11,17,27/05/2021,16,3,101,120,0,0,3,3,1,3,3,7,0,0,0,0,13,2,0,15
568,173585,2021,USA,Canada,0,1,2,3,26/05/2021,2,1,48,51,0,1,2,3,1,1,1,3,0,0,0,0,4,1,0,5
569,173585,2021,Brazil,Canada,0,1,5,6,25/05/2021,0,1,44,45,0,0,4,4,1,1,0,2,0,0,0,0,9,3,1,13
570,174676,2021,Belgium,Canada,0,2,7,9,20/06/2021,0,0,2,2,5,3,15,23,1,3,3,7,2,6,10,18,7,1,1,9
571,174676,2021,Thailand,Canada,0,3,5,8,19/06/2021,0,0,1,1,8,6,9,23,1,1,1,3,1,1,19,21,4,5,2,11
572,174676,2021,Canada,Italy,1,1,3,5,18/06/2021,0,0,0,0,1,6,4,11,0,1,0,1,3,2,12,17,3,1,1,5
573,174676,2021,Korea,Canada,0,3,7,10,14/06/2021,0,0,2,2,15,6,12,33,3,2,1,6,4,2,24,30,13,3,0,16
574,174676,2021,Russia,Canada,0,1,0,1,13/06/2021,0,0,0,0,4,2,4,10,0,0,0,0,1,1,10,12,1,1,1,3
575,174676,2021,Canada,Serbia,1,1,9,11,12/06/2021,0,0,1,1,15,5,11,31,1,1,1,3,2,1,26,29,6,3,2,11
576,174676,2021,Canada,Netherlands,0,2,5,7,08/06/2021,0,0,0,0,8,5,10,23,1,3,0,4,5,1,21,27,4,2,1,7
577,174676,2021,Canada,Japan,0,2,2,4,07/06/2021,0,0,2,2,4,5,10,19,2,1,0,3,2,2,13,17,7,2,0,9
578,174676,2021,Canada,Poland,1,3,15,19,06/06/2021,0,0,1,1,9,5,10,24,1,4,0,5,7,3,25,35,3,6,0,9
579,174676,2021,Germany,Canada,0,2,7,9,02/06/2021,0,0,3,3,4,1,5,10,2,1,3,6,1,1,13,15,1,3,1,5
580,174676,2021,China,Canada,1,0,20,21,01/06/2021,0,0,3,3,11,2,18,31,2,3,0,5,15,3,15,33,6,3,2,11
581,174676,2021,Canada,Türkiye,2,1,13,16,31/05/2021,0,0,5,5,11,3,16,30,2,0,4,6,1,1,28,30,10,4,5,19
582,174676,2021,Canada,Dominican Republic,0,3,10,13,27/05/2021,0,1,2,3,9,3,13,25,1,0,1,2,6,4,23,33,10,5,0,15
583,174676,2021,USA,Canada,0,0,8,8,26/05/2021,0,0,4,4,4,3,10,17,0,3,0,3,3,2,17,22,0,0,1,1
584,174676,2021,Brazil,Canada,0,3,6,9,25/05/2021,0,0,0,0,9,7,11,27,0,3,0,3,7,0,22,29,0,5,0,5
585,166581,2021,Belgium,Canada,0,0,2,2,20/06/2021,0,0,0,0,2,0,2,4,0,1,0,1,0,0,0,0,1,0,0,1
586,166581,2021,Thailand,Canada,0,1,5,6,19/06/2021,0,0,0,0,1,1,6,8,1,1,1,3,0,0,0,0,2,0,0,2
587,166581,2021,Canada,Italy,0,0,2,2,18/06/2021,0,0,0,0,6,0,3,9,0,2,1,3,0,0,0,0,2,2,1,5
588,166581,2021,Korea,Canada,0,0,0,0,14/06/2021,0,0,0,0,0,0,0,0,0,0,0,0,0,0,0,0,0,0,0,0
589,166581,2021,Russia,Canada,2,1,7,10,13/06/2021,0,1,1,2,8,2,7,17,0,2,2,4,0,0,0,0,4,1,1,6
590,166581,2021,Canada,Serbia,0,0,0,0,12/06/2021,0,0,0,0,0,0,0,0,0,0,0,0,0,0,0,0,0,0,0,0
591,166581,2021,Canada,Netherlands,0,0,2,2,08/06/2021,0,0,0,0,4,2,9,15,0,0,2,2,0,0,0,0,3,1,0,4
592,166581,2021,Canada,Japan,0,1,4,5,07/06/2021,0,0,0,0,6,3,9,18,1,3,4,8,0,0,0,0,3,0,0,3
593,166581,2021,Canada,Poland,0,0,0,0,06/06/2021,0,0,0,0,0,0,0,0,0,0,0,0,0,0,0,0,0,0,0,0
594,166581,2021,Germany,Canada,0,0,0,0,02/06/2021,0,0,0,0,0,0,0,0,0,0,0,0,0,0,0,0,0,0,0,0
595,166581,2021,China,Canada,0,0,0,0,01/06/2021,0,0,0,0,0,0,0,0,0,0,0,0,0,0,0,0,0,0,0,0
596,166581,2021,Canada,Türkiye,0,2,2,4,31/05/2021,0,0,0,0,2,1,3,6,0,2,0,2,0,0,0,0,1,1,0,2
597,166581,2021,Canada,Dominican Republic,1,1,8,10,27/05/2021,0,1,1,2,4,2,15,21,1,6,2,9,0,0,0,0,10,1,1,12
598,166581,2021,USA,Canada,0,0,3,3,26/05/2021,0,0,1,1,4,1,3,8,0,0,0,0,0,0,0,0,1,0,0,1
599,166581,2021,Brazil,Canada,0,0,4,4,25/05/2021,0,0,0,0,1,2,6,9,0,1,0,1,0,0,0,0,6,2,0,8
600,174680,2021,Belgium,Canada,0,1,0,1,20/06/2021,0,0,1,1,0,0,0,0,0,0,0,0,0,1,2,3,1,1,0,2
601,174680,2021,Thailand,Canada,1,1,2,4,19/06/2021,0,0,0,0,0,0,0,0,0,0,0,0,2,0,3,5,1,1,0,2
602,174680,2021,Canada,Italy,0,0,2,2,18/06/2021,0,0,0,0,0,0,0,0,0,0,0,0,0,0,4,4,1,1,0,2
603,174680,2021,Korea,Canada,1,0,9,10,14/06/2021,0,0,0,0,0,0,0,0,0,0,0,0,2,0,2,4,0,1,0,1
604,174680,2021,Russia,Canada,0,3,5,8,13/06/2021,0,0,0,0,6,4,7,17,0,4,0,4,5,2,14,21,2,3,3,8
605,174680,2021,Canada,Serbia,0,0,2,2,12/06/2021,0,0,0,0,0,0,0,0,0,0,0,0,2,0,1,3,0,0,0,0
606,174680,2021,Canada,Japan,0,0,0,0,07/06/2021,0,0,0,0,0,0,0,0,0,0,0,0,2,0,3,5,1,0,0,1
607,174680,2021,Canada,Poland,0,0,0,0,06/06/2021,0,0,0,0,0,0,1,1,0,0,0,0,1,0,0,1,0,0,0,0
608,174680,2021,Germany,Canada,0,0,0,0,02/06/2021,0,0,0,0,0,0,0,0,0,0,0,0,0,0,0,0,0,0,0,0
609,174680,2021,China,Canada,0,0,0,0,01/06/2021,0,0,0,0,0,0,0,0,0,0,0,0,0,0,0,0,0,0,0,0
610,174680,2021,Canada,Türkiye,0,0,0,0,31/05/2021,0,0,0,0,0,0,0,0,0,0,0,0,0,0,0,0,0,0,0,0
611,174680,2021,Canada,Dominican Republic,0,0,0,0,27/05/2021,0,0,0,0,0,0,0,0,0,0,0,0,0,0,0,0,0,0,0,0
612,174680,2021,USA,Canada,0,0,4,4,26/05/2021,0,0,0,0,1,2,2,5,0,2,0,2,0,0,1,1,0,0,0,0
613,174680,2021,Brazil,Canada,0,0,1,1,25/05/2021,0,0,0,0,0,2,2,4,0,0,0,0,2,0,2,4,1,0,0,1
614,156485,2021,Thailand,Canada,0,1,0,1,19/06/2021,2,0,11,13,0,0,0,0,1,0,0,1,0,0,0,0,0,1,0,1
615,156485,2021,Korea,Canada,0,0,0,0,14/06/2021,0,0,0,0,0,0,0,0,0,0,0,0,0,0,0,0,0,0,0,0
616,156485,2021,Russia,Canada,0,0,2,2,13/06/2021,7,1,16,24,0,0,1,1,0,0,0,0,0,0,2,2,1,1,0,2
617,156485,2021,Canada,Netherlands,0,1,1,2,08/06/2021,3,0,42,45,0,0,1,1,1,0,0,1,0,0,0,0,2,1,0,3
618,156485,2021,Canada,Japan,0,0,2,2,07/06/2021,4,1,36,41,0,0,0,0,0,1,4,5,0,0,0,0,1,2,1,4
619,156485,2021,Canada,Türkiye,0,0,0,0,31/05/2021,0,0,0,0,0,0,0,0,0,0,0,0,0,0,0,0,0,0,0,0
620,156485,2021,Canada,Dominican Republic,0,0,0,0,27/05/2021,0,0,0,0,0,0,0,0,0,0,0,0,0,0,0,0,0,0,0,0
621,156485,2021,USA,Canada,0,0,0,0,26/05/2021,0,0,0,0,0,0,0,0,0,0,0,0,0,0,0,0,0,0,0,0
622,168354,2021,Belgium,Canada,0,0,10,10,20/06/2021,0,0,4,4,5,2,7,14,3,5,4,12,0,0,0,0,7,1,0,8
623,168354,2021,Thailand,Canada,0,0,6,6,19/06/2021,0,0,1,1,11,0,7,18,2,11,6,19,0,0,1,1,4,2,3,9
624,168354,2021,Canada,Italy,0,1,2,3,18/06/2021,0,0,0,0,3,3,0,6,0,2,4,6,0,0,0,0,0,0,0,0
625,168354,2021,Korea,Canada,2,3,10,15,14/06/2021,0,0,1,1,8,2,11,21,2,9,6,17,0,0,1,1,5,1,0,6
626,168354,2021,Canada,Serbia,1,4,14,19,12/06/2021,0,0,3,3,12,1,5,18,4,6,4,14,0,0,0,0,7,3,0,10
627,168354,2021,Canada,Netherlands,1,0,8,9,08/06/2021,0,0,2,2,4,1,7,12,2,1,2,5,0,0,1,1,2,2,0,4
628,168354,2021,Canada,Japan,0,2,5,7,07/06/2021,0,0,2,2,3,0,7,10,1,6,3,10,0,0,0,0,0,0,1,1
629,168354,2021,Canada,Poland,0,1,14,15,06/06/2021,0,0,2,2,9,2,3,14,4,0,2,6,0,0,0,0,3,2,1,6
630,168354,2021,Germany,Canada,0,0,16,16,02/06/2021,0,0,2,2,7,0,4,11,1,6,4,11,0,0,0,0,4,1,1,6
631,168354,2021,China,Canada,1,3,11,15,01/06/2021,0,0,2,2,4,2,6,12,2,6,4,12,0,0,1,1,1,1,0,2
632,168354,2021,Canada,Türkiye,0,2,13,15,31/05/2021,0,0,4,4,8,2,10,20,5,6,10,21,1,0,1,2,3,2,1,6
633,168354,2021,Canada,Dominican Republic,1,2,11,14,27/05/2021,0,0,0,0,9,1,9,19,2,4,3,9,0,0,1,1,9,2,0,11
634,168354,2021,USA,Canada,0,0,8,8,26/05/2021,0,0,0,0,3,2,7,12,1,2,4,7,1,0,0,1,1,0,0,1
635,168354,2021,Brazil,Canada,0,0,8,8,25/05/2021,0,0,0,0,8,4,9,21,2,1,2,5,2,0,2,4,0,1,0,1
636,181178,2021,Belgium,Canada,0,0,0,0,20/06/2021,0,0,5,5,0,0,0,0,0,0,0,0,0,0,0,0,1,3,1,5
637,181178,2021,Thailand,Canada,0,0,0,0,19/06/2021,0,0,2,2,0,0,0,0,0,0,0,0,1,1,3,5,2,0,1,3
638,181178,2021,Canada,Italy,0,0,0,0,18/06/2021,0,0,0,0,0,0,0,0,0,0,0,0,0,0,0,0,0,0,0,0
639,181178,2021,Korea,Canada,0,0,0,0,14/06/2021,0,0,0,0,0,0,0,0,0,0,0,0,0,0,0,0,0,0,0,0
640,181178,2021,Russia,Canada,0,0,0,0,13/06/2021,0,0,2,2,0,0,0,0,0,0,0,0,2,1,8,11,2,1,2,5
641,181178,2021,Canada,Serbia,0,0,0,0,12/06/2021,0,0,0,0,0,0,0,0,0,0,0,0,0,0,0,0,0,0,0,0
642,181178,2021,Canada,Netherlands,0,0,0,0,08/06/2021,0,0,0,0,0,0,0,0,0,0,0,0,0,0,0,0,0,0,0,0
643,181178,2021,Canada,Japan,0,0,0,0,07/06/2021,0,0,0,0,0,0,0,0,0,0,0,0,0,0,0,0,0,1,0,1
644,181178,2021,Canada,Poland,0,0,0,0,06/06/2021,0,0,0,0,0,0,0,0,0,0,0,0,0,0,0,0,0,0,0,0
645,181178,2021,Germany,Canada,0,0,0,0,02/06/2021,0,0,0,0,0,0,0,0,0,0,0,0,0,0,0,0,0,0,0,0
646,181178,2021,China,Canada,0,0,0,0,01/06/2021,0,0,0,0,0,0,0,0,0,0,0,0,0,0,0,0,0,0,0,0
647,181178,2021,Canada,Türkiye,0,0,0,0,31/05/2021,0,0,0,0,0,0,0,0,0,0,0,0,0,0,0,0,0,0,0,0
648,181177,2021,Korea,Canada,0,0,0,0,14/06/2021,0,0,0,0,0,0,0,0,0,0,0,0,0,0,0,0,0,0,0,0
649,181177,2021,Russia,Canada,0,0,1,1,13/06/2021,0,0,0,0,0,2,1,3,0,0,1,1,0,1,2,3,1,0,0,1
650,181177,2021,Canada,Netherlands,0,0,0,0,08/06/2021,0,0,0,0,0,0,0,0,0,0,0,0,0,0,0,0,0,0,0,0
651,181177,2021,Canada,Japan,0,0,0,0,07/06/2021,0,0,0,0,0,0,0,0,0,0,0,0,0,0,0,0,0,0,0,0
652,181177,2021,Canada,Poland,0,0,0,0,06/06/2021,0,0,0,0,0,0,0,0,0,0,0,0,0,0,1,1,0,0,0,0
653,181177,2021,Canada,Dominican Republic,0,0,0,0,27/05/2021,0,0,0,0,0,0,0,0,0,0,0,0,0,0,0,0,0,0,0,0
654,181177,2021,USA,Canada,0,1,0,1,26/05/2021,0,0,0,0,0,0,0,0,0,0,0,0,0,0,1,1,0,0,0,0
655,181177,2021,Brazil,Canada,0,0,0,0,25/05/2021,0,0,0,0,0,0,0,0,0,0,0,0,0,0,0,0,0,0,0,0
656,135746,2021,China,USA,0,2,6,8,20/06/2021,0,0,0,0,5,0,6,11,2,2,5,9,0,0,0,0,2,1,0,3
657,135746,2021,China,Poland,2,1,6,9,19/06/2021,0,0,0,0,8,0,3,11,2,5,7,14,0,0,0,0,2,2,1,5
658,135746,2021,China,Russia,0,0,17,17,18/06/2021,0,0,7,7,4,0,6,10,2,6,3,11,3,0,5,8,2,2,0,4
659,135746,2021,China,Italy,3,1,13,17,14/06/2021,0,0,1,1,7,0,6,13,1,2,3,6,0,0,0,0,0,0,0,0
660,135746,2021,Dominican Republic,China,1,0,24,25,13/06/2021,0,0,1,1,6,1,9,16,4,11,4,19,0,0,0,0,2,0,0,2
661,135746,2021,China,Netherlands,1,2,13,16,12/06/2021,0,0,4,4,11,1,7,19,2,2,3,7,0,0,0,0,3,1,0,4
662,133588,2021,China,USA,2,0,13,15,20/06/2021,0,0,2,2,13,1,4,18,1,1,1,3,1,0,3,4,2,4,0,6
663,133588,2021,China,Poland,0,0,0,0,19/06/2021,0,0,0,0,0,0,0,0,0,0,0,0,0,0,0,0,0,0,0,0
664,133588,2021,China,Russia,0,0,10,10,18/06/2021,0,1,6,7,14,0,15,29,1,2,1,4,3,1,6,10,4,2,1,7
665,133588,2021,China,Italy,0,0,0,0,14/06/2021,0,0,0,0,0,0,0,0,0,0,0,0,0,0,0,0,0,0,0,0
666,133588,2021,Dominican Republic,China,0,0,14,14,13/06/2021,0,0,2,2,14,1,14,29,2,5,2,9,3,0,6,9,7,1,1,9
667,133588,2021,China,Netherlands,0,0,5,5,12/06/2021,0,0,8,8,10,1,7,18,0,1,1,2,0,0,2,2,9,2,0,11
668,152337,2021,China,USA,0,0,0,0,20/06/2021,0,0,0,0,0,0,0,0,0,0,0,0,0,0,0,0,0,0,0,0
669,152337,2021,China,Poland,0,0,0,0,19/06/2021,0,0,0,0,0,0,0,0,0,0,0,0,0,0,0,0,0,0,0,0
670,152337,2021,China,Russia,0,0,0,0,18/06/2021,0,0,0,0,0,0,0,0,0,0,0,0,0,0,0,0,0,0,0,0
671,152337,2021,Dominican Republic,China,0,0,1,1,13/06/2021,0,0,0,0,0,0,1,1,0,2,1,3,0,0,0,0,0,1,0,1
672,152337,2021,China,Netherlands,0,0,0,0,12/06/2021,0,0,0,0,0,0,0,0,0,0,0,0,0,0,0,0,0,0,0,0
673,152337,2021,China,Brazil,0,0,15,15,08/06/2021,0,0,3,3,13,1,7,21,1,5,9,15,0,0,0,0,0,2,0,2
674,152337,2021,China,Serbia,0,1,14,15,07/06/2021,0,0,0,0,7,0,4,11,5,1,0,6,0,0,0,0,0,1,0,1
675,152337,2021,China,Belgium,0,1,9,10,06/06/2021,0,1,2,3,12,7,5,24,3,8,5,16,1,0,0,1,2,0,0,2
676,152337,2021,China,Türkiye,0,0,6,6,02/06/2021,0,0,1,1,1,2,0,3,0,2,1,3,0,0,0,0,1,0,0,1
677,152337,2021,China,Canada,1,2,8,11,01/06/2021,1,0,1,2,3,1,8,12,1,5,2,8,0,0,0,0,0,0,0,0
678,152337,2021,China,Germany,0,2,14,16,31/05/2021,0,0,0,0,10,2,5,17,4,7,1,12,1,0,1,2,1,1,0,2
679,152337,2021,China,Thailand,0,2,7,9,27/05/2021,0,0,1,1,5,0,2,7,3,3,4,10,0,0,0,0,1,1,0,2
680,152337,2021,China,Japan,0,0,5,5,26/05/2021,0,0,0,0,2,0,5,7,3,4,0,7,0,0,0,0,0,0,0,0
681,152337,2021,China,Korea,1,3,7,11,25/05/2021,0,0,2,2,5,2,10,17,2,3,3,8,1,0,0,1,1,0,0,1
682,143206,2021,China,USA,1,1,13,15,20/06/2021,0,0,4,4,11,1,5,17,0,2,1,3,10,0,7,17,4,4,0,8
683,143206,2021,China,Poland,0,1,14,15,19/06/2021,0,0,1,1,10,2,7,19,1,3,1,5,2,1,5,8,9,2,0,11
684,143206,2021,China,Russia,0,0,10,10,18/06/2021,0,1,2,3,11,0,6,17,2,2,3,7,1,0,6,7,12,2,4,18
685,143206,2021,China,Italy,1,1,7,9,14/06/2021,0,0,1,1,9,1,5,15,0,0,0,0,3,1,8,12,12,3,1,16
686,143206,2021,Dominican Republic,China,0,2,11,13,13/06/2021,0,0,1,1,9,6,13,28,1,1,4,6,4,1,6,11,9,4,2,15
687,143206,2021,China,Netherlands,1,0,19,20,12/06/2021,0,0,2,2,15,6,16,37,1,3,1,5,5,0,8,13,12,4,1,17
688,143201,2021,China,USA,0,0,0,0,20/06/2021,0,0,0,0,0,0,0,0,0,0,0,0,0,0,0,0,0,0,0,0
689,143201,2021,China,Poland,1,0,12,13,19/06/2021,0,0,2,2,3,0,3,6,2,2,8,12,0,0,0,0,0,1,1,2
690,143201,2021,China,Russia,0,0,0,0,18/06/2021,0,0,0,0,0,0,0,0,0,0,0,0,0,0,0,0,0,0,0,0
691,143201,2021,China,Italy,0,0,0,0,14/06/2021,0,0,0,0,0,0,0,0,0,0,0,0,0,0,0,0,0,0,0,0
692,143201,2021,Dominican Republic,China,0,0,0,0,13/06/2021,0,0,0,0,0,0,0,0,0,0,0,0,0,0,0,0,0,0,0,0
693,143201,2021,China,Netherlands,0,0,0,0,12/06/2021,0,0,0,0,0,0,0,0,0,0,0,0,0,0,0,0,0,0,0,0
694,143201,2021,China,Brazil,0,1,15,16,08/06/2021,0,0,3,3,8,1,10,19,3,5,8,16,0,0,0,0,3,2,0,5
695,143201,2021,China,Serbia,0,0,8,8,07/06/2021,0,0,1,1,7,2,3,12,2,2,1,5,0,0,0,0,0,0,0,0
696,143201,2021,China,Belgium,0,1,17,18,06/06/2021,0,0,5,5,14,1,5,20,1,8,3,12,0,1,0,1,4,0,0,4
697,143201,2021,China,Türkiye,1,1,4,6,02/06/2021,0,0,1,1,2,2,6,10,0,2,4,6,0,0,0,0,1,0,0,1
698,143201,2021,China,Canada,1,0,11,12,01/06/2021,0,0,0,0,8,1,8,17,0,4,0,4,0,0,0,0,1,1,0,2
699,143201,2021,China,Germany,0,1,6,7,31/05/2021,0,0,0,0,2,0,2,4,0,1,0,1,0,0,0,0,0,2,0,2
700,143201,2021,China,Thailand,1,0,10,11,27/05/2021,0,0,0,0,10,2,5,17,3,5,8,16,0,0,1,1,3,0,1,4
701,143201,2021,China,Japan,0,1,6,7,26/05/2021,0,0,1,1,6,0,8,14,1,0,0,1,0,1,0,1,1,0,0,1
702,143201,2021,China,Korea,0,2,6,8,25/05/2021,0,0,0,0,2,0,5,7,1,4,2,7,0,0,0,0,1,0,0,1
703,152486,2021,China,USA,0,0,0,0,20/06/2021,0,0,0,0,0,0,0,0,0,0,0,0,0,0,0,0,0,0,0,0
704,152486,2021,China,Poland,0,1,0,1,19/06/2021,0,0,0,0,1,0,2,3,0,0,0,0,0,0,2,2,0,0,0,0
705,152486,2021,China,Italy,0,0,0,0,14/06/2021,0,0,0,0,0,0,0,0,0,0,0,0,0,0,0,0,0,0,0,0
706,152486,2021,Dominican Republic,China,0,0,0,0,13/06/2021,0,0,0,0,0,0,0,0,0,0,0,0,0,0,0,0,0,0,0,0
707,152486,2021,China,Netherlands,0,0,0,0,12/06/2021,0,0,0,0,0,0,1,1,0,0,0,0,0,0,0,0,0,0,0,0
708,152486,2021,China,Brazil,0,0,16,16,08/06/2021,0,0,4,4,4,3,15,22,0,6,3,9,5,0,14,19,9,8,7,24
709,152486,2021,China,Serbia,1,0,11,12,07/06/2021,0,0,1,1,8,4,15,27,4,2,2,8,3,2,12,17,2,2,1,5
710,152486,2021,China,Belgium,0,3,9,12,06/06/2021,0,0,6,6,12,7,22,41,0,5,2,7,5,3,6,14,16,1,2,19
711,152486,2021,China,Türkiye,0,1,6,7,02/06/2021,0,0,2,2,6,5,15,26,1,2,3,6,4,0,5,9,9,2,0,11
712,152486,2021,China,Canada,0,0,10,10,01/06/2021,0,0,3,3,9,4,15,28,0,2,3,5,0,0,1,1,6,2,0,8
713,152486,2021,China,Germany,0,3,10,13,31/05/2021,0,0,0,0,9,4,20,33,2,1,0,3,1,0,0,1,3,2,0,5
714,152486,2021,China,Thailand,2,0,15,17,27/05/2021,0,0,1,1,9,1,11,21,1,3,1,5,2,0,0,2,9,4,2,15
715,152486,2021,China,Japan,0,0,7,7,26/05/2021,0,1,0,1,5,2,9,16,1,3,0,4,0,0,1,1,2,0,0,2
716,152486,2021,China,Korea,2,2,17,21,25/05/2021,0,0,1,1,10,1,10,21,2,6,3,11,0,0,1,1,8,2,0,10
717,131973,2021,China,USA,1,1,8,10,20/06/2021,0,0,0,0,10,2,11,23,2,0,0,2,4,1,5,10,3,2,0,5
718,131973,2021,China,Poland,0,0,14,14,19/06/2021,0,0,2,2,18,2,4,24,3,3,4,10,6,0,9,15,5,2,0,7
719,131973,2021,China,Russia,0,0,0,0,18/06/2021,0,0,0,0,0,0,0,0,0,0,0,0,0,0,0,0,0,0,0,0
720,131973,2021,China,Italy,0,2,14,16,14/06/2021,0,0,2,2,9,0,17,26,2,1,1,4,10,0,7,17,4,2,0,6
721,131973,2021,Dominican Republic,China,2,0,6,8,13/06/2021,0,0,3,3,11,2,7,20,1,0,3,4,5,0,6,11,9,1,0,10
722,131973,2021,China,Netherlands,0,0,5,5,12/06/2021,0,0,1,1,7,1,5,13,0,0,1,1,8,1,5,14,5,4,1,10
723,131973,2021,China,Brazil,2,0,15,17,08/06/2021,0,0,4,4,32,4,24,60,2,4,3,9,5,1,10,16,10,2,5,17
724,131973,2021,China,Serbia,0,0,0,0,07/06/2021,0,0,0,0,0,0,0,0,0,0,0,0,0,0,0,0,0,0,0,0
725,131973,2021,China,Belgium,0,1,21,22,06/06/2021,0,0,6,6,35,9,33,77,2,6,5,13,1,1,12,14,9,1,3,13
726,131973,2021,China,Türkiye,0,0,0,0,02/06/2021,0,0,0,0,0,0,0,0,0,0,0,0,0,0,0,0,0,0,0,0
727,131973,2021,China,Canada,2,1,15,18,01/06/2021,0,0,1,1,18,10,21,49,2,2,0,4,9,1,12,22,8,2,2,12
728,131973,2021,China,Germany,2,1,16,19,31/05/2021,0,0,0,0,16,8,22,46,5,2,3,10,6,1,17,24,11,4,1,16
729,131973,2021,China,Thailand,1,2,6,9,27/05/2021,0,0,0,0,15,3,7,25,2,2,0,4,9,1,7,17,3,1,2,6
730,131973,2021,China,Japan,0,0,0,0,26/05/2021,0,0,0,0,0,2,4,6,0,0,0,0,0,0,0,0,0,0,0,0
731,131973,2021,China,Korea,1,2,11,14,25/05/2021,0,0,1,1,16,8,19,43,6,3,3,12,9,0,8,17,14,0,1,15
732,124132,2021,China,Poland,0,0,0,0,19/06/2021,0,0,0,0,0,0,0,0,0,0,0,0,0,0,0,0,0,0,0,0
733,124132,2021,China,Russia,0,0,0,0,18/06/2021,0,0,0,0,0,0,0,0,0,0,0,0,0,0,0,0,0,0,0,0
734,124132,2021,China,Italy,0,0,0,0,14/06/2021,0,0,0,0,0,0,0,0,0,0,0,0,0,0,0,0,0,0,0,0
735,124132,2021,China,Netherlands,0,0,0,0,12/06/2021,0,0,0,0,0,0,0,0,0,0,0,0,0,0,0,0,0,0,0,0
736,124132,2021,China,Brazil,0,0,12,12,08/06/2021,0,0,6,6,8,6,21,35,1,6,1,8,7,1,29,37,15,2,2,19
737,124132,2021,China,Serbia,0,1,11,12,07/06/2021,0,0,2,2,12,4,17,33,0,0,3,3,15,1,19,35,4,1,0,5
738,124132,2021,China,Belgium,0,1,3,4,06/06/2021,0,0,2,2,1,2,6,9,0,1,0,1,3,1,11,15,6,0,0,6
739,124132,2021,China,Türkiye,0,0,0,0,02/06/2021,0,0,0,0,0,0,0,0,0,0,0,0,1,0,3,4,0,1,0,1
740,124132,2021,China,Canada,1,0,8,9,01/06/2021,0,0,0,0,3,4,11,18,0,3,1,4,2,3,11,16,2,7,0,9
741,124132,2021,China,Germany,0,2,15,17,31/05/2021,0,0,0,0,9,2,24,35,0,4,0,4,12,2,17,31,4,3,0,7
742,124132,2021,China,Thailand,0,0,0,0,27/05/2021,0,0,0,0,0,0,0,0,0,0,0,0,0,0,0,0,0,0,0,0
743,124132,2021,China,Japan,0,1,3,4,26/05/2021,0,0,1,1,4,1,5,10,0,2,0,2,7,2,8,17,1,3,0,4
744,124132,2021,China,Korea,0,1,1,2,25/05/2021,0,0,0,0,0,1,1,2,0,2,0,2,2,0,6,8,4,0,0,4
745,123841,2021,China,USA,0,0,0,0,20/06/2021,0,0,0,0,0,0,0,0,0,0,0,0,0,0,0,0,0,0,0,0
746,123841,2021,China,Poland,0,0,8,8,19/06/2021,18,1,39,58,0,0,0,0,0,2,4,6,0,0,0,0,4,1,0,5
747,123841,2021,China,Russia,0,0,0,0,18/06/2021,8,0,6,14,0,0,0,0,0,0,0,0,0,0,0,0,3,0,0,3
748,123841,2021,China,Italy,0,0,0,0,14/06/2021,0,0,0,0,0,0,0,0,0,0,0,0,0,0,0,0,0,0,0,0
749,123841,2021,Dominican Republic,China,0,0,5,5,13/06/2021,10,0,36,46,0,0,1,1,1,2,1,4,0,0,0,0,8,0,3,11
750,123841,2021,China,Netherlands,0,0,0,0,12/06/2021,0,0,9,9,0,0,0,0,0,0,0,0,0,0,0,0,1,0,0,1
751,123841,2021,China,Brazil,0,1,14,15,08/06/2021,52,2,64,118,0,0,0,0,2,1,6,9,0,0,0,0,13,2,1,16
752,123841,2021,China,Serbia,0,0,0,0,07/06/2021,0,0,5,5,0,0,0,0,0,1,0,1,0,0,0,0,0,0,0,0
753,123841,2021,China,Belgium,0,1,23,24,06/06/2021,50,1,90,141,0,0,1,1,0,3,4,7,0,0,0,0,16,2,1,19
754,123841,2021,China,Türkiye,0,0,10,10,02/06/2021,13,1,84,98,0,0,0,0,0,1,2,3,0,0,0,0,13,3,2,18
755,123841,2021,China,Canada,1,2,10,13,01/06/2021,11,0,105,116,1,0,1,2,0,4,1,5,0,0,0,0,10,3,0,13
756,123841,2021,China,Germany,1,1,12,14,31/05/2021,13,1,1,15,0,1,2,3,2,2,0,4,0,0,0,0,2,2,0,4
757,123841,2021,China,Thailand,0,1,12,13,27/05/2021,37,0,44,81,0,0,1,1,0,1,0,1,0,0,0,0,0,1,1,2
758,123841,2021,China,Japan,0,0,0,0,26/05/2021,0,0,9,9,0,0,0,0,0,0,0,0,0,0,0,0,1,1,0,2
759,123841,2021,China,Korea,0,0,9,9,25/05/2021,10,1,104,115,0,0,3,3,0,3,2,5,0,0,0,0,7,1,0,8
760,152318,2021,China,USA,0,0,0,0,20/06/2021,0,0,0,0,0,0,0,0,0,0,0,0,0,0,0,0,0,0,0,0
761,152318,2021,China,Poland,1,1,10,12,19/06/2021,0,0,4,4,17,1,5,23,0,0,1,1,7,1,14,22,4,2,1,7
762,152318,2021,China,Russia,1,1,15,17,18/06/2021,0,0,3,3,18,5,8,31,0,1,4,5,2,2,7,11,7,1,2,10
763,152318,2021,China,Italy,2,2,8,12,14/06/2021,0,0,1,1,15,1,10,26,2,1,0,3,4,0,4,8,5,1,0,6
764,152318,2021,Dominican Republic,China,0,1,6,7,13/06/2021,0,0,1,1,12,0,1,13,1,0,0,1,5,0,6,11,4,1,0,5
765,152318,2021,China,Netherlands,2,1,8,11,12/06/2021,0,0,0,0,17,5,15,37,0,2,1,3,9,1,13,23,6,0,1,7
766,133146,2021,China,USA,0,0,0,0,20/06/2021,0,0,0,0,0,0,0,0,0,0,0,0,0,0,0,0,0,0,0,0
767,133146,2021,China,Poland,0,0,0,0,19/06/2021,0,0,5,5,0,0,0,0,0,0,0,0,1,1,6,8,3,2,0,5
768,133146,2021,China,Russia,0,0,0,0,18/06/2021,0,0,0,0,0,0,0,0,0,0,0,0,0,0,0,0,0,0,0,0
769,133146,2021,China,Italy,0,0,0,0,14/06/2021,0,0,3,3,0,0,0,0,0,0,0,0,1,2,3,6,8,1,1,10
770,133146,2021,Dominican Republic,China,0,0,0,0,13/06/2021,0,0,0,0,0,0,0,0,0,0,0,0,2,0,4,6,1,0,0,1
771,133146,2021,China,Netherlands,0,0,0,0,12/06/2021,0,0,0,0,0,0,0,0,0,0,0,0,0,0,0,0,0,0,0,0
772,133146,2021,China,Brazil,0,0,0,0,08/06/2021,0,0,0,0,0,0,0,0,0,0,0,0,0,0,0,0,0,0,0,0
773,133146,2021,China,Serbia,0,0,0,0,07/06/2021,0,0,8,8,0,0,0,0,0,0,0,0,8,1,6,15,9,5,2,16
774,133146,2021,China,Belgium,0,0,0,0,06/06/2021,0,0,4,4,0,0,0,0,0,0,0,0,0,2,6,8,3,1,0,4
775,133146,2021,China,Türkiye,0,0,0,0,02/06/2021,0,0,6,6,0,0,0,0,0,0,0,0,5,3,5,13,6,3,1,10
776,133146,2021,China,Canada,0,0,0,0,01/06/2021,0,0,0,0,0,0,0,0,0,0,0,0,0,0,0,0,0,0,0,0
777,133146,2021,China,Germany,0,0,0,0,31/05/2021,1,0,1,2,0,0,0,0,0,0,0,0,9,1,8,18,9,4,0,13
778,133146,2021,China,Thailand,0,0,0,0,27/05/2021,0,0,0,0,0,0,0,0,0,0,0,0,0,0,0,0,1,0,0,1
779,133146,2021,China,Japan,0,0,0,0,26/05/2021,0,0,0,0,0,0,0,0,0,0,0,0,0,0,0,0,0,0,0,0
780,133146,2021,China,Korea,0,0,0,0,25/05/2021,0,0,3,3,0,0,0,0,0,0,0,0,3,2,3,8,9,2,2,13
781,124130,2021,China,USA,0,1,11,12,20/06/2021,5,0,60,65,0,1,1,2,1,0,1,2,0,0,0,0,4,5,0,9
782,124130,2021,China,Poland,0,0,2,2,19/06/2021,1,0,10,11,0,0,0,0,0,0,0,0,0,0,0,0,1,0,0,1
783,124130,2021,China,Russia,0,1,4,5,18/06/2021,22,1,40,63,0,2,1,3,1,4,3,8,0,0,0,0,3,1,1,5
784,124130,2021,China,Italy,0,1,6,7,14/06/2021,12,0,64,76,0,0,2,2,0,1,0,1,0,0,0,0,3,4,0,7
785,124130,2021,Dominican Republic,China,0,0,6,6,13/06/2021,22,1,23,46,2,0,0,2,1,3,2,6,0,0,0,0,5,0,1,6
786,124130,2021,China,Netherlands,0,2,8,10,12/06/2021,12,0,87,99,0,1,0,1,1,0,0,1,0,0,0,0,12,2,1,15
787,138748,2021,China,USA,3,0,11,14,20/06/2021,0,0,0,0,6,0,3,9,3,1,0,4,0,0,0,0,0,1,1,2
788,138748,2021,China,Russia,0,0,12,12,18/06/2021,0,0,3,3,4,1,4,9,4,4,6,14,2,0,2,4,4,0,0,4
789,138748,2021,China,Italy,0,0,13,13,14/06/2021,0,0,1,1,7,0,2,9,1,2,0,3,0,0,0,0,1,2,0,3
790,138748,2021,Dominican Republic,China,0,1,13,14,13/06/2021,1,0,5,6,2,1,5,8,6,6,7,19,1,0,1,2,1,0,0,1
791,138748,2021,China,Netherlands,0,0,15,15,12/06/2021,0,0,3,3,3,1,6,10,4,1,2,7,0,0,0,0,8,0,0,8
792,135745,2021,China,USA,0,0,0,0,20/06/2021,0,0,3,3,0,0,0,0,0,0,0,0,6,0,6,12,10,4,1,15
793,135745,2021,China,Poland,0,0,0,0,19/06/2021,0,0,5,5,0,0,0,0,0,0,0,0,1,0,3,4,5,2,1,8
794,135745,2021,China,Russia,0,0,0,0,18/06/2021,0,0,0,0,0,0,0,0,0,0,0,0,6,1,7,14,12,1,1,14
795,135745,2021,China,Italy,0,0,0,0,14/06/2021,0,0,0,0,0,0,0,0,0,0,0,0,0,0,0,0,0,0,0,0
796,135745,2021,Dominican Republic,China,0,0,0,0,13/06/2021,0,0,7,7,0,0,0,0,0,0,0,0,6,2,12,20,4,3,0,7
797,135745,2021,China,Netherlands,0,0,0,0,12/06/2021,1,0,7,8,0,0,0,0,0,0,0,0,3,0,5,8,8,3,0,11
798,135745,2021,China,Brazil,0,0,0,0,08/06/2021,0,0,10,10,0,0,0,0,0,0,0,0,12,0,10,22,21,5,3,29
799,135745,2021,China,Serbia,0,0,0,0,07/06/2021,0,0,0,0,0,0,0,0,0,0,0,0,0,0,0,0,0,0,0,0
800,135745,2021,China,Belgium,0,0,0,0,06/06/2021,0,0,13,13,0,0,0,0,0,0,0,0,8,0,16,24,28,4,4,36
801,135745,2021,China,Türkiye,0,0,0,0,02/06/2021,0,0,1,1,0,0,0,0,0,0,0,0,2,0,6,8,4,1,0,5
802,135745,2021,China,Canada,0,0,0,0,01/06/2021,0,1,11,12,0,0,0,0,0,0,0,0,10,0,12,22,15,4,0,19
803,135745,2021,China,Germany,0,0,0,0,31/05/2021,1,0,0,1,0,0,0,0,0,0,0,0,5,2,7,14,6,5,0,11
804,135745,2021,China,Thailand,0,0,0,0,27/05/2021,0,0,3,3,0,0,0,0,0,0,0,0,10,1,6,17,13,2,1,16
805,135745,2021,China,Japan,0,0,0,0,26/05/2021,0,0,3,3,0,0,0,0,0,0,0,0,10,1,8,19,7,2,0,9
806,135745,2021,China,Korea,0,0,0,0,25/05/2021,0,0,0,0,0,0,0,0,0,0,0,0,3,0,5,8,7,0,1,8
807,133141,2021,China,USA,0,0,0,0,20/06/2021,0,0,0,0,0,0,0,0,0,0,0,0,0,0,0,0,0,0,0,0
808,133141,2021,China,Poland,0,0,1,1,19/06/2021,0,0,0,0,0,0,0,0,0,0,0,0,0,0,0,0,0,0,0,0
809,133141,2021,China,Russia,0,0,2,2,18/06/2021,0,0,0,0,0,0,3,3,1,1,3,5,0,0,0,0,0,0,0,0
810,133141,2021,China,Italy,0,0,0,0,14/06/2021,0,0,0,0,0,0,0,0,0,0,0,0,0,0,0,0,0,0,0,0
811,133141,2021,Dominican Republic,China,0,0,0,0,13/06/2021,0,0,0,0,0,0,0,0,0,0,0,0,0,0,0,0,0,0,0,0
812,133141,2021,China,Brazil,0,0,2,2,08/06/2021,0,0,0,0,2,1,9,12,0,1,1,2,0,0,0,0,6,1,1,8
813,133141,2021,China,Serbia,0,0,9,9,07/06/2021,0,0,1,1,5,2,13,20,0,3,0,3,0,1,3,4,1,3,0,4
814,133141,2021,China,Belgium,0,1,0,1,06/06/2021,0,0,0,0,2,0,4,6,0,0,0,0,0,0,0,0,1,1,0,2
815,133141,2021,China,Türkiye,1,0,10,11,02/06/2021,0,0,2,2,8,3,21,32,0,1,0,1,1,1,5,7,7,1,0,8
816,133141,2021,China,Canada,0,0,4,4,01/06/2021,0,1,0,1,4,1,14,19,0,2,2,4,0,0,0,0,1,0,0,1
817,133141,2021,China,Germany,0,0,8,8,31/05/2021,0,0,0,0,5,1,7,13,0,2,0,2,1,1,0,2,0,1,0,1
818,133141,2021,China,Thailand,0,0,0,0,27/05/2021,0,0,0,0,0,0,0,0,0,0,0,0,0,0,0,0,0,0,0,0
819,133141,2021,China,Japan,0,1,8,9,26/05/2021,0,0,0,0,6,3,14,23,3,1,0,4,5,2,16,23,7,1,0,8
820,133141,2021,China,Korea,0,0,13,13,25/05/2021,0,0,1,1,14,0,24,38,1,1,2,4,6,1,19,26,5,1,0,6
821,113454,2021,Netherlands,Dominican Republic,0,0,0,0,14/06/2021,0,0,0,0,0,0,0,0,0,0,0,0,0,0,0,0,0,0,0,0
822,113454,2021,Dominican Republic,China,0,0,0,0,13/06/2021,0,0,0,0,0,0,0,0,0,0,0,0,0,0,0,0,0,0,0,0
823,113454,2021,Dominican Republic,Italy,2,4,4,10,12/06/2021,0,0,1,1,5,1,3,9,1,8,0,9,0,0,0,0,1,0,0,1
824,113454,2021,Thailand,Dominican Republic,0,1,14,15,08/06/2021,0,0,0,0,2,0,9,11,5,6,1,12,1,0,0,1,0,2,0,2
825,113454,2021,Türkiye,Dominican Republic,0,1,7,8,07/06/2021,0,0,0,0,3,2,6,11,1,5,1,7,0,0,1,1,0,0,0,0
826,113454,2021,Dominican Republic,Russia,0,1,5,6,06/06/2021,0,0,1,1,7,3,6,16,4,9,4,17,0,0,0,0,3,0,0,3
827,113454,2021,Poland,Dominican Republic,0,2,6,8,02/06/2021,0,0,1,1,5,0,6,11,4,5,3,12,0,0,0,0,4,2,0,6
828,113454,2021,Dominican Republic,Korea,0,2,7,9,01/06/2021,0,0,0,0,5,1,1,7,1,5,2,8,0,0,0,0,3,0,0,3
829,113454,2021,Belgium,Dominican Republic,0,0,0,0,31/05/2021,0,0,0,0,0,0,0,0,0,2,0,2,0,0,0,0,0,0,0,0
830,113454,2021,Canada,Dominican Republic,0,0,0,0,27/05/2021,0,0,0,0,0,0,0,0,0,2,0,2,0,0,0,0,0,0,0,0
831,113454,2021,Brazil,Dominican Republic,0,1,3,4,26/05/2021,0,0,0,0,2,2,6,10,0,1,2,3,0,0,0,0,1,0,0,1
832,113454,2021,Dominican Republic,USA,0,1,1,2,25/05/2021,0,0,0,0,1,1,0,2,0,0,1,1,0,1,0,1,0,0,0,0
833,119591,2021,Dominican Republic,Germany,1,3,8,12,20/06/2021,0,0,1,1,7,1,4,12,2,4,6,12,0,0,0,0,3,1,3,7
834,119591,2021,Dominican Republic,Serbia,0,0,0,0,19/06/2021,0,0,0,0,0,0,0,0,0,0,0,0,0,0,0,0,0,0,0,0
835,119591,2021,Japan,Dominican Republic,0,1,14,15,18/06/2021,0,0,0,0,1,1,5,7,1,5,6,12,0,1,4,5,4,2,3,9
836,119591,2021,Netherlands,Dominican Republic,0,1,13,14,14/06/2021,0,0,2,2,7,0,2,9,0,5,6,11,1,2,6,9,5,1,1,7
837,119591,2021,Dominican Republic,China,0,0,4,4,13/06/2021,0,0,1,1,0,0,0,0,0,0,0,0,0,0,2,2,0,1,0,1
838,119591,2021,Dominican Republic,Italy,0,0,4,4,12/06/2021,0,0,0,0,0,0,0,0,0,0,0,0,1,1,3,5,0,0,0,0
839,119591,2021,Thailand,Dominican Republic,0,0,0,0,08/06/2021,0,0,0,0,0,0,0,0,0,0,0,0,0,0,0,0,0,0,0,0
840,119591,2021,Türkiye,Dominican Republic,0,0,0,0,07/06/2021,0,0,0,0,0,0,0,0,0,0,0,0,0,0,1,1,0,0,0,0
841,119591,2021,Poland,Dominican Republic,0,0,0,0,02/06/2021,0,0,0,0,0,0,0,0,0,0,0,0,0,0,0,0,0,0,0,0
842,119591,2021,Dominican Republic,Korea,0,0,0,0,01/06/2021,0,0,0,0,0,0,0,0,0,0,0,0,0,0,0,0,0,0,0,0
843,119591,2021,Belgium,Dominican Republic,0,2,19,21,31/05/2021,0,0,0,0,3,2,1,6,2,6,7,15,9,6,7,22,15,3,1,19
844,119591,2021,Canada,Dominican Republic,1,2,9,12,27/05/2021,0,0,0,0,4,0,7,11,3,3,2,8,3,1,7,11,8,1,0,9
845,119591,2021,Brazil,Dominican Republic,0,1,3,4,26/05/2021,0,0,0,0,2,2,0,4,2,0,1,3,3,0,4,7,0,2,0,2
846,119591,2021,Dominican Republic,USA,0,1,8,9,25/05/2021,0,0,0,0,1,2,1,4,1,7,0,8,0,0,4,4,4,3,0,7
847,119039,2021,Dominican Republic,Germany,0,0,0,0,20/06/2021,1,0,25,26,0,0,0,0,0,0,0,0,9,3,22,34,25,4,3,32
848,119039,2021,Dominican Republic,Serbia,0,0,0,0,19/06/2021,0,0,5,5,0,0,0,0,0,0,0,0,3,0,9,12,14,5,1,20
849,119039,2021,Japan,Dominican Republic,0,0,0,0,18/06/2021,0,0,40,40,0,0,0,0,0,0,0,0,6,1,9,16,19,5,6,30
850,119039,2021,Netherlands,Dominican Republic,0,0,0,0,14/06/2021,0,0,26,26,0,0,0,0,0,0,0,0,10,1,15,26,21,7,5,33
851,119039,2021,Dominican Republic,China,0,0,0,0,13/06/2021,1,0,23,24,0,0,0,0,0,0,0,0,7,0,12,19,15,4,2,21
852,119039,2021,Dominican Republic,Italy,0,0,0,0,12/06/2021,0,0,9,9,0,0,0,0,0,0,0,0,11,0,15,26,22,3,0,25
853,119039,2021,Thailand,Dominican Republic,0,0,0,0,08/06/2021,0,0,11,11,0,0,0,0,0,0,0,0,12,0,6,18,16,1,1,18
854,119039,2021,Türkiye,Dominican Republic,0,0,0,0,07/06/2021,0,0,21,21,0,0,0,0,0,0,0,0,7,1,9,17,5,5,0,10
855,119039,2021,Dominican Republic,Russia,0,0,0,0,06/06/2021,0,0,12,12,0,0,0,0,0,0,0,0,7,1,18,26,18,4,3,25
856,119039,2021,Poland,Dominican Republic,0,0,0,0,02/06/2021,0,0,21,21,0,0,0,0,0,0,0,0,6,1,7,14,26,8,4,38
857,119039,2021,Dominican Republic,Korea,0,0,0,0,01/06/2021,0,0,10,10,0,0,0,0,0,0,0,0,6,0,5,11,5,3,1,9
858,119039,2021,Belgium,Dominican Republic,0,0,0,0,31/05/2021,0,0,0,0,0,0,0,0,0,0,0,0,8,0,22,30,23,5,2,30
859,119039,2021,Canada,Dominican Republic,0,0,0,0,27/05/2021,0,0,12,12,0,0,0,0,0,0,0,0,5,3,17,25,27,3,0,30
860,119039,2021,Brazil,Dominican Republic,0,0,0,0,26/05/2021,0,0,10,10,0,0,0,0,0,0,0,0,10,0,5,15,5,0,1,6
861,119039,2021,Dominican Republic,USA,0,0,0,0,25/05/2021,1,0,3,4,0,0,0,0,0,0,0,0,8,0,8,16,9,5,0,14
862,119545,2021,Dominican Republic,Germany,0,0,0,0,20/06/2021,1,0,15,16,0,0,0,0,0,0,2,2,0,0,0,0,2,0,0,2
863,119545,2021,Dominican Republic,Serbia,0,0,0,0,19/06/2021,1,0,6,7,0,0,0,0,0,0,0,0,0,0,0,0,0,0,0,0
864,119545,2021,Japan,Dominican Republic,0,0,2,2,18/06/2021,0,0,6,6,0,0,0,0,0,1,0,1,0,0,0,0,3,0,0,3
865,119545,2021,Netherlands,Dominican Republic,0,0,10,10,14/06/2021,3,1,56,60,0,0,0,0,0,3,2,5,0,0,0,0,5,1,3,9
866,119545,2021,Dominican Republic,China,1,1,7,9,13/06/2021,13,1,77,91,1,1,1,3,0,0,2,2,0,0,0,0,3,3,0,6
867,119545,2021,Dominican Republic,Italy,0,0,6,6,12/06/2021,3,1,35,39,0,0,0,0,0,1,0,1,0,0,0,0,3,1,0,4
868,119545,2021,Thailand,Dominican Republic,0,0,0,0,08/06/2021,0,0,11,11,0,0,0,0,0,0,0,0,0,0,0,0,0,0,0,0
869,119545,2021,Türkiye,Dominican Republic,0,0,0,0,07/06/2021,0,0,0,0,0,0,0,0,0,0,0,0,0,0,0,0,0,0,0,0
870,119545,2021,Dominican Republic,Russia,0,0,2,2,06/06/2021,0,0,5,5,0,0,0,0,0,0,0,0,0,0,0,0,0,0,0,0
871,119545,2021,Poland,Dominican Republic,0,0,0,0,02/06/2021,0,0,0,0,0,0,0,0,0,0,0,0,0,0,0,0,0,0,0,0
872,119545,2021,Belgium,Dominican Republic,0,0,0,0,31/05/2021,0,0,0,0,0,0,0,0,0,0,0,0,0,0,0,0,1,0,0,1
873,119545,2021,Canada,Dominican Republic,0,0,0,0,27/05/2021,0,0,0,0,0,0,0,0,0,0,0,0,0,0,0,0,0,0,0,0
874,119545,2021,Dominican Republic,USA,0,0,0,0,25/05/2021,0,0,0,0,0,0,0,0,0,0,0,0,0,0,0,0,1,1,0,2
875,119585,2021,Dominican Republic,Germany,0,1,14,15,20/06/2021,10,0,88,98,1,1,1,3,0,1,2,3,0,0,0,0,14,6,1,21
876,119585,2021,Dominican Republic,Serbia,0,0,6,6,19/06/2021,14,0,46,60,2,0,1,3,0,2,4,6,0,0,0,0,2,0,1,3
877,119585,2021,Japan,Dominican Republic,0,0,13,13,18/06/2021,20,0,102,122,0,0,0,0,0,6,2,8,0,0,0,0,15,2,1,18
878,119585,2021,Netherlands,Dominican Republic,0,1,4,5,14/06/2021,11,0,42,53,0,1,1,2,0,0,2,2,0,0,0,0,8,2,4,14
879,119585,2021,Dominican Republic,China,0,0,0,0,13/06/2021,0,0,0,0,0,0,0,0,0,0,0,0,0,0,0,0,0,0,0,0
880,119585,2021,Dominican Republic,Italy,0,1,8,9,12/06/2021,8,2,84,94,2,0,5,7,1,0,1,2,0,0,0,0,4,1,0,5
881,119585,2021,Thailand,Dominican Republic,1,1,10,12,08/06/2021,21,4,75,100,0,0,2,2,1,1,3,5,0,0,0,0,4,1,0,5
882,119585,2021,Türkiye,Dominican Republic,0,2,13,15,07/06/2021,4,2,96,102,2,0,1,3,0,2,2,4,0,0,0,0,3,3,0,6
883,119585,2021,Dominican Republic,Russia,1,0,10,11,06/06/2021,47,2,93,142,1,0,2,3,0,2,9,11,0,0,0,0,3,3,0,6
884,119585,2021,Poland,Dominican Republic,0,2,14,16,02/06/2021,13,1,97,111,1,0,4,5,0,3,0,3,0,0,0,0,12,3,1,16
885,119585,2021,Dominican Republic,Korea,1,1,13,15,01/06/2021,16,1,56,73,1,0,0,1,0,4,4,8,0,0,0,0,5,2,2,9
886,119585,2021,Belgium,Dominican Republic,0,1,14,15,31/05/2021,15,2,1,18,0,0,4,4,0,2,2,4,0,0,0,0,6,3,1,10
887,119585,2021,Canada,Dominican Republic,3,3,11,17,27/05/2021,12,1,116,129,0,0,2,2,0,3,0,3,0,0,0,0,9,5,0,14
888,119585,2021,Brazil,Dominican Republic,0,0,9,9,26/05/2021,2,0,82,84,1,0,0,1,0,0,1,1,0,0,0,0,2,0,0,2
889,119585,2021,Dominican Republic,USA,0,0,10,10,25/05/2021,0,0,0,0,0,1,1,2,0,1,0,1,0,0,0,0,3,4,0,7
890,115386,2021,Dominican Republic,Germany,0,0,0,0,20/06/2021,0,0,0,0,0,0,0,0,0,0,0,0,0,0,0,0,0,0,0,0
891,115386,2021,Dominican Republic,Serbia,0,0,8,8,19/06/2021,0,0,0,0,3,2,1,6,1,3,1,5,0,0,0,0,2,2,0,4
892,115386,2021,Japan,Dominican Republic,0,1,6,7,18/06/2021,0,0,1,1,0,0,2,2,0,1,1,2,0,0,0,0,3,0,0,3
893,115386,2021,Netherlands,Dominican Republic,0,0,0,0,14/06/2021,0,0,0,0,0,0,0,0,0,0,0,0,0,0,0,0,0,0,0,0
894,115386,2021,Dominican Republic,China,0,3,9,12,13/06/2021,0,0,0,0,3,0,5,8,0,1,0,1,1,0,1,2,1,0,0,1
895,115386,2021,Dominican Republic,Italy,0,0,0,0,12/06/2021,0,0,0,0,0,0,0,0,0,0,0,0,0,0,0,0,0,0,0,0
896,115386,2021,Thailand,Dominican Republic,0,0,3,3,08/06/2021,0,0,0,0,1,1,5,7,0,0,4,4,0,0,0,0,1,1,0,2
897,115386,2021,Türkiye,Dominican Republic,0,0,0,0,07/06/2021,0,0,0,0,0,0,0,0,0,0,0,0,0,0,0,0,0,0,0,0
898,115386,2021,Dominican Republic,Russia,0,0,1,1,06/06/2021,0,0,1,1,0,0,0,0,0,0,1,1,0,0,0,0,0,0,0,0
899,115386,2021,Poland,Dominican Republic,0,0,0,0,02/06/2021,0,0,0,0,0,0,1,1,0,0,0,0,0,0,0,0,0,0,0,0
900,115386,2021,Dominican Republic,Korea,0,0,0,0,01/06/2021,0,0,1,1,0,0,0,0,0,0,0,0,0,0,0,0,0,0,0,0
901,115386,2021,Belgium,Dominican Republic,0,0,0,0,31/05/2021,0,0,0,0,0,0,0,0,0,0,0,0,0,0,0,0,0,0,0,0
902,115386,2021,Canada,Dominican Republic,0,0,0,0,27/05/2021,0,0,0,0,0,0,0,0,0,0,0,0,0,0,0,0,0,0,0,0
903,115386,2021,Brazil,Dominican Republic,0,0,0,0,26/05/2021,0,0,0,0,0,0,0,0,0,0,0,0,0,0,0,0,0,0,0,0
904,115386,2021,Dominican Republic,USA,0,0,0,0,25/05/2021,0,0,0,0,0,0,0,0,0,0,0,0,0,0,0,0,0,0,0,0
905,139912,2021,Dominican Republic,Germany,0,0,0,0,20/06/2021,0,0,0,0,0,0,0,0,0,0,0,0,0,0,0,0,0,0,0,0
906,139912,2021,Dominican Republic,Serbia,0,0,0,0,19/06/2021,0,0,0,0,0,0,0,0,0,0,0,0,0,0,0,0,0,0,0,0
907,139912,2021,Japan,Dominican Republic,0,0,0,0,18/06/2021,0,0,0,0,0,0,0,0,0,0,0,0,0,0,0,0,0,0,0,0
908,139912,2021,Dominican Republic,China,0,0,0,0,13/06/2021,0,0,10,10,0,0,0,0,0,0,0,0,0,0,0,0,1,0,0,1
909,139912,2021,Thailand,Dominican Republic,0,0,0,0,08/06/2021,0,0,0,0,0,0,0,0,0,0,0,0,0,0,0,0,0,0,0,0
910,139912,2021,Türkiye,Dominican Republic,0,0,0,0,07/06/2021,0,0,0,0,0,0,0,0,0,0,0,0,0,0,0,0,0,0,0,0
911,139912,2021,Dominican Republic,Korea,0,0,0,0,01/06/2021,0,0,0,0,0,0,0,0,0,0,0,0,0,0,0,0,0,0,0,0
912,139912,2021,Brazil,Dominican Republic,0,0,0,0,26/05/2021,0,0,0,0,0,0,0,0,0,0,0,0,0,0,0,0,0,0,0,0
913,112468,2021,Dominican Republic,Germany,2,1,17,20,20/06/2021,0,0,2,2,11,5,17,33,0,1,2,3,2,1,19,22,12,6,3,21
914,112468,2021,Dominican Republic,Serbia,0,0,17,17,19/06/2021,0,0,2,2,11,1,5,17,1,1,0,2,0,0,8,8,7,2,1,10
915,112468,2021,Japan,Dominican Republic,0,1,12,13,18/06/2021,0,0,3,3,12,3,14,29,1,6,3,10,2,2,26,30,12,1,1,14
916,112468,2021,Netherlands,Dominican Republic,1,0,13,14,14/06/2021,0,0,1,1,3,1,10,14,1,1,1,3,1,0,12,13,4,1,1,6
917,112468,2021,Dominican Republic,China,2,3,8,13,13/06/2021,0,0,1,1,17,6,11,34,1,2,1,4,4,2,17,23,9,1,4,14
918,112468,2021,Dominican Republic,Italy,2,2,10,14,12/06/2021,0,0,1,1,9,3,10,22,1,1,0,2,7,0,18,25,2,3,0,5
919,112468,2021,Thailand,Dominican Republic,0,1,10,11,08/06/2021,0,0,0,0,10,3,13,26,1,3,2,6,2,0,8,10,6,4,0,10
920,112468,2021,Türkiye,Dominican Republic,0,0,7,7,07/06/2021,0,0,0,0,0,0,1,1,0,0,0,0,0,0,2,2,0,1,0,1
921,112468,2021,Dominican Republic,Russia,0,1,7,8,06/06/2021,0,0,3,3,6,2,20,28,2,3,3,8,4,0,22,26,5,1,1,7
922,112468,2021,Poland,Dominican Republic,0,2,16,18,02/06/2021,0,0,1,1,11,4,9,24,1,1,1,3,2,3,33,38,12,7,1,20
923,112468,2021,Dominican Republic,Korea,0,0,3,3,01/06/2021,0,0,0,0,0,0,1,1,0,0,0,0,0,0,1,1,2,1,0,3
924,112468,2021,Belgium,Dominican Republic,1,4,8,13,31/05/2021,0,0,0,0,16,7,15,38,1,3,3,7,0,3,15,18,5,3,1,9
925,112468,2021,Canada,Dominican Republic,3,3,15,21,27/05/2021,0,0,0,0,18,3,12,33,0,3,0,3,5,1,16,22,5,1,0,6
926,112468,2021,Brazil,Dominican Republic,0,0,4,4,26/05/2021,0,0,0,0,4,1,7,12,0,1,1,2,0,1,13,14,0,1,0,1
927,112468,2021,Dominican Republic,USA,0,1,8,9,25/05/2021,0,0,1,1,8,3,17,28,0,0,0,0,7,1,26,34,2,5,1,8
928,123978,2021,Dominican Republic,Germany,0,1,14,15,20/06/2021,0,0,2,2,8,7,11,26,0,2,3,5,4,4,10,18,5,2,1,8
929,123978,2021,Dominican Republic,Serbia,0,0,8,8,19/06/2021,0,0,3,3,11,7,6,24,1,0,0,1,12,0,9,21,3,2,2,7
930,123978,2021,Japan,Dominican Republic,0,1,2,3,18/06/2021,0,0,1,1,2,0,3,5,0,0,0,0,1,0,12,13,2,1,1,4
931,123978,2021,Netherlands,Dominican Republic,0,0,10,10,14/06/2021,0,0,1,1,7,3,8,18,1,0,0,1,1,0,6,7,12,1,0,13
932,123978,2021,Dominican Republic,China,0,2,16,18,13/06/2021,0,0,0,0,16,7,15,38,1,0,1,2,9,1,33,43,10,3,1,14
933,123978,2021,Dominican Republic,Italy,0,2,7,9,12/06/2021,0,0,0,0,9,2,14,25,0,2,0,2,2,0,12,14,5,1,0,6
934,123978,2021,Thailand,Dominican Republic,2,1,15,18,08/06/2021,0,0,0,0,16,1,18,35,0,2,4,6,12,1,12,25,12,2,0,14
935,123978,2021,Türkiye,Dominican Republic,1,2,18,21,07/06/2021,0,0,2,2,18,7,12,37,1,0,2,3,8,0,16,24,9,5,0,14
936,123978,2021,Dominican Republic,Russia,0,0,10,10,06/06/2021,0,0,0,0,9,2,13,24,3,0,1,4,6,0,14,20,13,2,2,17
937,123978,2021,Poland,Dominican Republic,0,0,6,6,02/06/2021,0,0,2,2,0,0,1,1,0,0,0,0,2,0,6,8,1,0,2,3
938,123978,2021,Dominican Republic,Korea,0,1,12,13,01/06/2021,0,0,2,2,15,6,7,28,1,0,4,5,12,3,13,28,6,2,1,9
939,123978,2021,Belgium,Dominican Republic,0,0,0,0,31/05/2021,0,0,0,0,0,0,2,2,0,0,0,0,1,1,5,7,1,1,0,2
940,123978,2021,Canada,Dominican Republic,0,0,1,1,27/05/2021,0,0,0,0,0,0,0,0,0,0,0,0,0,0,1,1,1,0,0,1
941,123978,2021,Brazil,Dominican Republic,0,1,3,4,26/05/2021,0,0,0,0,5,3,3,11,0,0,1,1,3,0,7,10,2,0,0,2
942,123978,2021,Dominican Republic,USA,0,0,2,2,25/05/2021,0,0,0,0,1,2,7,10,0,0,0,0,2,0,1,3,1,0,0,1
943,115391,2021,Dominican Republic,Germany,0,0,0,0,20/06/2021,0,0,0,0,0,0,0,0,0,0,0,0,0,0,0,0,0,0,0,0
944,115391,2021,Dominican Republic,Serbia,0,0,2,2,19/06/2021,0,0,0,0,2,1,1,4,0,0,0,0,0,0,0,0,0,0,0,0
945,115391,2021,Japan,Dominican Republic,0,0,0,0,18/06/2021,0,0,0,0,0,0,0,0,0,0,0,0,0,0,0,0,0,0,0,0
946,115391,2021,Netherlands,Dominican Republic,0,0,1,1,14/06/2021,0,0,0,0,0,0,0,0,0,0,0,0,0,0,0,0,0,0,0,0
947,115391,2021,Dominican Republic,China,0,0,13,13,13/06/2021,0,0,3,3,10,5,12,27,0,4,0,4,0,0,0,0,7,2,1,10
948,115391,2021,Dominican Republic,Italy,1,0,1,2,12/06/2021,0,0,0,0,0,0,0,0,0,1,0,1,0,0,0,0,0,0,0,0
949,115391,2021,Thailand,Dominican Republic,0,0,3,3,08/06/2021,0,0,0,0,2,2,4,8,1,0,1,2,0,0,0,0,0,1,0,1
950,115391,2021,Türkiye,Dominican Republic,0,2,6,8,07/06/2021,0,0,1,1,2,5,4,11,0,0,0,0,0,0,0,0,2,1,0,3
951,115391,2021,Dominican Republic,Russia,0,0,1,1,06/06/2021,0,0,0,0,0,1,0,1,0,0,1,1,0,0,0,0,1,0,0,1
952,115391,2021,Poland,Dominican Republic,0,0,2,2,02/06/2021,0,0,0,0,0,0,0,0,0,0,0,0,0,0,0,0,0,0,0,0
953,115391,2021,Dominican Republic,Korea,0,0,2,2,01/06/2021,0,0,0,0,0,0,0,0,0,0,0,0,0,0,0,0,0,0,0,0
954,115391,2021,Belgium,Dominican Republic,0,0,0,0,31/05/2021,0,0,0,0,0,0,0,0,0,0,0,0,0,0,0,0,0,0,0,0
955,115391,2021,Canada,Dominican Republic,0,0,0,0,27/05/2021,0,0,0,0,0,0,0,0,0,0,0,0,0,0,0,0,0,0,0,0
956,115391,2021,Brazil,Dominican Republic,0,0,2,2,26/05/2021,0,0,0,0,2,0,0,2,0,0,0,0,0,0,0,0,0,0,0,0
957,115391,2021,Dominican Republic,USA,0,0,2,2,25/05/2021,0,0,0,0,2,2,0,4,0,1,0,1,0,0,0,0,0,0,0,0
958,114294,2021,Dominican Republic,Germany,0,2,14,16,20/06/2021,0,0,4,4,20,4,17,41,2,2,1,5,2,2,10,14,15,3,0,18
959,114294,2021,Dominican Republic,Serbia,0,0,0,0,19/06/2021,0,0,0,0,0,0,0,0,0,0,0,0,0,0,0,0,0,0,0,0
960,114294,2021,Japan,Dominican Republic,0,1,16,17,18/06/2021,0,0,6,6,26,2,22,50,0,2,2,4,3,2,29,34,18,3,1,22
961,114294,2021,Netherlands,Dominican Republic,0,2,12,14,14/06/2021,0,0,4,4,12,4,15,31,1,0,3,4,4,1,19,24,9,6,2,17
962,114294,2021,Dominican Republic,China,0,1,1,2,13/06/2021,0,0,0,0,2,0,2,4,0,0,0,0,0,0,0,0,2,0,0,2
963,114294,2021,Dominican Republic,Italy,3,2,14,19,12/06/2021,0,0,0,0,15,5,26,46,1,1,0,2,1,0,2,3,10,2,1,13
964,114294,2021,Thailand,Dominican Republic,0,0,0,0,08/06/2021,0,0,0,0,0,0,0,0,0,0,0,0,0,0,0,0,0,0,0,0
965,114294,2021,Türkiye,Dominican Republic,2,2,3,7,07/06/2021,0,0,0,0,11,1,9,21,0,3,3,6,7,3,4,14,1,1,0,2
966,114294,2021,Dominican Republic,Russia,1,3,17,21,06/06/2021,0,0,1,1,8,5,20,33,0,1,3,4,2,0,16,18,14,4,2,20
967,114294,2021,Poland,Dominican Republic,3,1,16,20,02/06/2021,0,0,3,3,21,9,24,54,2,3,2,7,4,1,20,25,11,3,0,14
968,114294,2021,Dominican Republic,Korea,0,0,0,0,01/06/2021,0,0,0,0,0,0,0,0,0,0,0,0,0,0,0,0,0,0,0,0
969,114294,2021,Belgium,Dominican Republic,1,2,13,16,31/05/2021,0,0,0,0,16,3,23,42,0,3,3,6,5,1,20,26,9,4,2,15
970,114294,2021,Canada,Dominican Republic,2,1,13,16,27/05/2021,0,0,2,2,17,8,25,50,0,0,0,0,3,0,11,14,14,4,0,18
971,114294,2021,Brazil,Dominican Republic,0,1,8,9,26/05/2021,0,0,3,3,5,7,14,26,0,1,0,1,2,1,14,17,1,0,0,1
972,114294,2021,Dominican Republic,USA,1,2,4,7,25/05/2021,0,0,0,0,9,1,14,24,0,1,0,1,2,0,4,6,1,2,0,3
973,123982,2021,Dominican Republic,Germany,0,0,0,0,20/06/2021,0,0,1,1,0,0,2,2,0,1,1,2,0,0,0,0,0,0,0,0
974,123982,2021,Dominican Republic,Serbia,0,0,0,0,19/06/2021,0,0,0,0,0,0,0,0,0,0,0,0,0,0,0,0,0,0,0,0
975,123982,2021,Japan,Dominican Republic,0,1,10,11,18/06/2021,0,0,1,1,29,7,32,68,2,6,6,14,0,0,4,4,18,3,3,24
976,123982,2021,Netherlands,Dominican Republic,0,4,11,15,14/06/2021,0,0,1,1,18,5,28,51,0,6,5,11,1,1,2,4,13,3,3,19
977,123982,2021,Dominican Republic,China,0,0,0,0,13/06/2021,0,0,0,0,0,1,1,2,0,0,0,0,0,0,0,0,0,0,0,0
978,123982,2021,Dominican Republic,Italy,0,0,6,6,12/06/2021,0,1,0,1,8,2,15,25,1,0,0,1,1,1,2,4,3,1,0,4
979,123982,2021,Thailand,Dominican Republic,0,1,6,7,08/06/2021,0,0,0,0,9,1,13,23,3,0,0,3,0,0,0,0,6,1,2,9
980,123982,2021,Türkiye,Dominican Republic,0,2,10,12,07/06/2021,0,0,2,2,15,4,21,40,1,1,2,4,5,0,11,16,4,1,2,7
981,123982,2021,Dominican Republic,Russia,1,1,13,15,06/06/2021,0,0,1,1,22,6,19,47,0,5,1,6,1,0,0,1,16,5,5,26
982,123982,2021,Poland,Dominican Republic,2,2,8,12,02/06/2021,0,0,7,7,18,5,23,46,1,0,4,5,0,0,1,1,7,2,1,10
983,123982,2021,Dominican Republic,Korea,1,3,4,8,01/06/2021,0,0,1,1,14,2,11,27,1,1,2,4,3,2,14,19,15,2,0,17
984,123982,2021,Belgium,Dominican Republic,0,0,1,1,31/05/2021,0,0,0,0,3,1,5,9,0,0,0,0,0,0,3,3,2,0,0,2
985,123982,2021,Canada,Dominican Republic,0,0,0,0,27/05/2021,0,0,0,0,0,0,0,0,0,0,0,0,0,0,0,0,0,0,0,0
986,123982,2021,Brazil,Dominican Republic,0,0,0,0,26/05/2021,0,0,0,0,0,0,0,0,0,0,0,0,0,0,0,0,0,0,0,0
987,123982,2021,Dominican Republic,USA,0,0,0,0,25/05/2021,0,0,0,0,0,0,0,0,0,0,0,0,0,0,0,0,0,0,0,0
988,139910,2021,Dominican Republic,Germany,0,1,13,14,20/06/2021,0,0,1,1,7,1,9,17,2,4,8,14,0,0,0,0,3,0,0,3
989,139910,2021,Dominican Republic,Serbia,0,0,15,15,19/06/2021,0,0,2,2,8,0,2,10,2,7,6,15,0,0,1,1,6,1,0,7
990,139910,2021,Japan,Dominican Republic,1,4,12,17,18/06/2021,0,0,5,5,5,1,8,14,3,3,6,12,0,0,0,0,7,0,0,7
991,139910,2021,Netherlands,Dominican Republic,1,2,14,17,14/06/2021,0,0,1,1,11,1,8,20,3,12,12,27,0,0,0,0,1,0,0,1
992,139910,2021,Dominican Republic,China,0,2,9,11,13/06/2021,0,0,2,2,12,2,8,22,1,3,3,7,0,0,0,0,6,2,0,8
993,139910,2021,Dominican Republic,Italy,2,1,14,17,12/06/2021,0,0,0,0,5,1,8,14,3,4,0,7,0,0,1,1,1,1,0,2
994,139910,2021,Thailand,Dominican Republic,0,0,5,5,08/06/2021,0,0,1,1,5,0,3,8,0,1,0,1,0,0,0,0,1,0,0,1
995,139910,2021,Türkiye,Dominican Republic,1,2,16,19,07/06/2021,0,0,1,1,3,0,3,6,6,2,0,8,0,1,0,1,3,1,0,4
996,139910,2021,Dominican Republic,Russia,0,0,19,19,06/06/2021,0,0,3,3,8,4,7,19,1,11,11,23,0,0,0,0,2,2,1,5
997,139910,2021,Poland,Dominican Republic,1,2,14,17,02/06/2021,0,0,3,3,5,2,3,10,2,6,11,19,0,0,0,0,3,2,0,5
998,139910,2021,Dominican Republic,Korea,1,2,13,16,01/06/2021,0,0,1,1,3,2,3,8,0,1,3,4,0,0,0,0,2,0,0,2
999,139910,2021,Belgium,Dominican Republic,0,3,14,17,31/05/2021,0,0,0,0,11,3,8,22,4,6,11,21,0,0,1,1,5,0,1,6
1000,139910,2021,Canada,Dominican Republic,0,1,14,15,27/05/2021,0,0,2,2,8,2,10,20,3,5,1,9,0,0,0,0,8,2,0,10
1001,139910,2021,Brazil,Dominican Republic,0,1,9,10,26/05/2021,0,0,1,1,4,0,5,9,2,3,0,5,0,0,0,0,2,0,0,2
1002,139910,2021,Dominican Republic,USA,0,0,6,6,25/05/2021,0,0,0,0,3,0,6,9,1,0,0,1,0,0,2,2,1,1,0,2
1003,139927,2021,Dominican Republic,Germany,1,3,7,11,20/06/2021,0,0,1,1,7,1,10,18,0,0,0,0,0,0,1,1,4,0,1,5
1004,139927,2021,Dominican Republic,Serbia,4,1,12,17,19/06/2021,0,0,0,0,8,4,8,20,0,0,1,1,0,0,0,0,7,2,1,10
1005,139927,2021,Japan,Dominican Republic,0,0,1,1,18/06/2021,0,0,3,3,2,2,6,10,0,2,2,4,0,0,0,0,1,1,0,2
1006,139927,2021,Netherlands,Dominican Republic,0,1,0,1,14/06/2021,0,0,0,0,3,1,2,6,0,1,1,2,0,0,0,0,1,0,0,1
1007,139927,2021,Dominican Republic,Italy,0,0,0,0,12/06/2021,0,0,0,0,0,0,0,0,0,0,0,0,0,0,0,0,0,0,0,0
1008,139927,2021,Poland,Dominican Republic,0,0,0,0,02/06/2021,0,0,0,0,0,0,0,0,0,0,0,0,0,0,0,0,0,0,0,0
1009,139927,2021,Dominican Republic,Korea,1,2,7,10,01/06/2021,0,0,3,3,11,3,9,23,3,3,6,12,0,0,0,0,7,2,0,9
1010,139927,2021,Belgium,Dominican Republic,1,4,17,22,31/05/2021,0,0,0,0,25,3,20,48,2,4,1,7,0,0,0,0,14,4,0,18
1011,139927,2021,Canada,Dominican Republic,4,2,15,21,27/05/2021,0,0,1,1,6,5,20,31,0,3,1,4,0,0,0,0,10,2,0,12
1012,139927,2021,Brazil,Dominican Republic,1,0,5,6,26/05/2021,0,0,0,0,5,4,12,21,0,4,0,4,0,0,0,0,5,1,0,6
1013,139927,2021,Dominican Republic,USA,0,1,7,8,25/05/2021,0,0,0,0,9,4,12,25,1,4,1,6,0,0,0,0,1,2,0,3
1014,139913,2021,Dominican Republic,Germany,0,0,0,0,20/06/2021,0,0,0,0,0,0,0,0,0,0,0,0,0,0,0,0,0,0,0,0
1015,139913,2021,Dominican Republic,Serbia,0,0,0,0,19/06/2021,0,0,0,0,0,0,0,0,0,0,0,0,0,0,0,0,0,0,0,0
1016,139913,2021,Japan,Dominican Republic,0,0,0,0,18/06/2021,0,0,0,0,0,0,0,0,0,0,0,0,0,0,0,0,0,0,0,0
1017,139913,2021,Netherlands,Dominican Republic,0,0,0,0,14/06/2021,0,0,0,0,0,0,0,0,0,0,0,0,0,0,0,0,0,0,0,0
1018,139913,2021,Dominican Republic,China,0,0,0,0,13/06/2021,0,0,0,0,0,0,0,0,0,0,0,0,0,0,0,0,0,0,0,0
1019,139913,2021,Dominican Republic,Italy,0,0,0,0,12/06/2021,0,0,0,0,0,0,0,0,0,0,0,0,0,0,0,0,0,0,0,0
1020,139913,2021,Thailand,Dominican Republic,0,0,0,0,08/06/2021,0,0,0,0,0,0,0,0,0,0,0,0,0,0,0,0,0,0,0,0
1021,139913,2021,Türkiye,Dominican Republic,0,0,0,0,07/06/2021,0,0,0,0,0,0,0,0,0,0,0,0,0,0,0,0,0,0,0,0
1022,139913,2021,Dominican Republic,Russia,0,0,3,3,06/06/2021,0,0,0,0,0,0,0,0,0,0,0,0,1,0,7,8,0,0,1,1
1023,139913,2021,Poland,Dominican Republic,0,0,0,0,02/06/2021,0,0,0,0,0,0,0,0,0,0,0,0,0,0,0,0,0,0,0,0
1024,139913,2021,Dominican Republic,Korea,0,0,0,0,01/06/2021,0,0,0,0,0,0,0,0,0,0,0,0,0,0,0,0,0,0,0,0
1025,139913,2021,Belgium,Dominican Republic,0,0,0,0,31/05/2021,0,0,0,0,0,0,0,0,0,0,0,0,0,0,0,0,0,0,0,0
1026,139913,2021,Canada,Dominican Republic,0,0,0,0,27/05/2021,0,0,0,0,0,0,0,0,0,0,0,0,0,0,0,0,0,0,0,0
1027,139913,2021,Brazil,Dominican Republic,0,0,0,0,26/05/2021,0,0,0,0,0,0,0,0,0,0,0,0,0,0,0,0,0,0,0,0
1028,139913,2021,Dominican Republic,USA,0,0,0,0,25/05/2021,0,0,0,0,0,0,0,0,0,0,0,0,0,0,0,0,0,0,0,0
1029,152140,2021,Dominican Republic,Germany,0,1,5,6,20/06/2021,0,0,1,1,0,0,0,0,0,0,0,0,0,0,0,0,0,0,1,1
1030,152140,2021,Japan,Germany,0,1,0,1,19/06/2021,0,0,0,0,0,0,0,0,0,0,0,0,3,0,1,4,0,0,0,0
1031,152140,2021,Germany,Serbia,1,0,1,2,18/06/2021,0,0,0,0,0,0,0,0,0,0,0,0,0,0,0,0,0,1,0,1
1032,152140,2021,Germany,Poland,0,0,0,0,14/06/2021,0,0,0,0,0,0,0,0,0,0,0,0,1,0,1,2,0,0,0,0
1033,152140,2021,Germany,Brazil,0,0,1,1,13/06/2021,0,0,0,0,0,0,0,0,0,0,0,0,0,0,0,0,0,0,0,0
1034,152140,2021,Thailand,Germany,0,0,0,0,12/06/2021,0,0,0,0,0,0,0,0,0,0,0,0,0,0,0,0,0,0,0,0
1035,152140,2021,Germany,Korea,0,0,0,0,08/06/2021,0,0,6,6,0,0,0,0,0,0,0,0,5,0,2,7,7,1,0,8
1036,152140,2021,Germany,Italy,0,0,0,0,07/06/2021,0,0,0,0,0,0,0,0,0,0,0,0,5,0,3,8,3,1,0,4
1037,152140,2021,Germany,USA,0,0,0,0,06/06/2021,0,0,0,0,0,0,0,0,0,0,0,0,0,0,0,0,0,0,0,0
1038,152140,2021,Germany,Canada,0,0,0,0,02/06/2021,0,0,0,0,0,0,0,0,0,0,0,0,0,0,0,0,0,0,0,0
1039,152140,2021,Türkiye,Germany,0,0,0,0,01/06/2021,0,0,0,0,0,0,0,0,0,0,0,0,0,0,0,0,0,0,0,0
1040,152140,2021,China,Germany,0,0,0,0,31/05/2021,0,0,0,0,0,0,0,0,0,0,0,0,0,0,0,0,0,0,0,0
1041,152140,2021,Germany,Belgium,0,0,0,0,27/05/2021,0,0,0,0,0,0,0,0,0,0,0,0,0,0,0,0,0,0,1,1
1042,152140,2021,Netherlands,Germany,0,0,0,0,26/05/2021,0,0,0,0,0,0,0,0,0,0,0,0,0,0,0,0,0,0,0,0
1043,152140,2021,Germany,Russia,0,0,0,0,25/05/2021,0,0,0,0,0,0,0,0,0,0,0,0,1,0,0,1,0,0,0,0
1044,150973,2021,Dominican Republic,Germany,0,0,2,2,20/06/2021,2,0,11,13,0,0,0,0,0,0,0,0,0,0,0,0,0,0,0,0
1045,150973,2021,Japan,Germany,0,0,1,1,19/06/2021,3,0,9,12,0,0,1,1,0,2,1,3,0,0,0,0,1,0,0,1
1046,150973,2021,Germany,Serbia,0,0,3,3,18/06/2021,5,0,24,29,1,0,0,1,0,1,0,1,0,0,0,0,2,2,0,4
1047,150973,2021,Germany,Poland,0,0,2,2,14/06/2021,0,0,1,1,1,0,0,1,0,0,0,0,0,0,0,0,0,0,0,0
1048,150973,2021,Germany,Brazil,0,0,8,8,13/06/2021,0,0,8,8,0,0,0,0,0,0,0,0,0,0,0,0,2,0,0,2
1049,150973,2021,Thailand,Germany,0,1,5,6,12/06/2021,6,0,39,45,1,0,0,1,2,1,0,3,0,0,0,0,4,0,1,5
1050,150973,2021,Germany,Korea,0,0,0,0,08/06/2021,0,0,0,0,0,0,0,0,0,0,0,0,0,0,0,0,0,0,0,0
1051,150973,2021,Germany,Italy,0,0,9,9,07/06/2021,16,0,39,55,1,0,0,1,2,1,1,4,0,0,0,0,6,2,1,9
1052,150973,2021,Germany,USA,0,0,6,6,06/06/2021,1,2,24,27,2,0,0,2,0,0,0,0,0,0,1,1,1,0,0,1
1053,150973,2021,Germany,Canada,1,0,9,10,02/06/2021,3,1,41,45,0,0,0,0,0,0,0,0,0,1,0,1,2,1,0,3
1054,150973,2021,Türkiye,Germany,0,0,2,2,01/06/2021,3,0,1,4,0,0,0,0,0,0,0,0,0,0,0,0,0,1,0,1
1055,150973,2021,China,Germany,0,0,4,4,31/05/2021,4,0,0,4,0,0,0,0,0,0,0,0,0,0,0,0,0,2,0,2
1056,150973,2021,Germany,Belgium,2,0,1,3,27/05/2021,0,0,9,9,0,0,0,0,0,1,0,1,0,0,0,0,0,0,0,0
1057,150973,2021,Netherlands,Germany,0,0,5,5,26/05/2021,11,0,41,52,0,1,2,3,0,0,1,1,0,0,0,0,2,0,0,2
1058,150973,2021,Germany,Russia,1,0,2,3,25/05/2021,2,1,15,18,0,0,0,0,0,0,1,1,0,0,0,0,1,0,0,1
1059,136668,2021,Dominican Republic,Germany,1,2,10,13,20/06/2021,22,1,88,111,2,0,4,6,2,5,3,10,0,1,0,1,16,4,2,22
1060,136668,2021,Japan,Germany,0,2,9,11,19/06/2021,39,0,66,105,2,1,0,3,2,4,5,11,0,0,0,0,11,1,1,13
1061,136668,2021,Germany,Serbia,0,0,7,7,18/06/2021,13,0,43,56,1,0,0,1,1,0,0,1,0,0,0,0,2,1,0,3
1062,136668,2021,Germany,Poland,0,2,9,11,14/06/2021,16,0,69,85,2,0,1,3,0,1,1,2,0,0,0,0,7,2,3,12
1063,136668,2021,Germany,Brazil,0,3,9,12,13/06/2021,27,2,72,101,3,0,3,6,2,4,1,7,0,0,0,0,8,1,1,10
1064,136668,2021,Thailand,Germany,1,2,5,8,12/06/2021,14,0,57,71,0,0,1,1,0,1,2,3,0,0,0,0,3,3,2,8
1065,136668,2021,Germany,Korea,1,3,10,14,08/06/2021,14,0,58,72,2,0,1,3,0,2,2,4,0,0,0,0,10,0,1,11
1066,136668,2021,Germany,Italy,0,1,1,2,07/06/2021,9,0,15,24,0,0,0,0,0,0,0,0,0,0,0,0,0,0,0,0
1067,136668,2021,Germany,USA,0,0,4,4,06/06/2021,1,1,31,33,0,0,1,1,0,1,1,2,0,0,0,0,1,1,0,2
1068,136668,2021,Germany,Canada,0,0,2,2,02/06/2021,3,2,37,42,1,0,2,3,1,0,0,1,0,0,0,0,2,2,1,5
1069,136668,2021,Türkiye,Germany,1,2,6,9,01/06/2021,15,0,61,76,1,1,2,4,0,2,5,7,0,0,0,0,7,1,4,12
1070,136668,2021,China,Germany,0,2,13,15,31/05/2021,10,1,0,11,3,0,3,6,0,2,2,4,0,0,0,0,8,2,0,10
1071,136668,2021,Germany,Belgium,0,1,7,8,27/05/2021,7,1,63,71,2,1,1,4,0,0,0,0,0,0,0,0,4,0,0,4
1072,136668,2021,Netherlands,Germany,0,2,8,10,26/05/2021,23,1,58,82,4,0,2,6,0,0,0,0,0,0,0,0,3,3,0,6
1073,136668,2021,Germany,Russia,1,0,5,6,25/05/2021,15,3,58,76,1,0,0,1,0,1,2,3,0,0,0,0,11,0,0,11
1074,141676,2021,Dominican Republic,Germany,0,0,0,0,20/06/2021,0,0,0,0,0,0,0,0,0,0,0,0,2,0,3,5,2,0,1,3
1075,141676,2021,Japan,Germany,3,1,20,24,19/06/2021,0,0,2,2,7,2,13,22,1,3,4,8,10,1,15,26,12,0,0,12
1076,141676,2021,Germany,Serbia,1,0,4,5,18/06/2021,0,0,1,1,3,2,2,7,1,1,2,4,4,0,6,10,1,2,0,3
1077,141676,2021,Germany,Poland,0,0,0,0,14/06/2021,0,0,0,0,0,0,0,0,0,0,0,0,0,0,0,0,0,0,0,0
1078,141676,2021,Germany,Brazil,0,0,3,3,13/06/2021,0,0,0,0,0,0,0,0,0,0,0,0,0,0,0,0,1,0,0,1
1079,141676,2021,Thailand,Germany,0,0,3,3,12/06/2021,0,0,0,0,2,0,1,3,0,0,0,0,0,0,2,2,0,1,0,1
1080,141676,2021,Germany,Korea,0,0,0,0,08/06/2021,0,0,0,0,0,0,0,0,0,0,0,0,0,0,0,0,0,0,0,0
1081,141676,2021,Germany,Italy,0,0,1,1,07/06/2021,0,0,0,0,0,2,1,3,0,1,0,1,2,0,2,4,1,1,1,3
1082,141676,2021,Germany,USA,1,0,2,3,06/06/2021,0,0,0,0,1,0,1,2,0,0,0,0,1,0,4,5,0,1,0,1
1083,141676,2021,Germany,Canada,0,0,5,5,02/06/2021,0,0,0,0,3,1,6,10,0,0,1,1,11,3,8,22,3,2,1,6
1084,141676,2021,Türkiye,Germany,0,0,2,2,01/06/2021,0,0,1,1,3,3,3,9,1,1,2,4,0,0,6,6,2,0,0,2
1085,141676,2021,Germany,Belgium,0,0,0,0,27/05/2021,0,0,0,0,1,0,0,1,0,0,0,0,0,0,0,0,0,0,0,0
1086,141676,2021,Netherlands,Germany,0,0,7,7,26/05/2021,0,0,0,0,0,0,0,0,0,0,0,0,1,0,1,2,1,0,0,1
1087,141676,2021,Germany,Russia,0,0,1,1,25/05/2021,0,0,1,1,0,0,0,0,0,0,0,0,1,0,1,2,1,0,0,1
1088,168102,2021,Thailand,Germany,0,0,0,0,12/06/2021,0,0,0,0,0,0,0,0,0,0,0,0,0,0,0,0,0,0,0,0
1089,168102,2021,Germany,Korea,0,0,0,0,08/06/2021,0,0,0,0,0,0,0,0,0,0,0,0,0,0,0,0,0,0,0,0
1090,168102,2021,Germany,Italy,0,1,1,2,07/06/2021,0,0,1,1,3,3,4,10,0,0,0,0,0,1,0,1,2,0,1,3
1091,168102,2021,Germany,USA,0,1,2,3,06/06/2021,0,0,0,0,3,1,3,7,0,2,0,2,0,0,0,0,0,0,0,0
1092,168102,2021,Germany,Canada,1,2,11,14,02/06/2021,0,0,0,0,12,4,12,28,3,1,1,5,0,0,0,0,5,0,1,6
1093,168102,2021,Türkiye,Germany,1,1,1,3,01/06/2021,0,0,1,1,5,3,3,11,0,1,3,4,0,0,1,1,2,0,0,2
1094,168102,2021,China,Germany,0,0,0,0,31/05/2021,0,0,0,0,1,3,0,4,0,1,0,1,0,0,0,0,0,0,0,0
1095,168102,2021,Germany,Belgium,0,0,2,2,27/05/2021,0,0,0,0,0,0,1,1,0,0,0,0,0,0,0,0,0,0,0,0
1096,168102,2021,Netherlands,Germany,1,1,9,11,26/05/2021,0,0,0,0,9,1,9,19,1,0,0,1,1,0,0,1,1,0,0,1
1097,168102,2021,Germany,Russia,0,0,1,1,25/05/2021,0,0,0,0,5,3,3,11,0,1,1,2,0,0,0,0,0,2,0,2
1098,156295,2021,Dominican Republic,Germany,1,2,10,13,20/06/2021,0,0,1,1,23,8,18,49,1,3,4,8,0,0,0,0,7,5,1,13
1099,156295,2021,Japan,Germany,0,0,1,1,19/06/2021,0,0,0,0,1,0,4,5,0,2,0,2,0,0,0,0,2,0,0,2
1100,156295,2021,Germany,Serbia,0,0,0,0,18/06/2021,0,0,0,0,0,0,0,0,0,0,0,0,0,0,0,0,0,0,0,0
1101,156295,2021,Germany,Poland,2,3,7,12,14/06/2021,0,0,1,1,13,2,9,24,0,3,3,6,0,0,0,0,4,1,0,5
1102,156295,2021,Germany,Brazil,3,0,10,13,13/06/2021,0,0,1,1,13,5,16,34,1,4,2,7,0,0,0,0,9,3,1,13
1103,156295,2021,Thailand,Germany,0,2,12,14,12/06/2021,0,0,4,4,9,5,12,26,1,1,1,3,0,0,0,0,8,3,4,15
1104,156295,2021,Germany,Korea,0,1,10,11,08/06/2021,0,0,2,2,10,5,12,27,4,2,9,15,0,0,0,0,7,7,1,15
1105,156295,2021,Germany,Italy,0,1,4,5,07/06/2021,0,0,1,1,7,2,13,22,1,1,2,4,0,0,0,0,5,1,0,6
1106,156295,2021,Germany,USA,0,0,5,5,06/06/2021,0,0,0,0,4,2,7,13,0,0,1,1,0,0,0,0,3,1,0,4
1107,156295,2021,Germany,Canada,0,0,0,0,02/06/2021,0,0,0,0,1,1,1,3,0,0,0,0,0,0,0,0,0,0,0,0
1108,156295,2021,Türkiye,Germany,0,0,1,1,01/06/2021,0,0,0,0,2,0,5,7,0,0,0,0,0,0,0,0,2,1,0,3
1109,156295,2021,China,Germany,0,3,7,10,31/05/2021,1,0,0,1,10,7,11,28,0,2,2,4,0,0,0,0,6,2,0,8
1110,156295,2021,Germany,Belgium,0,2,12,14,27/05/2021,0,0,2,2,8,2,9,19,0,0,0,0,0,0,0,0,2,0,0,2
1111,156295,2021,Netherlands,Germany,0,1,11,12,26/05/2021,0,0,0,0,9,7,12,28,0,0,0,0,0,0,0,0,5,0,0,5
1112,156295,2021,Germany,Russia,0,1,6,7,25/05/2021,0,0,0,0,9,4,11,24,0,3,2,5,0,0,0,0,4,1,0,5
1113,163658,2021,Dominican Republic,Germany,0,2,12,14,20/06/2021,0,0,2,2,12,2,18,32,0,2,2,4,10,0,13,23,11,3,2,16
1114,163658,2021,Japan,Germany,0,3,9,12,19/06/2021,0,0,1,1,11,1,18,30,0,1,3,4,19,4,22,45,8,2,2,12
1115,163658,2021,Germany,Serbia,0,2,3,5,18/06/2021,0,0,2,2,11,3,8,22,0,0,1,1,7,0,9,16,4,2,0,6
1116,163658,2021,Germany,Poland,0,2,11,13,14/06/2021,0,0,2,2,10,1,14,25,1,1,1,3,8,1,10,19,6,0,1,7
1117,163658,2021,Germany,Brazil,0,3,13,16,13/06/2021,0,0,2,2,9,4,7,20,0,1,0,1,15,1,21,37,6,3,0,9
1118,163658,2021,Thailand,Germany,2,2,16,20,12/06/2021,0,0,2,2,13,5,17,35,3,0,1,4,13,3,21,37,4,1,0,5
1119,163658,2021,Germany,Korea,0,2,9,11,08/06/2021,0,1,2,3,14,1,3,18,1,0,1,2,6,1,9,16,11,0,0,11
1120,163658,2021,Germany,Italy,0,2,4,6,07/06/2021,0,0,3,3,11,5,7,23,2,3,2,7,6,1,10,17,1,2,0,3
1121,163658,2021,Germany,USA,0,1,5,6,06/06/2021,0,0,1,1,6,2,11,19,1,3,1,5,4,1,7,12,1,1,0,2
1122,163658,2021,Germany,Canada,0,2,3,5,02/06/2021,0,0,0,0,2,1,4,7,0,0,1,1,3,1,4,8,2,1,0,3
1123,163658,2021,Türkiye,Germany,0,3,6,9,01/06/2021,0,0,1,1,6,1,4,11,1,5,0,6,7,4,22,33,4,2,0,6
1124,163658,2021,China,Germany,1,1,19,21,31/05/2021,1,0,0,1,13,7,14,34,2,3,0,5,21,1,13,35,7,3,0,10
1125,163658,2021,Germany,Belgium,3,1,9,13,27/05/2021,0,0,1,1,11,1,12,24,0,0,0,0,11,1,6,18,1,0,1,2
1126,163658,2021,Netherlands,Germany,2,5,7,14,26/05/2021,0,0,1,1,14,3,25,42,2,0,0,2,8,2,19,29,7,2,0,9
1127,163658,2021,Germany,Russia,0,0,0,0,25/05/2021,0,0,0,0,0,0,2,2,0,0,0,0,0,0,0,0,0,0,0,0
1128,144980,2021,Dominican Republic,Germany,0,0,2,2,20/06/2021,0,0,0,0,1,0,2,3,0,1,1,2,0,0,0,0,0,0,0,0
1129,144980,2021,Japan,Germany,0,0,1,1,19/06/2021,0,0,3,3,1,2,3,6,0,2,0,2,0,0,3,3,4,1,0,5
1130,144980,2021,Germany,Serbia,2,0,15,17,18/06/2021,0,0,2,2,7,2,9,18,0,1,1,2,7,2,10,19,8,0,2,10
1131,144980,2021,Germany,Poland,0,0,0,0,14/06/2021,0,0,0,0,1,0,0,1,0,0,0,0,0,0,0,0,0,0,0,0
1132,144980,2021,Germany,Brazil,0,0,0,0,13/06/2021,0,0,0,0,2,1,2,5,0,0,1,1,0,0,0,0,0,0,0,0
1133,144980,2021,Thailand,Germany,0,0,5,5,12/06/2021,0,1,1,2,8,4,6,18,1,1,0,2,2,0,5,7,3,2,1,6
1134,144980,2021,Germany,Korea,0,0,0,0,08/06/2021,0,0,0,0,0,0,0,0,0,0,0,0,0,0,0,0,0,0,0,0
1135,144980,2021,Germany,Italy,0,0,4,4,07/06/2021,0,0,1,1,2,1,6,9,0,2,0,2,6,3,12,21,1,2,2,5
1136,144980,2021,Germany,USA,1,0,1,2,06/06/2021,0,0,1,1,1,2,4,7,0,1,1,2,1,1,5,7,1,0,0,1
1137,144980,2021,Germany,Canada,0,1,3,4,02/06/2021,0,0,0,0,5,2,0,7,0,1,1,2,5,0,6,11,0,0,1,1
1138,144980,2021,Türkiye,Germany,0,0,1,1,01/06/2021,0,0,0,0,0,0,2,2,0,3,0,3,1,1,1,3,1,0,1,2
1139,144980,2021,China,Germany,0,0,6,6,31/05/2021,0,0,0,0,9,3,9,21,1,0,1,2,6,1,6,13,2,1,0,3
1140,151016,2021,Dominican Republic,Germany,5,5,12,22,20/06/2021,0,0,3,3,11,6,16,33,1,0,5,6,11,1,19,31,11,1,2,14
1141,151016,2021,Japan,Germany,1,3,9,13,19/06/2021,0,0,1,1,17,6,19,42,2,5,3,10,0,0,0,0,4,2,3,9
1142,151016,2021,Germany,Serbia,1,4,5,10,18/06/2021,0,0,1,1,14,5,12,31,0,0,1,1,0,0,0,0,8,3,0,11
1143,151016,2021,Germany,Poland,4,2,8,14,14/06/2021,0,1,0,1,7,5,11,23,2,1,0,3,7,2,25,34,6,4,2,12
1144,151016,2021,Germany,Brazil,2,3,5,10,13/06/2021,0,0,1,1,16,7,22,45,3,3,1,7,11,0,21,32,6,0,1,7
1145,151016,2021,Thailand,Germany,0,4,1,5,12/06/2021,0,0,0,0,8,4,9,21,1,0,1,2,3,0,13,16,7,1,0,8
1146,151016,2021,Germany,Korea,3,1,11,15,08/06/2021,0,1,2,3,13,4,8,25,3,0,2,5,10,1,15,26,5,1,3,9
1147,151016,2021,Germany,Italy,0,0,2,2,07/06/2021,0,0,0,0,6,3,2,11,0,0,1,1,1,1,6,8,2,0,0,2
1148,151016,2021,Germany,USA,0,2,4,6,06/06/2021,0,0,1,1,7,2,5,14,0,3,0,3,7,4,15,26,2,1,1,4
1149,151016,2021,Germany,Canada,0,4,2,6,02/06/2021,0,0,0,0,8,1,6,15,0,2,0,2,3,1,10,14,4,1,0,5
1150,151016,2021,Türkiye,Germany,1,4,7,12,01/06/2021,0,0,0,0,12,4,8,24,1,2,1,4,3,1,10,14,6,1,2,9
1151,151016,2021,China,Germany,3,3,7,13,31/05/2021,0,0,0,0,18,5,12,35,2,1,3,6,6,1,14,21,4,5,0,9
1152,151016,2021,Germany,Belgium,0,0,1,1,27/05/2021,0,0,0,0,0,1,2,3,0,0,0,0,1,0,0,1,0,0,0,0
1153,151016,2021,Netherlands,Germany,0,0,2,2,26/05/2021,0,0,0,0,1,1,4,6,0,0,1,1,2,1,0,3,0,0,0,0
1154,151016,2021,Germany,Russia,1,1,6,8,25/05/2021,0,0,0,0,8,6,12,26,1,1,2,4,5,0,7,12,2,2,0,4
1155,150812,2021,Dominican Republic,Germany,3,1,14,18,20/06/2021,0,0,1,1,4,1,11,16,0,8,3,11,0,0,0,0,3,0,0,3
1156,150812,2021,Japan,Germany,1,0,9,10,19/06/2021,0,0,0,0,9,1,9,19,5,6,4,15,0,0,0,0,1,1,0,2
1157,150812,2021,Germany,Serbia,0,1,6,7,18/06/2021,0,0,2,2,9,3,2,14,1,0,0,1,0,0,0,0,0,1,0,1
1158,150812,2021,Germany,Poland,0,0,10,10,14/06/2021,0,0,0,0,5,2,4,11,2,5,1,8,0,0,0,0,3,0,1,4
1159,150812,2021,Germany,Brazil,0,0,9,9,13/06/2021,0,0,1,1,8,2,6,16,1,1,5,7,0,0,0,0,2,2,1,5
1160,150812,2021,Thailand,Germany,0,1,10,11,12/06/2021,0,0,0,0,7,0,8,15,1,8,4,13,0,0,1,1,2,2,0,4
1161,150812,2021,Germany,Korea,0,1,6,7,08/06/2021,0,0,0,0,5,1,5,11,1,3,4,8,1,0,2,3,2,0,0,2
1162,150812,2021,Germany,Italy,0,1,12,13,07/06/2021,0,0,1,1,1,1,3,5,1,2,0,3,0,1,0,1,1,0,0,1
1163,150812,2021,Germany,USA,0,0,4,4,06/06/2021,0,0,1,1,1,1,2,4,0,2,1,3,0,0,0,0,1,1,0,2
1164,150812,2021,Germany,Canada,0,1,6,7,02/06/2021,0,0,1,1,3,3,4,10,2,3,2,7,0,0,0,0,2,1,1,4
1165,150812,2021,Türkiye,Germany,0,1,9,10,01/06/2021,0,0,1,1,6,2,5,13,1,4,3,8,0,0,0,0,4,0,2,6
1166,150812,2021,China,Germany,1,1,10,12,31/05/2021,0,0,0,0,5,3,7,15,3,0,4,7,3,1,0,4,2,0,1,3
1167,150812,2021,Germany,Belgium,0,1,7,8,27/05/2021,0,0,1,1,5,0,6,11,3,1,1,5,0,0,0,0,0,0,0,0
1168,150812,2021,Netherlands,Germany,0,1,6,7,26/05/2021,0,0,0,0,7,3,4,14,2,3,0,5,0,0,0,0,2,0,0,2
1169,150812,2021,Germany,Russia,1,0,6,7,25/05/2021,0,1,1,2,3,1,7,11,0,6,2,8,0,0,0,0,0,1,1,2
1170,163989,2021,Germany,Italy,0,0,0,0,07/06/2021,0,0,0,0,0,0,0,0,0,0,0,0,0,0,0,0,0,0,0,0
1171,163989,2021,Germany,USA,0,1,1,2,06/06/2021,0,0,1,1,2,0,1,3,0,2,0,2,1,0,0,1,0,0,0,0
1172,163989,2021,Germany,Belgium,0,0,0,0,27/05/2021,0,0,0,0,0,0,0,0,0,0,0,0,0,0,0,0,0,0,0,0
1173,163989,2021,Netherlands,Germany,0,0,0,0,26/05/2021,0,0,0,0,0,0,0,0,0,0,0,0,0,0,0,0,0,0,0,0
1174,163989,2021,Germany,Russia,0,0,0,0,25/05/2021,0,0,0,0,0,0,0,0,0,0,0,0,0,0,0,0,0,0,0,0
1175,136671,2021,Dominican Republic,Germany,0,0,0,0,20/06/2021,0,0,21,21,0,0,0,0,0,0,0,0,15,2,13,30,17,5,3,25
1176,136671,2021,Japan,Germany,0,0,0,0,19/06/2021,0,0,14,14,0,0,0,0,0,0,0,0,6,1,5,12,18,3,2,23
1177,136671,2021,Germany,Serbia,0,0,0,0,18/06/2021,0,0,7,7,0,0,0,0,0,0,0,0,3,1,7,11,11,7,2,20
1178,136671,2021,Germany,Poland,0,0,0,0,14/06/2021,0,0,4,4,0,0,0,0,0,0,0,0,3,0,4,7,11,1,1,13
1179,136671,2021,Germany,Brazil,0,0,0,0,13/06/2021,0,0,13,13,0,0,0,0,0,0,0,0,10,0,10,20,12,7,1,20
1180,136671,2021,Thailand,Germany,0,0,0,0,12/06/2021,0,1,10,11,0,0,0,0,0,0,0,0,9,0,13,22,24,6,4,34
1181,136671,2021,Germany,Korea,0,0,0,0,08/06/2021,0,0,0,0,0,0,0,0,0,0,0,0,0,0,0,0,0,0,0,0
1182,136671,2021,Germany,Italy,0,0,0,0,07/06/2021,0,0,6,6,0,0,0,0,0,0,0,0,6,1,1,8,5,2,0,7
1183,136671,2021,Germany,USA,0,0,0,0,06/06/2021,0,0,7,7,0,0,0,0,0,0,0,0,1,2,8,11,0,6,1,7
1184,136671,2021,Germany,Canada,0,0,0,0,02/06/2021,0,0,5,5,0,0,0,0,0,0,0,0,10,0,8,18,6,6,1,13
1185,136671,2021,Türkiye,Germany,0,0,0,0,01/06/2021,0,0,6,6,0,0,0,0,0,0,0,0,1,0,9,10,8,1,0,9
1186,136671,2021,China,Germany,0,0,0,0,31/05/2021,0,1,3,4,0,0,0,0,0,0,0,0,9,0,9,18,20,9,1,30
1187,136671,2021,Germany,Belgium,0,0,0,0,27/05/2021,0,0,3,3,0,0,0,0,0,0,0,0,4,1,5,10,1,0,0,1
1188,136671,2021,Netherlands,Germany,0,0,0,0,26/05/2021,0,0,8,8,0,0,0,0,0,0,0,0,11,2,10,23,20,3,1,24
1189,136671,2021,Germany,Russia,0,0,0,0,25/05/2021,1,0,6,7,0,0,0,0,0,0,0,0,13,3,12,28,12,4,0,16
1190,163674,2021,Dominican Republic,Germany,0,0,0,0,20/06/2021,0,0,0,0,0,0,0,0,0,0,0,0,0,0,0,0,0,0,0,0
1191,163674,2021,Japan,Germany,0,0,0,0,19/06/2021,0,0,0,0,1,0,0,1,1,0,0,1,0,0,0,0,0,0,0,0
1192,163674,2021,Germany,Serbia,0,0,0,0,18/06/2021,0,0,0,0,0,0,0,0,0,0,0,0,0,0,0,0,0,0,0,0
1193,163674,2021,Germany,Poland,0,0,0,0,14/06/2021,0,0,0,0,0,0,0,0,0,0,0,0,0,0,0,0,0,0,0,0
1194,163674,2021,Germany,Brazil,0,0,0,0,13/06/2021,0,0,0,0,0,0,0,0,0,0,0,0,0,0,0,0,0,0,0,0
1195,163674,2021,Thailand,Germany,0,0,0,0,12/06/2021,0,0,0,0,0,0,0,0,0,0,0,0,0,0,0,0,0,0,0,0
1196,163674,2021,Germany,Korea,0,0,0,0,08/06/2021,0,0,0,0,0,0,0,0,0,0,0,0,0,0,0,0,0,0,0,0
1197,163674,2021,Germany,Canada,0,0,1,1,02/06/2021,0,0,0,0,0,1,0,1,0,0,0,0,0,0,0,0,0,0,0,0
1198,163674,2021,Türkiye,Germany,0,0,1,1,01/06/2021,0,0,0,0,0,0,0,0,0,0,0,0,0,0,0,0,0,0,0,0
1199,163674,2021,China,Germany,0,0,0,0,31/05/2021,0,0,0,0,0,0,0,0,0,0,0,0,0,0,0,0,0,0,0,0
1200,163674,2021,Germany,Belgium,0,0,1,1,27/05/2021,0,0,0,0,0,0,0,0,0,0,0,0,0,0,0,0,0,0,0,0
1201,163674,2021,Netherlands,Germany,0,0,0,0,26/05/2021,0,0,0,0,0,0,0,0,0,0,0,0,0,0,0,0,0,0,0,0
1202,163674,2021,Germany,Russia,0,0,0,0,25/05/2021,0,0,0,0,0,0,0,0,0,0,0,0,0,0,0,0,0,0,0,0
1203,153929,2021,Dominican Republic,Germany,0,3,12,15,20/06/2021,0,0,0,0,7,0,11,18,5,3,9,17,1,0,0,1,3,2,0,5
1204,153929,2021,Japan,Germany,2,3,9,14,19/06/2021,0,0,0,0,7,1,5,13,2,5,3,10,0,0,1,1,0,0,0,0
1205,153929,2021,Germany,Serbia,1,4,13,18,18/06/2021,0,0,1,1,2,0,5,7,2,1,2,5,0,0,0,0,4,1,0,5
1206,153929,2021,Germany,Poland,2,1,9,12,14/06/2021,0,0,0,0,7,0,2,9,3,7,4,14,0,0,0,0,0,1,0,1
1207,153929,2021,Germany,Brazil,0,4,10,14,13/06/2021,0,0,2,2,7,2,3,12,1,6,5,12,0,0,1,1,0,0,0,0
1208,153929,2021,Thailand,Germany,1,2,10,13,12/06/2021,0,0,3,3,6,1,11,18,1,9,13,23,0,0,5,5,3,1,0,4
1209,153929,2021,Germany,Korea,0,1,14,15,08/06/2021,0,0,4,4,6,1,4,11,1,6,1,8,0,0,1,1,3,1,0,4
1210,153929,2021,Germany,Italy,1,2,5,8,07/06/2021,0,0,0,0,3,0,8,11,1,7,6,14,0,0,0,0,4,0,0,4
1211,153929,2021,Germany,USA,1,2,7,10,06/06/2021,0,0,2,2,0,0,2,2,3,2,1,6,0,0,0,0,1,0,0,1
1212,153929,2021,Germany,Canada,1,3,11,15,02/06/2021,0,0,1,1,5,1,5,11,1,8,3,12,0,0,0,0,2,0,0,2
1213,153929,2021,Türkiye,Germany,4,3,7,14,01/06/2021,0,0,0,0,3,0,6,9,0,5,4,9,0,0,0,0,2,0,0,2
1214,153929,2021,China,Germany,2,3,17,22,31/05/2021,0,0,0,0,7,2,2,11,4,4,4,12,0,0,0,0,0,2,0,2
1215,153929,2021,Germany,Belgium,2,2,10,14,27/05/2021,0,0,0,0,6,0,1,7,1,1,0,2,0,0,0,0,2,0,0,2
1216,153929,2021,Netherlands,Germany,2,4,16,22,26/05/2021,0,0,2,2,8,2,2,12,1,6,1,8,0,0,0,0,4,0,0,4
1217,153929,2021,Germany,Russia,2,2,12,16,25/05/2021,2,0,0,2,4,0,4,8,1,2,2,5,0,0,0,0,1,0,0,1
1218,177765,2021,Germany,Korea,0,0,0,0,08/06/2021,0,0,0,0,0,0,0,0,0,0,0,0,0,0,0,0,0,0,0,0
1219,177765,2021,Germany,Italy,0,0,0,0,07/06/2021,0,0,0,0,0,0,0,0,0,0,0,0,0,0,0,0,0,0,0,0
1220,177765,2021,Germany,USA,0,0,0,0,06/06/2021,0,0,0,0,0,0,0,0,0,0,0,0,0,0,0,0,0,0,0,0
1221,177765,2021,Germany,Canada,0,0,0,0,02/06/2021,0,0,0,0,0,0,0,0,0,0,0,0,0,0,0,0,0,0,0,0
1222,177765,2021,Türkiye,Germany,0,0,0,0,01/06/2021,0,0,0,0,0,0,0,0,0,0,0,0,0,0,0,0,0,0,0,0
1223,177765,2021,China,Germany,0,0,0,0,31/05/2021,0,0,0,0,0,0,0,0,0,0,0,0,0,0,0,0,0,0,0,0
1224,151986,2021,Thailand,Italy,0,0,0,0,20/06/2021,0,0,0,0,0,0,0,0,0,0,0,0,0,0,0,0,0,0,0,0
1225,151986,2021,Belgium,Italy,1,0,14,15,19/06/2021,10,1,96,107,0,0,1,1,1,2,1,4,0,0,0,0,9,5,0,14
1226,151986,2021,Canada,Italy,0,0,18,18,18/06/2021,23,0,58,81,1,0,0,1,1,3,2,6,0,0,0,0,6,0,0,6
1227,151986,2021,China,Italy,0,0,7,7,14/06/2021,9,1,62,72,0,0,0,0,0,0,0,0,0,0,0,0,1,1,0,2
1228,151986,2021,Italy,Netherlands,1,0,19,20,13/06/2021,9,0,120,129,0,0,0,0,0,3,4,7,0,0,0,0,7,5,0,12
1229,151986,2021,Dominican Republic,Italy,2,0,17,19,12/06/2021,19,0,117,136,0,0,0,0,0,5,1,6,0,1,0,1,3,2,0,5
1230,151986,2021,Italy,USA,1,0,16,17,08/06/2021,12,0,82,94,0,0,1,1,0,0,4,4,0,0,0,0,6,2,0,8
1231,151986,2021,Germany,Italy,2,0,16,18,07/06/2021,15,1,52,68,1,0,0,1,0,1,1,2,0,0,0,0,8,1,0,9
1232,151986,2021,Italy,Korea,4,0,24,28,06/06/2021,18,1,104,123,0,0,2,2,1,3,12,16,0,0,0,0,9,3,1,13
1233,151986,2021,Brazil,Italy,2,1,11,14,02/06/2021,24,0,75,99,1,0,1,2,0,5,2,7,0,0,0,0,5,3,2,10
1234,151986,2021,Italy,Japan,1,1,19,21,01/06/2021,14,0,124,138,1,0,2,3,2,2,4,8,0,0,0,0,7,1,0,8
1235,151986,2021,Russia,Italy,1,0,8,9,31/05/2021,23,1,62,86,0,0,1,1,0,5,1,6,0,0,0,0,3,2,0,5
1236,151986,2021,Serbia,Italy,0,0,8,8,27/05/2021,8,0,37,45,0,0,0,0,0,1,1,2,0,0,0,0,2,0,0,2
1237,151986,2021,Türkiye,Italy,1,0,5,6,26/05/2021,6,0,40,46,1,0,0,1,0,0,0,0,0,0,0,0,1,2,0,3
1238,151986,2021,Italy,Poland,0,0,15,15,25/05/2021,35,1,111,147,0,0,0,0,0,1,1,2,0,0,0,0,8,1,0,9
1239,142391,2021,Thailand,Italy,0,0,0,0,20/06/2021,0,0,0,0,0,0,0,0,0,0,0,0,0,0,0,0,0,0,0,0
1240,142391,2021,Belgium,Italy,1,2,11,14,19/06/2021,0,0,0,0,5,1,5,11,1,4,0,5,0,0,0,0,0,1,0,1
1241,142391,2021,Canada,Italy,1,1,12,14,18/06/2021,0,0,0,0,5,1,6,12,1,5,6,12,0,0,0,0,3,1,0,4
1242,142391,2021,China,Italy,0,0,0,0,14/06/2021,0,0,0,0,0,0,0,0,0,0,0,0,0,0,0,0,0,0,0,0
1243,142391,2021,Italy,Netherlands,2,1,17,20,13/06/2021,0,0,2,2,5,0,12,17,1,7,1,9,0,0,0,0,3,3,0,6
1244,142391,2021,Dominican Republic,Italy,0,2,2,4,12/06/2021,0,0,0,0,3,0,2,5,0,1,1,2,0,0,0,0,1,1,0,2
1245,142391,2021,Italy,USA,0,0,0,0,08/06/2021,0,0,0,0,0,0,0,0,0,0,0,0,0,0,0,0,0,0,0,0
1246,142391,2021,Germany,Italy,1,0,7,8,07/06/2021,0,0,2,2,4,0,2,6,0,2,1,3,0,0,0,0,1,0,0,1
1247,142391,2021,Italy,Korea,1,1,14,16,06/06/2021,0,1,1,2,5,0,8,13,1,4,5,10,0,0,1,1,4,1,0,5
1248,142391,2021,Brazil,Italy,0,2,9,11,02/06/2021,0,0,2,2,6,2,1,9,2,4,6,12,0,0,0,0,5,0,0,5
1249,142391,2021,Italy,Japan,0,0,20,20,01/06/2021,0,0,2,2,7,1,6,14,2,4,2,8,0,0,0,0,2,2,0,4
1250,142391,2021,Russia,Italy,1,1,7,9,31/05/2021,0,0,1,1,5,0,1,6,1,2,2,5,0,0,0,0,2,0,0,2
1251,142391,2021,Serbia,Italy,0,0,0,0,27/05/2021,0,0,0,0,0,0,0,0,0,0,0,0,0,0,0,0,0,0,0,0
1252,142391,2021,Türkiye,Italy,0,0,0,0,26/05/2021,0,0,0,0,0,0,0,0,0,0,0,0,0,0,0,0,0,0,0,0
1253,142391,2021,Italy,Poland,0,0,0,0,25/05/2021,0,0,0,0,0,0,0,0,0,0,0,0,0,0,0,0,0,0,0,0
1254,143393,2021,Thailand,Italy,0,0,0,0,20/06/2021,0,0,0,0,0,0,0,0,0,0,0,0,0,0,0,0,0,0,0,0
1255,143393,2021,Belgium,Italy,0,2,11,13,19/06/2021,0,0,0,0,7,2,12,21,0,2,0,2,2,3,23,28,7,4,1,12
1256,143393,2021,Canada,Italy,0,0,0,0,18/06/2021,0,0,0,0,0,1,0,1,0,0,0,0,2,0,0,2,1,0,0,1
1257,143393,2021,China,Italy,0,0,0,0,14/06/2021,0,0,0,0,0,0,0,0,0,0,0,0,0,0,0,0,0,0,0,0
1258,143393,2021,Italy,Netherlands,0,0,0,0,13/06/2021,1,0,0,1,0,0,0,0,0,0,0,0,0,0,0,0,0,0,0,0
1259,143393,2021,Italy,USA,0,0,0,0,08/06/2021,0,0,0,0,0,0,0,0,0,0,0,0,0,0,0,0,0,0,0,0
1260,143393,2021,Germany,Italy,1,1,13,15,07/06/2021,0,0,0,0,8,4,6,18,1,3,0,4,2,1,7,10,6,2,0,8
1261,143393,2021,Italy,Korea,0,3,11,14,06/06/2021,0,0,2,2,8,3,17,28,1,0,0,1,9,3,24,36,12,1,2,15
1262,143393,2021,Brazil,Italy,0,0,0,0,02/06/2021,0,0,0,0,0,0,1,1,0,0,0,0,0,0,1,1,1,0,0,1
1263,143393,2021,Italy,Japan,1,1,8,10,01/06/2021,0,0,1,1,20,5,25,50,5,1,0,6,3,2,12,17,9,3,0,12
1264,143393,2021,Russia,Italy,0,1,8,9,31/05/2021,0,0,4,4,9,6,6,21,0,0,1,1,11,1,25,37,11,3,1,15
1265,143393,2021,Serbia,Italy,0,0,0,0,27/05/2021,0,0,0,0,0,0,0,0,0,0,0,0,0,0,0,0,0,0,0,0
1266,143393,2021,Türkiye,Italy,0,1,3,4,26/05/2021,0,0,0,0,5,2,3,10,0,2,0,2,6,3,10,19,3,0,0,3
1267,143393,2021,Italy,Poland,2,1,17,20,25/05/2021,0,0,1,1,12,9,16,37,2,0,1,3,11,4,33,48,11,3,0,14
1268,151664,2021,Thailand,Italy,0,0,0,0,20/06/2021,0,0,0,0,0,0,0,0,0,0,0,0,0,0,0,0,0,0,0,0
1269,151664,2021,Belgium,Italy,0,4,3,7,19/06/2021,0,0,2,2,19,9,13,41,3,4,0,7,0,0,0,0,6,3,0,9
1270,151664,2021,Canada,Italy,0,3,3,6,18/06/2021,0,0,0,0,18,3,10,31,0,3,3,6,0,0,0,0,5,2,1,8
1271,151664,2021,China,Italy,0,0,0,0,14/06/2021,0,0,0,0,0,0,1,1,0,1,0,1,0,0,0,0,0,0,0,0
1272,151664,2021,Italy,Netherlands,1,4,11,16,13/06/2021,0,0,1,1,25,8,25,58,1,1,1,3,0,0,0,0,15,6,0,21
1273,151664,2021,Dominican Republic,Italy,0,0,0,0,12/06/2021,0,0,0,0,0,0,0,0,0,0,0,0,0,0,0,0,0,0,0,0
1274,151664,2021,Italy,USA,0,4,2,6,08/06/2021,0,0,2,2,6,7,6,19,2,5,2,9,0,0,0,0,8,1,0,9
1275,151664,2021,Germany,Italy,0,0,0,0,07/06/2021,0,0,0,0,0,0,0,0,0,0,0,0,0,0,0,0,0,0,0,0
1276,151664,2021,Italy,Korea,0,2,5,7,06/06/2021,0,0,2,2,15,7,9,31,1,4,0,5,0,1,0,1,7,2,1,10
1277,151664,2021,Brazil,Italy,0,0,0,0,02/06/2021,0,0,0,0,0,0,0,0,0,0,0,0,0,0,0,0,0,0,0,0
1278,151664,2021,Italy,Japan,1,2,11,14,01/06/2021,0,0,4,4,22,11,20,53,1,6,1,8,0,0,0,0,6,6,2,14
1279,151664,2021,Russia,Italy,2,6,7,15,31/05/2021,0,0,1,1,18,6,9,33,2,3,2,7,0,0,0,0,2,3,1,6
1280,151664,2021,Serbia,Italy,0,3,8,11,27/05/2021,0,0,1,1,21,6,17,44,3,2,0,5,0,0,0,0,5,1,1,7
1281,151664,2021,Türkiye,Italy,0,2,2,4,26/05/2021,0,0,2,2,9,3,7,19,0,1,0,1,0,0,0,0,3,5,0,8
1282,151664,2021,Italy,Poland,1,2,0,3,25/05/2021,0,0,0,0,2,1,1,4,0,1,1,2,0,0,0,0,4,0,0,4
1283,143401,2021,Canada,Italy,0,1,0,1,18/06/2021,0,0,0,0,0,0,0,0,0,0,0,0,0,0,0,0,0,0,0,0
1284,143401,2021,China,Italy,2,1,7,10,14/06/2021,0,0,1,1,9,5,12,26,1,0,1,2,0,0,0,0,11,2,0,13
1285,143401,2021,Italy,Netherlands,0,1,1,2,13/06/2021,0,0,0,0,0,0,4,4,0,0,0,0,0,0,1,1,2,0,0,2
1286,143401,2021,Dominican Republic,Italy,0,4,10,14,12/06/2021,0,0,0,0,25,6,29,60,1,3,1,5,0,0,0,0,11,3,0,14
1287,143401,2021,Italy,USA,0,1,3,4,08/06/2021,0,0,0,0,9,1,10,20,0,2,2,4,0,0,0,0,5,3,2,10
1288,143401,2021,Germany,Italy,1,1,8,10,07/06/2021,0,0,3,3,17,3,15,35,1,0,1,2,0,0,0,0,9,1,0,10
1289,143401,2021,Italy,Korea,0,2,2,4,06/06/2021,0,0,0,0,11,1,14,26,0,4,1,5,0,0,0,0,5,0,0,5
1290,143401,2021,Brazil,Italy,0,1,13,14,02/06/2021,0,0,3,3,11,10,20,41,2,2,3,7,0,0,0,0,14,5,4,23
1291,143401,2021,Italy,Japan,0,0,1,1,01/06/2021,0,0,0,0,1,0,1,2,0,0,0,0,0,0,0,0,0,1,0,1
1292,143401,2021,Russia,Italy,0,0,0,0,31/05/2021,0,0,0,0,0,0,0,0,0,0,0,0,0,0,0,0,0,0,0,0
1293,143401,2021,Serbia,Italy,0,1,2,3,27/05/2021,0,0,1,1,4,2,5,11,1,1,0,2,0,0,0,0,2,0,0,2
1294,143401,2021,Türkiye,Italy,0,2,4,6,26/05/2021,0,0,0,0,6,4,4,14,0,0,0,0,0,0,0,0,3,0,0,3
1295,143401,2021,Italy,Poland,1,0,15,16,25/05/2021,0,0,1,1,13,8,21,42,2,2,4,8,0,0,0,0,12,4,0,16
1296,151658,2021,Thailand,Italy,1,3,18,22,20/06/2021,0,0,1,1,7,2,7,16,2,4,11,17,0,0,0,0,3,1,0,4
1297,151658,2021,Belgium,Italy,0,0,1,1,19/06/2021,0,0,0,0,0,2,1,3,0,0,0,0,0,0,0,0,0,0,0,0
1298,151658,2021,Canada,Italy,0,0,0,0,18/06/2021,0,0,0,0,0,0,0,0,0,0,0,0,0,0,0,0,0,0,0,0
1299,151658,2021,China,Italy,1,2,4,7,14/06/2021,0,0,1,1,7,1,4,12,0,2,1,3,0,0,0,0,0,1,1,2
1300,151658,2021,Italy,Netherlands,0,0,1,1,13/06/2021,0,0,0,0,0,1,1,2,0,0,1,1,0,0,0,0,0,0,0,0
1301,151658,2021,Dominican Republic,Italy,0,2,6,8,12/06/2021,0,0,1,1,2,2,4,8,1,1,1,3,0,0,1,1,2,0,0,2
1302,151658,2021,Italy,USA,4,2,10,16,08/06/2021,0,0,2,2,7,0,4,11,1,4,2,7,0,0,0,0,2,0,0,2
1303,151658,2021,Germany,Italy,0,0,0,0,07/06/2021,0,0,0,0,0,0,0,0,0,0,0,0,0,0,1,1,0,0,0,0
1304,151658,2021,Italy,Korea,0,0,0,0,06/06/2021,0,0,0,0,0,0,0,0,0,0,0,0,0,0,0,0,0,0,0,0
1305,151658,2021,Brazil,Italy,3,2,10,15,02/06/2021,0,0,3,3,7,1,7,15,0,6,7,13,0,0,0,0,2,0,0,2
1306,151658,2021,Italy,Japan,0,0,0,0,01/06/2021,0,0,0,0,0,0,0,0,0,0,0,0,0,0,0,0,0,0,0,0
1307,151658,2021,Russia,Italy,0,0,3,3,31/05/2021,0,0,0,0,2,1,2,5,2,0,2,4,0,0,0,0,1,0,0,1
1308,151658,2021,Serbia,Italy,0,3,4,7,27/05/2021,0,0,1,1,1,2,3,6,2,3,2,7,0,0,0,0,1,0,0,1
1309,151658,2021,Türkiye,Italy,0,4,5,9,26/05/2021,0,0,2,2,4,2,1,7,0,1,0,1,0,0,0,0,1,1,0,2
1310,151658,2021,Italy,Poland,4,6,10,20,25/05/2021,0,0,2,2,6,4,6,16,1,8,9,18,0,0,0,0,0,1,0,1
1311,156091,2021,Thailand,Italy,1,0,22,23,20/06/2021,24,4,108,136,0,0,3,3,1,3,5,9,0,0,0,0,9,2,0,11
1312,156091,2021,Belgium,Italy,0,0,1,1,19/06/2021,0,0,13,13,0,0,0,0,0,0,0,0,0,0,0,0,0,0,0,0
1313,156091,2021,China,Italy,0,0,0,0,14/06/2021,0,0,9,9,0,0,0,0,0,0,0,0,0,0,0,0,0,1,1,2
1314,156091,2021,Italy,Netherlands,0,0,0,0,13/06/2021,0,0,8,8,0,0,0,0,0,0,0,0,0,0,0,0,0,0,0,0
1315,156091,2021,Dominican Republic,Italy,0,0,0,0,12/06/2021,1,0,6,7,0,0,0,0,0,0,0,0,0,0,0,0,0,0,0,0
1316,150445,2021,Thailand,Italy,0,0,0,0,20/06/2021,1,0,14,15,0,0,0,0,0,0,0,0,12,1,14,27,18,6,2,26
1317,150445,2021,Belgium,Italy,0,0,0,0,19/06/2021,0,0,0,0,0,0,0,0,0,0,0,0,1,0,2,3,2,0,0,2
1318,150445,2021,Canada,Italy,0,0,0,0,18/06/2021,0,0,0,0,0,0,0,0,0,0,0,0,0,0,0,0,0,0,0,0
1319,150445,2021,China,Italy,0,0,0,0,14/06/2021,0,0,2,2,0,0,0,0,0,0,0,0,1,0,0,1,0,0,0,0
1320,150445,2021,Italy,Netherlands,0,0,0,0,13/06/2021,0,0,24,24,0,0,0,0,0,0,0,0,6,2,15,23,22,5,0,27
1321,150445,2021,Dominican Republic,Italy,0,0,0,0,12/06/2021,0,0,1,1,0,0,0,0,0,0,0,0,3,1,1,5,2,0,0,2
1322,150445,2021,Italy,USA,0,0,0,0,08/06/2021,0,0,6,6,0,0,0,0,0,0,0,0,1,3,6,10,13,3,2,18
1323,150445,2021,Germany,Italy,0,0,0,0,07/06/2021,0,0,0,0,0,0,0,0,0,0,0,0,0,0,2,2,0,1,0,1
1324,150445,2021,Italy,Korea,0,0,0,0,06/06/2021,0,0,1,1,0,0,0,0,0,0,0,0,2,0,3,5,0,2,0,2
1325,150445,2021,Brazil,Italy,0,0,0,0,02/06/2021,0,0,14,14,0,0,0,0,0,0,0,0,6,1,18,25,17,7,1,25
1326,150445,2021,Italy,Japan,0,0,0,0,01/06/2021,0,0,4,4,0,0,0,0,0,0,0,0,4,0,3,7,2,2,0,4
1327,150445,2021,Russia,Italy,0,0,0,0,31/05/2021,0,0,1,1,0,0,0,0,0,0,0,0,0,0,2,2,0,0,1,1
1328,150445,2021,Serbia,Italy,0,0,0,0,27/05/2021,0,0,3,3,0,0,0,0,0,0,0,0,4,0,6,10,3,1,0,4
1329,150445,2021,Türkiye,Italy,0,0,0,0,26/05/2021,0,0,0,0,0,0,0,0,0,0,0,0,0,1,2,3,0,1,0,1
1330,150445,2021,Italy,Poland,0,0,0,0,25/05/2021,0,0,0,0,0,0,0,0,0,0,0,0,0,0,0,0,0,0,0,0
1331,151661,2021,Thailand,Italy,0,0,3,3,20/06/2021,0,0,0,0,0,0,0,0,0,0,0,0,0,0,0,0,1,0,0,1
1332,151661,2021,Belgium,Italy,1,0,25,26,19/06/2021,0,0,2,2,9,1,5,15,3,2,1,6,0,0,0,0,3,3,0,6
1333,151661,2021,Canada,Italy,0,0,9,9,18/06/2021,0,0,0,0,4,1,5,10,2,2,5,9,0,0,0,0,2,1,1,4
1334,151661,2021,China,Italy,0,0,0,0,14/06/2021,0,0,0,0,0,0,0,0,0,0,0,0,0,0,0,0,0,0,0,0
1335,151661,2021,Italy,Netherlands,1,1,12,14,13/06/2021,0,0,0,0,6,1,4,11,4,4,1,9,0,0,0,0,0,2,0,2
1336,151661,2021,Dominican Republic,Italy,0,0,13,13,12/06/2021,0,0,1,1,10,1,5,16,4,3,3,10,0,0,0,0,4,2,0,6
1337,151661,2021,Italy,USA,0,0,7,7,08/06/2021,0,0,0,0,2,0,3,5,1,2,0,3,0,0,0,0,1,1,0,2
1338,151661,2021,Germany,Italy,3,1,10,14,07/06/2021,0,0,3,3,3,1,4,8,2,0,2,4,0,0,0,0,3,2,0,5
1339,151661,2021,Italy,Korea,1,1,15,17,06/06/2021,0,0,1,1,8,2,1,11,5,7,8,20,0,0,0,0,3,0,2,5
1340,151661,2021,Brazil,Italy,0,0,0,0,02/06/2021,0,0,0,0,0,0,0,0,0,0,0,0,0,0,0,0,0,0,0,0
1341,151661,2021,Italy,Japan,1,1,15,17,01/06/2021,0,0,0,0,8,2,6,16,0,1,1,2,0,0,1,1,1,4,0,5
1342,151661,2021,Russia,Italy,1,0,17,18,31/05/2021,0,0,2,2,4,2,0,6,0,2,1,3,0,0,0,0,4,2,0,6
1343,151661,2021,Serbia,Italy,1,1,18,20,27/05/2021,0,0,0,0,2,0,4,6,3,1,0,4,0,0,0,0,3,1,1,5
1344,151661,2021,Türkiye,Italy,0,0,9,9,26/05/2021,0,0,0,0,1,1,3,5,0,4,1,5,0,0,0,0,1,0,1,2
1345,151661,2021,Italy,Poland,0,0,16,16,25/05/2021,0,0,0,0,7,2,9,18,2,3,1,6,0,0,0,0,4,0,0,4
1346,181258,2021,Thailand,Italy,2,3,10,15,20/06/2021,0,0,2,2,4,3,7,14,1,3,8,12,5,0,11,16,15,3,1,19
1347,181258,2021,Belgium,Italy,0,0,4,4,19/06/2021,0,0,0,0,0,0,0,0,0,0,0,0,0,0,0,0,1,1,0,2
1348,181258,2021,Canada,Italy,0,0,0,0,18/06/2021,0,0,0,0,0,0,0,0,0,0,0,0,1,0,2,3,0,0,0,0
1349,181258,2021,China,Italy,0,1,3,4,14/06/2021,0,0,0,0,5,1,8,14,0,0,1,1,4,1,5,10,4,2,0,6
1350,181258,2021,Italy,Netherlands,0,3,10,13,13/06/2021,0,0,1,1,8,5,6,19,2,1,0,3,6,1,17,24,7,4,0,11
1351,181258,2021,Dominican Republic,Italy,0,1,1,2,12/06/2021,0,0,0,0,0,2,6,8,0,0,0,0,1,0,6,7,2,1,0,3
1352,180478,2021,Canada,Italy,0,0,0,0,18/06/2021,0,0,0,0,0,0,0,0,0,0,0,0,0,0,0,0,0,0,0,0
1353,180478,2021,Italy,USA,0,0,0,0,08/06/2021,0,0,6,6,0,0,0,0,0,0,0,0,0,0,0,0,0,0,0,0
1354,180478,2021,Germany,Italy,0,0,0,0,07/06/2021,0,0,0,0,0,0,0,0,0,0,0,0,0,0,0,0,0,0,0,0
1355,180478,2021,Italy,Korea,0,0,1,1,06/06/2021,0,0,4,4,0,0,0,0,0,0,0,0,0,0,0,0,0,0,1,1
1356,180478,2021,Brazil,Italy,0,0,0,0,02/06/2021,1,0,7,8,0,0,0,0,0,0,0,0,0,0,0,0,0,0,0,0
1357,180478,2021,Italy,Japan,0,0,0,0,01/06/2021,0,0,4,4,0,0,0,0,0,0,0,0,0,0,0,0,0,0,0,0
1358,180478,2021,Russia,Italy,0,0,0,0,31/05/2021,0,0,0,0,0,0,0,0,0,0,0,0,0,0,0,0,0,0,0,0
1359,180478,2021,Serbia,Italy,0,3,4,7,27/05/2021,16,2,63,81,0,0,0,0,1,3,2,6,0,0,0,0,7,3,0,10
1360,180478,2021,Türkiye,Italy,0,0,1,1,26/05/2021,5,0,17,22,0,0,0,0,0,1,0,1,0,0,0,0,1,0,0,1
1361,180478,2021,Italy,Poland,0,0,0,0,25/05/2021,1,0,2,3,0,0,0,0,0,0,0,0,0,0,0,0,0,0,0,0
1362,136692,2021,Thailand,Italy,1,3,6,10,20/06/2021,0,0,2,2,11,1,6,18,8,10,10,28,0,0,0,0,6,2,0,8
1363,136692,2021,Belgium,Italy,0,0,0,0,19/06/2021,0,0,0,0,0,0,0,0,0,0,0,0,0,0,0,0,0,0,0,0
1364,136692,2021,China,Italy,0,3,8,11,14/06/2021,0,0,1,1,1,1,4,6,1,2,0,3,0,1,0,1,3,2,0,5
1365,136692,2021,Italy,Netherlands,0,0,0,0,13/06/2021,0,0,0,0,0,0,0,0,0,0,0,0,0,0,0,0,0,0,0,0
1366,136692,2021,Dominican Republic,Italy,0,0,0,0,12/06/2021,0,0,0,0,0,0,0,0,0,0,0,0,0,0,0,0,0,0,0,0
1367,136692,2021,Italy,USA,0,1,7,8,08/06/2021,0,0,0,0,3,0,4,7,2,2,3,7,0,0,0,0,0,0,1,1
1368,136692,2021,Germany,Italy,0,0,0,0,07/06/2021,0,0,0,0,0,0,0,0,0,0,0,0,0,0,0,0,0,0,0,0
1369,136692,2021,Italy,Korea,0,0,0,0,06/06/2021,0,0,0,0,0,0,0,0,0,0,0,0,0,0,0,0,0,0,0,0
1370,136692,2021,Brazil,Italy,0,0,1,1,02/06/2021,0,0,0,0,0,0,0,0,0,0,0,0,0,0,0,0,0,1,0,1
1371,136692,2021,Italy,Japan,0,0,0,0,01/06/2021,0,0,0,0,0,0,0,0,0,0,0,0,0,0,0,0,0,0,0,0
1372,136692,2021,Russia,Italy,0,0,0,0,31/05/2021,0,0,0,0,0,0,0,0,0,0,0,0,0,0,0,0,0,0,0,0
1373,136692,2021,Serbia,Italy,0,0,6,6,27/05/2021,0,0,0,0,3,0,5,8,1,4,1,6,0,0,0,0,1,0,0,1
1374,136692,2021,Türkiye,Italy,0,0,1,1,26/05/2021,0,0,0,0,0,0,0,0,0,0,0,0,0,0,0,0,0,0,0,0
1375,136692,2021,Italy,Poland,0,0,0,0,25/05/2021,0,0,0,0,0,0,0,0,0,0,0,0,0,0,0,0,0,0,0,0
1376,151663,2021,Thailand,Italy,1,1,17,19,20/06/2021,0,0,2,2,17,3,23,43,2,2,0,4,7,0,8,15,7,2,2,11
1377,151663,2021,Belgium,Italy,0,0,2,2,19/06/2021,0,0,2,2,2,1,7,10,0,0,0,0,2,2,10,14,1,0,0,1
1378,151663,2021,Canada,Italy,0,0,9,9,18/06/2021,0,0,1,1,9,1,8,18,2,0,0,2,4,1,20,25,7,2,1,10
1379,151663,2021,China,Italy,0,0,8,8,14/06/2021,0,0,3,3,11,5,17,33,0,0,0,0,6,1,21,28,4,3,0,7
1380,151663,2021,Italy,Netherlands,0,0,15,15,13/06/2021,0,0,3,3,19,2,26,47,2,1,0,3,8,3,24,35,6,7,1,14
1381,151663,2021,Dominican Republic,Italy,0,1,12,13,12/06/2021,0,0,1,1,11,6,13,30,2,1,0,3,9,3,8,20,10,3,0,13
1382,151663,2021,Italy,USA,0,2,7,9,08/06/2021,0,0,3,3,10,3,7,20,2,1,0,3,8,2,38,48,3,1,1,5
1383,151663,2021,Germany,Italy,0,0,2,2,07/06/2021,0,0,0,0,1,0,0,1,1,0,1,2,0,0,0,0,0,0,0,0
1384,151663,2021,Italy,Korea,0,0,0,0,06/06/2021,0,0,0,0,1,0,1,2,0,1,0,1,1,1,0,2,0,0,0,0
1385,151663,2021,Brazil,Italy,0,2,8,10,02/06/2021,0,0,1,1,18,10,14,42,1,0,0,1,4,1,20,25,2,4,2,8
1386,151663,2021,Italy,Japan,1,0,6,7,01/06/2021,0,0,0,0,3,1,4,8,1,0,0,1,4,0,5,9,3,1,0,4
1387,151663,2021,Russia,Italy,0,0,1,1,31/05/2021,0,0,0,0,0,0,0,0,0,0,0,0,0,0,0,0,0,0,0,0
1388,151663,2021,Serbia,Italy,0,0,5,5,27/05/2021,0,0,0,0,3,1,1,5,0,0,0,0,0,0,1,1,3,0,0,3
1389,151663,2021,Türkiye,Italy,0,0,1,1,26/05/2021,0,0,0,0,1,0,0,1,0,0,0,0,0,0,2,2,0,0,0,0
1390,151663,2021,Italy,Poland,0,0,0,0,25/05/2021,0,0,0,0,0,2,0,2,0,0,1,1,0,1,0,1,0,0,0,0
1391,143391,2021,Thailand,Italy,0,1,0,1,20/06/2021,0,0,0,0,0,0,0,0,0,0,0,0,2,0,2,4,1,0,0,1
1392,143391,2021,Belgium,Italy,1,3,6,10,19/06/2021,0,0,0,0,10,4,24,38,2,2,0,4,9,5,12,26,10,2,1,13
1393,143391,2021,Canada,Italy,3,1,13,17,18/06/2021,0,0,3,3,10,2,9,21,0,4,3,7,4,0,8,12,9,1,2,12
1394,143391,2021,Dominican Republic,Italy,0,2,11,13,12/06/2021,0,0,0,0,2,3,13,18,0,0,0,0,6,2,4,12,3,3,0,6
1395,143391,2021,Italy,USA,1,3,9,13,08/06/2021,0,0,1,1,10,4,19,33,0,3,3,6,6,2,10,18,4,1,1,6
1396,143391,2021,Germany,Italy,0,3,4,7,07/06/2021,0,0,1,1,7,0,10,17,0,3,3,6,6,0,8,14,7,1,0,8
1397,143391,2021,Italy,Korea,1,2,8,11,06/06/2021,0,0,2,2,10,7,15,32,0,4,1,5,11,1,7,19,8,0,3,11
1398,143391,2021,Brazil,Italy,0,3,10,13,02/06/2021,0,0,3,3,7,4,17,28,0,1,1,2,5,1,18,24,6,4,1,11
1399,143391,2021,Italy,Japan,2,4,12,18,01/06/2021,0,0,0,0,7,1,9,17,0,1,0,1,15,4,17,36,8,5,0,13
1400,143391,2021,Russia,Italy,0,2,3,5,31/05/2021,0,0,0,0,2,4,13,19,0,0,0,0,0,0,3,3,4,1,0,5
1401,143391,2021,Serbia,Italy,0,1,8,9,27/05/2021,0,0,1,1,10,7,15,32,0,0,2,2,4,0,13,17,6,1,0,7
1402,143391,2021,Türkiye,Italy,0,3,6,9,26/05/2021,0,0,1,1,6,3,7,16,0,0,0,0,5,1,7,13,1,0,0,1
1403,143391,2021,Italy,Poland,2,2,16,20,25/05/2021,0,0,1,1,13,4,25,42,4,5,3,12,4,2,9,15,10,1,1,12
1404,173917,2021,,,-,-,-,-,-,-,-,-,-,-,-,-,-,-,-,-,-,-,-,-,-,-,-,-,-
1405,173402,2021,Thailand,Italy,0,0,0,0,20/06/2021,0,0,1,1,0,0,1,1,0,0,0,0,8,0,1,9,1,0,0,1
1406,173402,2021,Belgium,Italy,0,0,0,0,19/06/2021,0,1,13,14,0,0,0,0,0,0,0,0,9,0,14,23,10,12,2,24
1407,173402,2021,Canada,Italy,0,0,0,0,18/06/2021,0,0,7,7,0,0,0,0,0,0,0,0,4,0,10,14,11,0,3,14
1408,173402,2021,China,Italy,0,0,0,0,14/06/2021,0,0,9,9,0,0,0,0,0,0,0,0,9,1,3,13,7,6,0,13
1409,173402,2021,Italy,Netherlands,0,0,0,0,13/06/2021,0,0,0,0,0,0,0,0,0,0,0,0,1,0,5,6,0,0,0,0
1410,173402,2021,Dominican Republic,Italy,0,0,0,0,12/06/2021,0,0,6,6,0,0,0,0,0,0,0,0,17,3,12,32,18,3,4,25
1411,173402,2021,Italy,USA,0,0,0,0,08/06/2021,0,0,0,0,0,0,0,0,0,0,0,0,1,0,1,2,4,1,0,5
1412,173402,2021,Germany,Italy,0,0,0,0,07/06/2021,0,0,10,10,0,0,0,0,0,0,0,0,9,0,8,17,13,2,3,18
1413,173402,2021,Italy,Korea,0,0,0,0,06/06/2021,0,0,9,9,0,0,0,0,0,0,0,0,12,0,6,18,19,1,3,23
1414,173402,2021,Brazil,Italy,0,0,0,0,02/06/2021,0,0,1,1,0,0,0,0,0,0,0,0,3,1,3,7,2,0,1,3
1415,173402,2021,Italy,Japan,0,0,0,0,01/06/2021,0,0,9,9,0,0,0,0,0,0,0,0,11,0,15,26,18,7,1,26
1416,173402,2021,Russia,Italy,0,0,0,0,31/05/2021,0,0,5,5,0,0,0,0,0,0,0,0,4,0,14,18,9,5,2,16
1417,173402,2021,Serbia,Italy,0,0,0,0,27/05/2021,0,1,7,8,0,0,0,0,0,0,0,0,11,0,6,17,9,6,0,15
1418,173402,2021,Türkiye,Italy,0,0,0,0,26/05/2021,0,0,4,4,0,0,0,0,0,0,0,0,2,0,7,9,8,5,0,13
1419,173402,2021,Italy,Poland,0,0,0,0,25/05/2021,0,0,7,7,0,0,0,0,0,0,0,0,12,1,14,27,24,4,0,28
1420,173730,2021,Thailand,Italy,1,0,15,16,20/06/2021,0,0,2,2,28,5,27,60,4,4,4,12,5,3,14,22,15,3,1,19
1421,173730,2021,Belgium,Italy,0,0,1,1,19/06/2021,0,0,0,0,2,0,2,4,0,0,0,0,0,0,1,1,1,0,0,1
1422,173730,2021,Canada,Italy,0,0,0,0,18/06/2021,0,0,0,0,0,0,0,0,0,0,0,0,0,0,0,0,0,0,0,0
1423,173730,2021,China,Italy,0,0,3,3,14/06/2021,0,0,0,0,4,1,1,6,0,0,0,0,1,2,11,14,0,2,1,3
1424,173730,2021,Italy,Netherlands,1,1,3,5,13/06/2021,0,0,0,0,3,3,7,13,0,1,0,1,2,0,4,6,3,2,0,5
1425,173730,2021,Dominican Republic,Italy,0,0,4,4,12/06/2021,0,0,0,0,3,2,2,7,0,0,0,0,3,0,3,6,0,0,0,0
1426,173730,2021,Italy,USA,0,0,1,1,08/06/2021,0,0,2,2,0,1,0,1,0,0,0,0,0,0,5,5,0,2,0,2
1427,173730,2021,Germany,Italy,0,0,0,0,07/06/2021,0,0,0,0,0,0,0,0,0,0,0,0,0,0,0,0,0,0,0,0
1428,173730,2021,Italy,Korea,0,0,0,0,06/06/2021,0,0,0,0,0,0,0,0,0,0,0,0,0,0,0,0,0,0,0,0
1429,173730,2021,Brazil,Italy,0,0,1,1,02/06/2021,0,0,0,0,0,0,0,0,0,0,0,0,1,0,1,2,1,0,2,3
1430,173730,2021,Italy,Japan,0,0,0,0,01/06/2021,0,0,0,0,0,0,0,0,0,0,0,0,0,0,0,0,0,0,0,0
1431,173730,2021,Russia,Italy,0,0,4,4,31/05/2021,0,0,1,1,5,3,4,12,0,0,0,0,2,3,2,7,4,2,0,6
1432,173730,2021,Serbia,Italy,0,1,11,12,27/05/2021,0,1,0,1,3,7,15,25,1,0,0,1,9,2,29,40,9,2,1,12
1433,173730,2021,Türkiye,Italy,0,0,4,4,26/05/2021,0,0,2,2,2,0,3,5,1,1,0,2,6,0,9,15,4,0,0,4
1434,173730,2021,Italy,Poland,0,0,0,0,25/05/2021,0,0,0,0,0,0,0,0,0,0,0,0,0,0,0,0,0,0,0,0
1435,146401,2021,Japan,Türkiye,0,0,9,9,25/06/2021,0,0,3,3,8,6,14,28,0,2,1,3,1,0,5,6,9,2,0,11
1436,146401,2021,Brazil,Japan,2,2,13,17,24/06/2021,0,0,6,6,15,6,22,43,0,3,3,6,2,0,6,8,19,3,3,25
1437,146401,2021,Japan,Serbia,0,0,0,0,20/06/2021,0,0,0,0,0,0,0,0,0,0,0,0,0,0,0,0,0,0,0,0
1438,146401,2021,Japan,Germany,0,1,14,15,19/06/2021,0,1,1,2,12,6,17,35,1,3,2,6,0,0,2,2,14,4,2,20
1439,146401,2021,Japan,Dominican Republic,2,0,20,22,18/06/2021,0,0,6,6,16,3,24,43,1,2,1,4,1,0,1,2,27,1,1,29
1440,146401,2021,Belgium,Japan,0,1,20,21,14/06/2021,0,0,7,7,9,8,15,32,0,3,1,4,0,0,0,0,20,3,1,24
1441,146401,2021,USA,Japan,3,2,12,17,13/06/2021,0,0,1,1,12,4,14,30,0,2,3,5,0,0,2,2,14,5,0,19
1442,146401,2021,Japan,Türkiye,2,1,10,13,12/06/2021,0,0,4,4,11,7,12,30,2,2,5,9,0,0,1,1,10,6,1,17
1443,146401,2021,Japan,Poland,2,1,18,21,08/06/2021,1,0,2,3,19,7,22,48,0,4,2,6,0,0,0,0,13,5,2,20
1444,146401,2021,Canada,Japan,1,0,22,23,07/06/2021,0,0,1,1,12,3,5,20,0,2,2,4,0,0,0,0,15,3,0,18
1445,146401,2021,Japan,Netherlands,1,0,10,11,06/06/2021,0,0,2,2,18,2,16,36,0,1,1,2,0,0,1,1,9,3,2,14
1446,146401,2021,Japan,Russia,2,2,7,11,02/06/2021,0,1,2,3,9,5,12,26,0,1,1,2,0,0,1,1,2,3,0,5
1447,146401,2021,Italy,Japan,1,4,11,16,01/06/2021,0,0,0,0,14,6,19,39,0,0,0,0,10,0,11,21,11,4,1,16
1448,146401,2021,Brazil,Japan,0,1,7,8,31/05/2021,0,0,0,0,8,4,20,32,0,2,1,3,4,1,7,12,6,3,2,11
1449,146401,2021,Korea,Japan,0,1,9,10,27/05/2021,0,1,0,1,9,2,10,21,1,0,1,2,2,0,5,7,1,0,0,1
1450,146401,2021,China,Japan,1,2,6,9,26/05/2021,0,0,0,0,16,3,16,35,0,0,0,0,1,0,3,4,9,0,0,9
1451,146401,2021,Japan,Thailand,1,1,6,8,25/05/2021,0,0,0,0,9,0,15,24,3,5,2,10,0,0,0,0,9,1,1,11
1452,143437,2021,Japan,Türkiye,1,0,7,8,25/06/2021,0,0,2,2,10,5,11,26,0,1,0,1,7,2,8,17,4,2,0,6
1453,143437,2021,Brazil,Japan,2,0,15,17,24/06/2021,0,0,3,3,16,6,28,50,0,3,4,7,20,1,17,38,13,3,5,21
1454,143437,2021,Japan,Serbia,0,0,1,1,20/06/2021,0,0,0,0,0,0,0,0,0,0,0,0,0,0,0,0,0,0,0,0
1455,143437,2021,Japan,Germany,4,0,15,19,19/06/2021,0,0,2,2,11,2,19,32,1,3,3,7,4,2,15,21,9,2,1,12
1456,143437,2021,Japan,Dominican Republic,2,1,20,23,18/06/2021,0,0,3,3,19,6,32,57,2,4,3,9,20,0,14,34,13,9,2,24
1457,143437,2021,Belgium,Japan,0,1,11,12,14/06/2021,0,0,0,0,21,6,25,52,0,1,3,4,6,1,22,29,16,3,3,22
1458,143437,2021,Japan,Türkiye,0,1,11,12,12/06/2021,0,0,4,4,18,5,17,40,0,0,4,4,11,2,13,26,14,3,0,17
1459,143437,2021,Japan,Poland,0,2,16,18,08/06/2021,0,0,2,2,24,5,14,43,2,4,3,9,17,0,22,39,13,2,1,16
1460,143437,2021,Canada,Japan,0,0,9,9,07/06/2021,0,0,2,2,9,3,13,25,0,1,5,6,9,0,8,17,11,1,0,12
1461,143437,2021,Japan,Netherlands,0,2,9,11,06/06/2021,0,0,1,1,10,5,14,29,0,1,3,4,2,0,6,8,10,1,2,13
1462,143437,2021,Japan,Russia,3,2,12,17,02/06/2021,0,0,1,1,18,3,20,41,0,1,1,2,8,1,9,18,6,4,1,11
1463,143437,2021,Italy,Japan,1,1,21,23,01/06/2021,0,0,1,1,21,7,22,50,1,1,0,2,12,3,6,21,1,1,0,2
1464,143437,2021,Brazil,Japan,0,2,6,8,31/05/2021,0,0,4,4,12,3,18,33,1,5,2,8,5,0,9,14,6,0,0,6
1465,143437,2021,Korea,Japan,0,1,12,13,27/05/2021,0,0,0,0,18,5,11,34,2,0,0,2,14,3,9,26,0,0,0,0
1466,143437,2021,China,Japan,2,1,11,14,26/05/2021,0,0,0,0,11,5,11,27,0,0,1,1,11,0,9,20,10,1,0,11
1467,143437,2021,Japan,Thailand,2,1,11,14,25/05/2021,0,0,0,0,8,2,7,17,2,1,2,5,11,1,5,17,5,0,0,5
1468,141953,2021,Japan,Türkiye,0,1,7,8,25/06/2021,0,0,1,1,2,1,3,6,1,2,2,5,0,0,0,0,1,0,0,1
1469,141953,2021,Brazil,Japan,0,0,8,8,24/06/2021,0,0,2,2,7,3,8,18,1,4,8,13,0,0,0,0,4,0,2,6
1470,141953,2021,Japan,Germany,1,0,6,7,19/06/2021,0,0,1,1,12,1,9,22,0,3,3,6,1,0,1,2,4,1,0,5
1471,141953,2021,Japan,Dominican Republic,0,0,11,11,18/06/2021,0,0,2,2,9,1,12,22,4,6,15,25,0,0,0,0,9,1,0,10
1472,141953,2021,Belgium,Japan,0,0,0,0,14/06/2021,0,0,0,0,0,0,0,0,0,0,0,0,0,0,0,0,0,0,0,0
1473,141953,2021,USA,Japan,1,0,5,6,13/06/2021,0,0,2,2,5,0,7,12,0,6,5,11,1,0,1,2,4,0,1,5
1474,141953,2021,Japan,Türkiye,0,1,5,6,12/06/2021,0,0,0,0,6,2,7,15,2,3,5,10,0,0,1,1,6,0,1,7
1475,141953,2021,Japan,Poland,0,0,0,0,08/06/2021,0,0,0,0,0,0,0,0,0,0,0,0,0,0,0,0,0,0,0,0
1476,141953,2021,Canada,Japan,0,0,0,0,07/06/2021,0,0,0,0,0,0,0,0,0,0,0,0,0,0,0,0,0,0,0,0
1477,141953,2021,Italy,Japan,0,0,3,3,01/06/2021,0,0,1,1,1,1,2,4,0,4,0,4,0,1,0,1,1,0,0,1
1478,141953,2021,Brazil,Japan,1,0,6,7,31/05/2021,1,0,3,4,1,1,6,8,2,3,1,6,1,0,0,1,2,0,1,3
1479,141953,2021,Korea,Japan,0,1,7,8,27/05/2021,0,0,0,0,3,1,10,14,1,0,0,1,4,0,0,4,0,0,0,0
1480,141953,2021,China,Japan,0,1,15,16,26/05/2021,0,0,0,0,7,0,5,12,0,2,2,4,0,0,0,0,2,1,0,3
1481,141953,2021,Japan,Thailand,0,1,10,11,25/05/2021,0,0,0,0,9,0,8,17,2,5,6,13,0,0,0,0,1,0,0,1
1482,119385,2021,,,-,-,-,-,-,-,-,-,-,-,-,-,-,-,-,-,-,-,-,-,-,-,-,-,-
1483,112717,2021,Japan,Türkiye,0,0,10,10,25/06/2021,0,0,1,1,3,0,7,10,2,3,0,5,0,0,0,0,0,2,1,3
1484,112717,2021,Brazil,Japan,0,1,12,13,24/06/2021,0,0,2,2,5,1,4,10,1,8,3,12,0,0,0,0,1,0,0,1
1485,112717,2021,Japan,Serbia,0,0,0,0,20/06/2021,0,0,0,0,0,0,0,0,0,0,0,0,0,0,0,0,0,0,0,0
1486,112717,2021,Japan,Germany,0,0,0,0,19/06/2021,0,0,0,0,0,0,0,0,0,0,0,0,0,0,0,0,0,0,0,0
1487,112717,2021,Japan,Dominican Republic,1,2,15,18,18/06/2021,0,0,4,4,6,3,6,15,0,5,6,11,0,0,1,1,4,1,0,5
1488,112717,2021,Belgium,Japan,1,1,14,16,14/06/2021,0,0,0,0,6,1,7,14,2,8,9,19,0,0,1,1,4,0,0,4
1489,112717,2021,USA,Japan,0,0,0,0,13/06/2021,0,0,0,0,0,0,0,0,0,0,0,0,0,0,0,0,0,0,0,0
1490,112717,2021,Japan,Türkiye,1,0,16,17,12/06/2021,0,0,2,2,5,0,9,14,4,3,9,16,0,0,1,1,1,1,1,3
1491,112717,2021,Japan,Poland,0,1,19,20,08/06/2021,0,0,0,0,8,2,9,19,1,4,6,11,0,0,1,1,6,0,0,6
1492,112717,2021,Canada,Japan,0,0,0,0,07/06/2021,0,0,0,0,0,0,0,0,0,0,0,0,0,0,0,0,0,0,0,0
1493,112717,2021,Japan,Netherlands,1,0,13,14,06/06/2021,0,0,2,2,6,1,8,15,3,5,3,11,0,0,0,0,1,1,4,6
1494,112717,2021,Japan,Russia,1,1,12,14,02/06/2021,0,0,2,2,2,2,4,8,2,0,1,3,1,0,0,1,1,1,0,2
1495,112717,2021,Italy,Japan,3,0,18,21,01/06/2021,0,1,0,1,11,3,6,20,2,8,3,13,0,0,0,0,2,1,0,3
1496,112717,2021,Brazil,Japan,0,0,0,0,31/05/2021,0,0,0,0,0,0,0,0,0,0,0,0,0,0,0,0,0,0,0,0
1497,112717,2021,Korea,Japan,0,0,0,0,27/05/2021,0,0,0,0,0,0,0,0,0,0,0,0,0,0,0,0,0,0,0,0
1498,112717,2021,China,Japan,2,0,10,12,26/05/2021,0,0,1,1,3,1,7,11,1,4,1,6,0,0,0,0,1,0,0,1
1499,112717,2021,Japan,Thailand,2,2,7,11,25/05/2021,0,0,0,0,9,1,4,14,3,2,5,10,3,0,0,3,1,0,0,1
1500,135416,2021,Japan,Türkiye,0,1,2,3,25/06/2021,0,0,0,0,1,0,0,1,0,1,0,1,4,0,5,9,1,1,0,2
1501,135416,2021,Brazil,Japan,0,0,0,0,24/06/2021,0,0,0,0,0,0,0,0,0,0,0,0,0,0,0,0,0,0,0,0
1502,135416,2021,Japan,Serbia,0,1,8,9,20/06/2021,0,0,0,0,12,3,17,32,2,1,0,3,0,0,0,0,7,1,0,8
1503,135416,2021,Japan,Germany,0,0,1,1,19/06/2021,0,0,0,0,0,0,0,0,0,0,0,0,0,2,0,2,0,0,0,0
1504,135416,2021,Japan,Dominican Republic,0,0,0,0,18/06/2021,0,0,0,0,0,0,0,0,0,0,0,0,0,0,0,0,0,0,0,0
1505,135416,2021,Belgium,Japan,0,0,0,0,14/06/2021,0,0,0,0,0,0,0,0,0,0,0,0,0,0,0,0,0,0,0,0
1506,135416,2021,USA,Japan,0,0,12,12,13/06/2021,0,0,6,6,11,5,23,39,1,1,2,4,12,4,15,31,8,3,1,12
1507,135416,2021,Japan,Türkiye,0,0,5,5,12/06/2021,0,0,1,1,3,0,3,6,0,0,0,0,3,1,4,8,1,0,0,1
1508,135416,2021,Japan,Poland,0,0,0,0,08/06/2021,0,0,0,0,0,0,0,0,0,0,0,0,0,0,6,6,2,1,0,3
1509,135416,2021,Canada,Japan,0,0,0,0,07/06/2021,0,0,0,0,0,0,0,0,0,0,0,0,0,0,0,0,0,0,0,0
1510,135416,2021,Japan,Netherlands,0,0,1,1,06/06/2021,0,0,0,0,0,1,3,4,0,0,0,0,2,1,2,5,0,1,0,1
1511,135416,2021,Japan,Russia,0,0,0,0,02/06/2021,0,0,0,0,0,0,0,0,0,0,0,0,0,0,0,0,0,0,0,0
1512,135416,2021,Italy,Japan,0,0,0,0,01/06/2021,0,0,1,1,1,1,0,2,0,0,0,0,3,1,2,6,0,0,0,0
1513,135416,2021,Brazil,Japan,0,0,1,1,31/05/2021,0,0,0,0,0,0,0,0,0,0,0,0,1,0,1,2,0,0,0,0
1514,135416,2021,Korea,Japan,0,0,2,2,27/05/2021,0,0,0,0,0,0,0,0,0,0,0,0,0,0,0,0,0,0,0,0
1515,135416,2021,China,Japan,0,0,1,1,26/05/2021,0,0,0,0,0,0,0,0,0,0,0,0,0,0,0,0,0,0,0,0
1516,135416,2021,Japan,Thailand,0,0,2,2,25/05/2021,0,0,0,0,0,0,0,0,0,0,0,0,0,0,0,0,0,0,0,0
1517,162218,2021,Japan,Türkiye,0,1,6,7,25/06/2021,0,0,0,0,6,5,8,19,0,0,0,0,11,0,12,23,2,1,3,6
1518,162218,2021,Brazil,Japan,0,1,14,15,24/06/2021,0,0,5,5,17,8,17,42,1,2,1,4,17,0,21,38,9,4,0,13
1519,162218,2021,Japan,Serbia,0,0,0,0,20/06/2021,0,0,0,0,0,0,0,0,0,0,0,0,0,0,0,0,0,0,0,0
1520,162218,2021,Japan,Germany,0,0,10,10,19/06/2021,0,0,4,4,16,5,16,37,1,2,1,4,8,3,23,34,11,3,1,15
1521,162218,2021,Japan,Dominican Republic,0,1,11,12,18/06/2021,0,0,6,6,23,2,27,52,1,1,3,5,16,1,12,29,18,3,2,23
1522,162218,2021,Belgium,Japan,1,1,17,19,14/06/2021,0,0,0,0,11,7,19,37,0,0,1,1,12,1,21,34,16,4,2,22
1523,162218,2021,USA,Japan,0,1,2,3,13/06/2021,0,0,2,2,2,2,5,9,0,1,0,1,2,1,1,4,1,0,0,1
1524,162218,2021,Japan,Türkiye,2,1,16,19,12/06/2021,0,0,3,3,9,3,22,34,1,2,2,5,9,2,12,23,13,1,1,15
1525,162218,2021,Japan,Poland,1,3,14,18,08/06/2021,0,0,1,1,19,7,16,42,1,2,4,7,20,0,14,34,10,5,0,15
1526,162218,2021,Canada,Japan,5,0,13,18,07/06/2021,0,0,1,1,8,5,12,25,0,2,2,4,4,1,1,6,9,0,1,10
1527,162218,2021,Japan,Netherlands,0,1,7,8,06/06/2021,0,0,2,2,5,5,7,17,0,0,1,1,6,1,20,27,9,4,2,15
1528,162218,2021,Japan,Russia,1,0,12,13,02/06/2021,0,0,2,2,19,1,12,32,0,1,0,1,11,0,4,15,7,1,0,8
1529,162218,2021,Italy,Japan,1,0,12,13,01/06/2021,0,0,0,0,17,2,23,42,2,3,0,5,15,2,10,27,9,5,0,14
1530,162218,2021,Brazil,Japan,1,1,9,11,31/05/2021,0,0,1,1,10,7,6,23,0,1,1,2,17,2,11,30,8,1,0,9
1531,162218,2021,Korea,Japan,1,1,12,14,27/05/2021,0,0,0,0,17,3,16,36,0,0,1,1,7,0,2,9,2,0,1,3
1532,162218,2021,China,Japan,2,1,9,12,26/05/2021,0,0,2,2,15,3,10,28,1,0,0,1,13,0,6,19,8,1,0,9
1533,162218,2021,Japan,Thailand,0,0,11,11,25/05/2021,0,0,0,0,8,1,5,14,1,2,2,5,11,0,6,17,3,1,0,4
1534,143376,2021,Japan,Türkiye,0,0,2,2,25/06/2021,2,0,13,15,0,0,0,0,0,0,0,0,0,0,0,0,0,0,0,0
1535,143376,2021,Brazil,Japan,0,0,3,3,24/06/2021,2,0,3,5,0,0,0,0,0,0,0,0,0,0,0,0,1,1,0,2
1536,143376,2021,Japan,Germany,0,1,6,7,19/06/2021,0,0,8,8,0,0,0,0,0,0,0,0,0,0,0,0,0,0,0,0
1537,143376,2021,Japan,Dominican Republic,0,0,2,2,18/06/2021,0,0,0,0,0,0,0,0,0,0,0,0,0,0,0,0,0,0,0,0
1538,143376,2021,Belgium,Japan,0,0,3,3,14/06/2021,6,0,16,22,1,0,0,1,0,0,0,0,0,0,0,0,0,1,0,1
1539,143376,2021,USA,Japan,0,0,7,7,13/06/2021,10,1,76,87,1,0,2,3,0,3,0,3,0,0,0,0,14,2,2,18
1540,143376,2021,Japan,Türkiye,0,0,3,3,12/06/2021,0,0,11,11,0,0,0,0,0,0,0,0,0,0,0,0,2,1,0,3
1541,143376,2021,Japan,Netherlands,0,0,0,0,06/06/2021,0,0,0,0,0,0,0,0,0,0,0,0,0,0,0,0,0,0,0,0
1542,143376,2021,Japan,Russia,0,0,1,1,02/06/2021,0,0,6,6,0,0,0,0,0,0,0,0,0,0,0,0,0,0,0,0
1543,143376,2021,Italy,Japan,0,0,2,2,01/06/2021,1,0,19,20,0,0,1,1,1,0,0,1,0,0,0,0,1,0,0,1
1544,143376,2021,Brazil,Japan,0,0,0,0,31/05/2021,1,0,4,5,0,0,0,0,0,0,0,0,0,0,0,0,3,0,0,3
1545,143376,2021,Korea,Japan,0,0,1,1,27/05/2021,1,0,12,13,0,0,0,0,0,0,0,0,0,0,0,0,0,0,0,0
1546,143376,2021,China,Japan,0,0,0,0,26/05/2021,0,0,0,0,0,0,0,0,0,0,0,0,0,0,0,0,0,0,0,0
1547,143376,2021,Japan,Thailand,0,0,3,3,25/05/2021,1,0,14,15,0,0,0,0,0,0,0,0,0,0,0,0,2,0,1,3
1548,119378,2021,Japan,Serbia,1,1,9,11,20/06/2021,0,0,0,0,4,2,4,10,2,1,1,4,1,0,0,1,2,2,0,4
1549,119378,2021,USA,Japan,0,1,1,2,13/06/2021,0,0,0,0,0,0,1,1,0,0,0,0,0,0,0,0,0,0,0,0
1550,119378,2021,Japan,Türkiye,0,0,0,0,12/06/2021,0,0,0,0,0,0,0,0,0,0,0,0,0,0,0,0,0,0,0,0
1551,119378,2021,Japan,Poland,0,0,0,0,08/06/2021,0,0,0,0,0,0,0,0,0,0,0,0,0,0,0,0,0,0,0,0
1552,119378,2021,Canada,Japan,0,1,2,3,07/06/2021,0,0,0,0,2,0,4,6,0,0,0,0,0,0,0,0,3,0,0,3
1553,119378,2021,Japan,Netherlands,0,0,0,0,06/06/2021,0,0,0,0,0,0,0,0,0,0,0,0,0,0,0,0,0,0,0,0
1554,119378,2021,Japan,Russia,0,0,0,0,02/06/2021,0,0,0,0,0,0,0,0,0,0,0,0,0,0,0,0,0,0,0,0
1555,119378,2021,Italy,Japan,0,0,0,0,01/06/2021,0,0,0,0,0,0,0,0,0,0,0,0,0,0,0,0,0,0,0,0
1556,119378,2021,Brazil,Japan,0,0,0,0,31/05/2021,0,0,0,0,0,0,0,0,0,0,0,0,0,0,0,0,0,0,0,0
1557,141956,2021,Japan,Türkiye,0,0,1,1,25/06/2021,0,0,1,1,0,0,0,0,0,0,0,0,0,0,0,0,0,0,0,0
1558,141956,2021,Brazil,Japan,0,0,3,3,24/06/2021,0,0,0,0,0,0,0,0,0,0,0,0,0,0,0,0,0,0,0,0
1559,141956,2021,Japan,Serbia,2,2,13,17,20/06/2021,0,0,0,0,8,3,8,19,1,0,0,1,8,1,9,18,7,2,0,9
1560,141956,2021,Japan,Germany,0,0,0,0,19/06/2021,0,0,0,0,0,0,0,0,0,0,0,0,0,0,0,0,0,0,0,0
1561,141956,2021,Japan,Dominican Republic,0,0,3,3,18/06/2021,0,0,0,0,0,0,0,0,0,0,0,0,0,0,0,0,0,1,0,1
1562,141956,2021,Belgium,Japan,0,1,1,2,14/06/2021,0,0,0,0,0,0,0,0,0,0,0,0,0,0,0,0,0,0,0,0
1563,141956,2021,USA,Japan,0,0,3,3,13/06/2021,0,0,1,1,2,1,2,5,0,0,0,0,1,0,1,2,0,1,1,2
1564,141956,2021,Japan,Türkiye,0,0,5,5,12/06/2021,0,0,0,0,0,0,0,0,0,0,0,0,0,0,0,0,1,0,0,1
1565,141956,2021,Japan,Poland,1,0,5,6,08/06/2021,0,0,0,0,0,0,0,0,0,0,0,0,0,0,0,0,0,2,1,3
1566,141956,2021,Canada,Japan,0,0,3,3,07/06/2021,0,0,0,0,1,0,0,1,0,0,0,0,0,0,0,0,0,0,0,0
1567,141956,2021,Japan,Netherlands,0,0,0,0,06/06/2021,0,0,0,0,0,0,0,0,0,0,0,0,0,0,0,0,0,0,0,0
1568,141956,2021,Japan,Russia,0,0,0,0,02/06/2021,0,0,0,0,0,0,0,0,0,0,0,0,0,0,0,0,0,0,0,0
1569,141956,2021,Italy,Japan,0,0,1,1,01/06/2021,0,0,0,0,0,0,0,0,0,0,0,0,0,0,0,0,0,0,0,0
1570,138802,2021,Japan,Türkiye,0,0,0,0,25/06/2021,0,0,0,0,0,0,0,0,0,0,0,0,0,0,0,0,0,0,0,0
1571,138802,2021,Brazil,Japan,0,0,0,0,24/06/2021,0,0,0,0,0,0,0,0,0,0,0,0,0,0,0,0,0,0,0,0
1572,138802,2021,Japan,Serbia,2,0,13,15,20/06/2021,0,0,2,2,3,1,1,5,1,2,2,5,0,0,1,1,1,2,0,3
1573,138802,2021,Japan,Germany,0,0,0,0,19/06/2021,0,0,0,0,0,0,0,0,0,0,0,0,0,0,0,0,0,0,0,0
1574,138802,2021,Japan,Dominican Republic,0,0,0,0,18/06/2021,0,0,0,0,0,0,0,0,0,0,0,0,0,0,0,0,0,0,0,0
1575,138802,2021,Belgium,Japan,0,0,0,0,14/06/2021,0,0,0,0,0,0,0,0,0,0,0,0,0,0,0,0,0,0,0,0
1576,138802,2021,USA,Japan,0,0,10,10,13/06/2021,0,0,1,1,0,0,6,6,0,3,5,8,0,0,2,2,8,1,0,9
1577,138802,2021,Japan,Türkiye,0,0,0,0,12/06/2021,0,0,0,0,0,0,0,0,0,0,0,0,0,0,0,0,0,0,0,0
1578,138802,2021,Japan,Netherlands,0,0,0,0,06/06/2021,0,0,0,0,0,0,0,0,0,0,0,0,0,0,0,0,0,0,0,0
1579,138802,2021,Japan,Russia,0,0,0,0,02/06/2021,0,0,0,0,0,0,0,0,0,0,0,0,0,0,0,0,0,0,0,0
1580,138802,2021,Italy,Japan,0,0,7,7,01/06/2021,0,0,0,0,1,0,5,6,0,5,3,8,0,0,0,0,0,2,0,2
1581,138802,2021,Brazil,Japan,0,0,12,12,31/05/2021,0,0,2,2,2,1,9,12,2,4,0,6,0,0,1,1,1,0,2,3
1582,138802,2021,Korea,Japan,2,1,13,16,27/05/2021,0,0,0,0,5,1,4,10,3,0,0,3,0,0,1,1,0,0,0,0
1583,138802,2021,China,Japan,0,0,0,0,26/05/2021,0,0,0,0,0,0,0,0,0,0,0,0,0,0,0,0,0,0,0,0
1584,138802,2021,Japan,Thailand,0,0,0,0,25/05/2021,0,0,0,0,0,0,0,0,0,0,0,0,0,0,0,0,0,0,0,0
1585,162767,2021,Japan,Türkiye,0,0,0,0,25/06/2021,0,0,6,6,0,0,0,0,0,0,0,0,7,0,3,10,6,3,2,11
1586,162767,2021,Brazil,Japan,0,0,0,0,24/06/2021,0,0,9,9,0,0,0,0,0,0,0,0,7,2,6,15,15,2,2,19
1587,162767,2021,Japan,Serbia,0,0,0,0,20/06/2021,0,0,2,2,0,0,0,0,0,0,0,0,0,0,0,0,6,1,0,7
1588,162767,2021,Japan,Germany,0,0,0,0,19/06/2021,0,0,6,6,0,0,0,0,0,0,0,0,5,0,7,12,4,2,0,6
1589,162767,2021,Japan,Dominican Republic,0,0,0,0,18/06/2021,0,0,8,8,0,0,0,0,0,0,0,0,13,0,10,23,6,2,0,8
1590,162767,2021,Belgium,Japan,0,0,0,0,14/06/2021,0,0,17,17,0,0,0,0,0,0,0,0,4,0,6,10,15,1,2,18
1591,162767,2021,USA,Japan,0,0,0,0,13/06/2021,0,0,0,0,0,0,0,0,0,0,0,0,0,0,0,0,0,0,0,0
1592,162767,2021,Japan,Türkiye,0,0,0,0,12/06/2021,0,0,18,18,0,0,0,0,0,0,0,0,2,0,6,8,19,3,2,24
1593,162767,2021,Japan,Poland,0,0,0,0,08/06/2021,0,0,7,7,0,0,0,0,0,0,0,0,8,0,6,14,10,3,0,13
1594,162767,2021,Canada,Japan,0,0,0,0,07/06/2021,0,0,4,4,0,0,0,0,0,0,0,0,6,1,7,14,14,1,3,18
1595,162767,2021,Japan,Netherlands,0,0,0,0,06/06/2021,0,0,3,3,0,0,0,0,0,0,0,0,4,1,8,13,13,2,0,15
1596,162767,2021,Japan,Russia,0,0,0,0,02/06/2021,0,0,1,1,0,0,0,0,0,0,0,0,0,0,0,0,0,0,0,0
1597,162767,2021,Italy,Japan,0,0,0,0,01/06/2021,0,0,5,5,0,0,0,0,0,0,0,0,18,0,5,23,9,10,1,20
1598,162767,2021,Brazil,Japan,0,0,0,0,31/05/2021,0,0,7,7,0,0,0,0,0,0,0,0,1,0,3,4,8,1,1,10
1599,162767,2021,Korea,Japan,0,0,0,0,27/05/2021,0,0,5,5,0,0,0,0,0,0,0,0,7,0,1,8,6,0,0,6
1600,162767,2021,China,Japan,0,0,0,0,26/05/2021,1,0,5,6,0,0,0,0,0,0,0,0,2,0,1,3,14,5,0,19
1601,162767,2021,Japan,Thailand,0,0,0,0,25/05/2021,0,0,1,1,0,0,0,0,0,0,0,0,1,1,4,6,16,0,1,17
1602,124327,2021,Japan,Türkiye,0,0,0,0,25/06/2021,0,0,0,0,0,0,0,0,0,0,0,0,0,0,0,0,0,0,0,0
1603,124327,2021,Brazil,Japan,0,0,0,0,24/06/2021,0,0,0,0,0,0,0,0,0,0,0,0,0,0,0,0,0,0,0,0
1604,124327,2021,Japan,Serbia,0,0,0,0,20/06/2021,0,0,6,6,0,0,0,0,0,0,0,0,6,0,4,10,4,0,0,4
1605,124327,2021,Japan,Germany,0,0,0,0,19/06/2021,0,0,6,6,0,0,0,0,0,0,0,0,0,0,0,0,16,2,5,23
1606,124327,2021,Japan,Dominican Republic,0,0,0,0,18/06/2021,0,0,3,3,0,0,0,0,0,0,0,0,0,0,0,0,10,4,3,17
1607,124327,2021,Belgium,Japan,0,0,0,0,14/06/2021,0,0,0,0,0,0,0,0,0,0,0,0,0,0,0,0,0,0,0,0
1608,124327,2021,USA,Japan,0,0,0,0,13/06/2021,0,0,14,14,0,0,0,0,0,0,0,0,1,0,5,6,10,5,1,16
1609,124327,2021,Japan,Türkiye,0,0,0,0,12/06/2021,0,0,0,0,0,0,0,0,0,0,0,0,0,0,0,0,0,0,0,0
1610,124327,2021,Japan,Poland,0,0,0,0,08/06/2021,0,0,0,0,0,0,0,0,0,0,0,0,0,0,0,0,4,2,0,6
1611,124327,2021,Canada,Japan,0,0,0,0,07/06/2021,0,0,0,0,0,0,0,0,0,0,0,0,0,0,0,0,0,0,0,0
1612,124327,2021,Japan,Netherlands,0,0,0,0,06/06/2021,0,0,5,5,0,0,0,0,0,0,0,0,3,0,3,6,3,1,0,4
1613,124327,2021,Japan,Russia,0,0,0,0,02/06/2021,0,0,7,7,0,0,0,0,0,0,0,0,10,1,8,19,13,5,2,20
1614,124327,2021,Italy,Japan,0,0,0,0,01/06/2021,0,0,0,0,0,0,0,0,0,0,0,0,0,0,0,0,0,0,0,0
1615,124327,2021,Brazil,Japan,0,0,0,0,31/05/2021,0,0,5,5,0,0,0,0,0,0,0,0,0,0,1,1,1,3,0,4
1616,124327,2021,Korea,Japan,0,0,0,0,27/05/2021,0,0,0,0,0,0,0,0,0,0,0,0,0,0,0,0,0,0,0,0
1617,124327,2021,China,Japan,0,0,0,0,26/05/2021,0,0,0,0,0,0,0,0,0,0,0,0,0,0,0,0,0,0,0,0
1618,124327,2021,Japan,Thailand,0,0,0,0,25/05/2021,0,0,0,0,0,0,0,0,0,0,0,0,0,0,0,0,0,0,0,0
1619,162227,2021,Japan,Türkiye,0,0,0,0,25/06/2021,0,0,0,0,0,0,0,0,0,0,0,0,0,0,0,0,0,0,0,0
1620,162227,2021,Brazil,Japan,0,0,0,0,24/06/2021,0,0,0,0,0,0,0,0,0,0,0,0,0,0,0,0,0,0,0,0
1621,162227,2021,Japan,Serbia,0,0,0,0,20/06/2021,0,0,0,0,0,0,0,0,0,0,0,0,0,0,0,0,0,0,0,0
1622,162227,2021,Japan,Germany,1,0,16,17,19/06/2021,0,0,1,1,5,2,3,10,0,6,2,8,0,0,2,2,4,1,2,7
1623,162227,2021,Japan,Dominican Republic,0,0,0,0,18/06/2021,0,0,0,0,0,0,0,0,0,0,0,0,0,0,0,0,0,0,0,0
1624,162227,2021,Belgium,Japan,0,1,10,11,14/06/2021,0,0,1,1,12,0,7,19,0,5,7,12,0,0,0,0,4,2,1,7
1625,162227,2021,USA,Japan,0,0,0,0,13/06/2021,0,0,0,0,0,0,0,0,0,0,0,0,0,0,0,0,0,0,0,0
1626,162227,2021,Japan,Türkiye,0,0,0,0,12/06/2021,0,0,0,0,0,0,0,0,0,0,0,0,0,0,0,0,0,0,0,0
1627,162227,2021,Japan,Poland,1,0,12,13,08/06/2021,0,0,0,0,3,4,4,11,3,5,2,10,0,0,2,2,3,0,2,5
1628,162227,2021,Canada,Japan,0,1,8,9,07/06/2021,0,0,0,0,9,3,7,19,1,1,1,3,0,0,0,0,7,0,0,7
1629,162227,2021,Japan,Netherlands,0,0,8,8,06/06/2021,0,0,0,0,3,3,7,13,1,5,5,11,0,0,0,0,2,2,1,5
1630,162227,2021,Japan,Russia,0,0,7,7,02/06/2021,0,0,0,0,5,2,8,15,1,0,1,2,1,0,1,2,1,3,0,4
1631,162227,2021,Korea,Japan,0,0,0,0,27/05/2021,0,0,0,0,0,0,0,0,0,0,0,0,0,0,0,0,0,0,0,0
1632,162227,2021,China,Japan,0,0,0,0,26/05/2021,0,0,0,0,0,0,0,0,0,0,0,0,0,0,0,0,0,0,0,0
1633,162227,2021,Japan,Thailand,0,0,0,0,25/05/2021,0,0,0,0,0,0,0,0,0,0,0,0,0,0,0,0,0,0,0,0
1634,151944,2021,Japan,Serbia,1,1,5,7,20/06/2021,2,1,83,86,2,0,0,2,1,1,0,2,0,0,1,1,5,0,1,6
1635,151944,2021,USA,Japan,0,0,2,2,13/06/2021,1,0,9,10,0,0,0,0,0,0,0,0,0,0,0,0,2,1,0,3
1636,151944,2021,Japan,Poland,0,1,0,1,08/06/2021,0,0,0,0,0,0,0,0,0,0,0,0,0,0,0,0,0,0,0,0
1637,151944,2021,Canada,Japan,0,0,4,4,07/06/2021,3,0,3,6,0,0,0,0,0,0,0,0,0,0,0,0,0,1,0,1
1638,151944,2021,Brazil,Japan,0,0,1,1,31/05/2021,1,0,1,2,0,0,2,2,0,1,0,1,1,0,0,1,2,0,0,2
1639,151944,2021,Korea,Japan,0,0,0,0,27/05/2021,0,0,0,0,0,0,0,0,0,0,0,0,0,0,0,0,0,0,0,0
1640,151944,2021,China,Japan,0,0,0,0,26/05/2021,0,0,0,0,0,0,0,0,0,0,0,0,0,0,0,0,0,0,0,0
1641,151944,2021,Japan,Thailand,0,0,0,0,25/05/2021,0,0,0,0,0,0,0,0,0,0,0,0,0,0,0,0,0,0,0,0
1642,151953,2021,Japan,Türkiye,0,1,0,1,25/06/2021,0,0,0,0,0,0,0,0,0,0,0,0,1,0,0,1,0,0,0,0
1643,151953,2021,Brazil,Japan,0,0,3,3,24/06/2021,0,0,0,0,0,0,0,0,0,0,0,0,0,0,0,0,0,0,0,0
1644,151953,2021,Japan,Serbia,1,2,10,13,20/06/2021,0,0,1,1,12,6,12,30,0,0,1,1,6,1,6,13,6,1,0,7
1645,151953,2021,Japan,Germany,0,0,8,8,19/06/2021,0,0,0,0,0,0,0,0,0,0,0,0,0,0,0,0,1,0,0,1
1646,151953,2021,Japan,Dominican Republic,1,0,6,7,18/06/2021,0,0,1,1,0,0,0,0,0,0,0,0,0,0,0,0,0,0,1,1
1647,151953,2021,Belgium,Japan,0,0,0,0,14/06/2021,0,0,0,0,0,0,0,0,0,0,0,0,0,1,0,1,0,0,0,0
1648,151953,2021,USA,Japan,0,1,6,7,13/06/2021,0,0,3,3,8,3,12,23,0,1,1,2,2,0,9,11,10,3,0,13
1649,151953,2021,Japan,Poland,0,0,0,0,08/06/2021,0,0,0,0,0,0,0,0,0,0,0,0,0,0,0,0,0,0,0,0
1650,151953,2021,Canada,Japan,0,0,2,2,07/06/2021,0,0,0,0,0,0,0,0,0,0,0,0,0,0,0,0,0,0,0,0
1651,151953,2021,Japan,Netherlands,0,0,1,1,06/06/2021,0,0,1,1,0,0,0,0,0,0,0,0,0,1,4,5,1,0,0,1
1652,151953,2021,Japan,Russia,0,0,0,0,02/06/2021,0,0,0,0,0,0,0,0,0,0,1,1,0,0,2,2,0,0,0,0
1653,151953,2021,Italy,Japan,0,1,2,3,01/06/2021,0,0,0,0,0,0,1,1,0,0,0,0,0,0,0,0,0,1,0,1
1654,151953,2021,Brazil,Japan,0,0,0,0,31/05/2021,0,0,0,0,1,0,0,1,0,0,1,1,3,0,1,4,0,0,0,0
1655,151953,2021,Korea,Japan,0,0,0,0,27/05/2021,0,0,0,0,0,0,0,0,0,0,0,0,1,0,1,2,0,0,0,0
1656,151953,2021,China,Japan,0,0,1,1,26/05/2021,0,0,0,0,0,0,0,0,0,0,0,0,0,0,0,0,0,0,0,0
1657,151953,2021,Japan,Thailand,0,0,0,0,25/05/2021,0,0,0,0,1,0,5,6,1,0,0,1,0,0,0,0,0,0,1,1
1658,181033,2021,Japan,Türkiye,0,1,3,4,25/06/2021,10,1,53,64,0,0,1,1,0,1,2,3,0,0,0,0,3,5,0,8
1659,181033,2021,Brazil,Japan,0,0,7,7,24/06/2021,38,2,93,133,2,1,1,4,2,6,3,11,0,0,0,0,13,3,0,16
1660,181033,2021,Japan,Serbia,0,0,0,0,20/06/2021,0,0,0,0,0,0,0,0,0,0,0,0,0,0,0,0,0,0,0,0
1661,181033,2021,Japan,Germany,0,1,9,10,19/06/2021,14,2,86,102,1,0,2,3,0,3,2,5,0,0,0,0,12,5,1,18
1662,181033,2021,Japan,Dominican Republic,0,1,8,9,18/06/2021,70,1,87,158,0,0,4,4,2,6,2,10,0,0,0,0,16,2,0,18
1663,181033,2021,Belgium,Japan,0,2,11,13,14/06/2021,33,1,70,104,0,0,1,1,1,4,3,8,0,0,0,0,9,4,3,16
1664,181033,2021,Japan,Türkiye,0,2,9,11,12/06/2021,18,0,77,95,0,1,2,3,2,5,2,9,0,0,0,0,12,1,2,15
1665,181033,2021,Japan,Poland,0,1,11,12,08/06/2021,57,0,94,151,0,0,0,0,0,3,3,6,0,0,0,0,5,7,1,13
1666,181033,2021,Canada,Japan,0,1,2,3,07/06/2021,13,1,70,84,0,0,2,2,3,2,2,7,0,0,0,0,4,0,0,4
1667,181033,2021,Japan,Netherlands,0,0,12,12,06/06/2021,35,2,61,98,0,0,2,2,0,1,1,2,0,0,0,0,7,1,1,9
1668,181033,2021,Japan,Russia,0,1,10,11,02/06/2021,14,0,86,100,0,0,0,0,0,0,2,2,0,0,0,0,4,2,0,6
1669,181033,2021,Italy,Japan,0,1,13,14,01/06/2021,8,0,127,135,2,2,3,7,0,2,1,3,0,0,0,0,0,4,0,4
1670,181033,2021,Brazil,Japan,0,1,8,9,31/05/2021,18,0,67,85,0,1,1,2,0,2,0,2,0,0,0,0,9,1,1,11
1671,181033,2021,Korea,Japan,1,1,10,12,27/05/2021,4,0,91,95,0,0,1,1,0,1,1,2,0,0,1,1,0,0,0,0
1672,181033,2021,China,Japan,0,1,8,9,26/05/2021,43,1,61,105,1,0,3,4,1,2,0,3,0,0,0,0,6,1,0,7
1673,181033,2021,Japan,Thailand,0,2,12,14,25/05/2021,21,1,52,74,0,0,0,0,0,1,1,2,0,0,0,0,1,2,3,6
1674,135943,2021,Korea,Netherlands,1,3,12,16,20/06/2021,0,0,1,1,16,8,17,41,1,2,1,4,4,2,14,20,10,0,5,15
1675,135943,2021,Korea,Türkiye,0,0,9,9,19/06/2021,0,0,3,3,9,2,11,22,0,2,1,3,3,1,8,12,6,1,0,7
1676,135943,2021,Korea,Brazil,0,0,2,2,18/06/2021,0,0,1,1,2,2,5,9,0,1,0,1,7,0,11,18,3,1,1,5
1677,135943,2021,Korea,Canada,0,1,0,1,14/06/2021,0,0,0,0,2,2,5,9,0,0,2,2,0,0,8,8,6,0,0,6
1678,135943,2021,Korea,Serbia,0,1,2,3,13/06/2021,0,0,2,2,6,0,5,11,0,0,0,0,1,0,6,7,3,0,1,4
1679,135943,2021,Russia,Korea,0,0,6,6,12/06/2021,0,0,1,1,0,2,6,8,0,2,1,3,1,1,9,11,4,0,1,5
1680,135943,2021,Germany,Korea,1,1,5,7,08/06/2021,0,0,3,3,2,4,8,14,0,0,0,0,5,2,14,21,5,1,1,7
1681,135943,2021,Korea,USA,0,0,0,0,07/06/2021,0,0,0,0,0,0,0,0,0,0,0,0,0,0,0,0,0,0,0,0
1682,135943,2021,Italy,Korea,4,4,6,14,06/06/2021,0,0,1,1,14,10,20,44,2,2,1,5,9,4,21,34,10,2,5,17
1683,135943,2021,Belgium,Korea,0,3,14,17,02/06/2021,0,0,3,3,23,4,17,44,0,6,2,8,9,2,29,40,18,3,4,25
1684,135943,2021,Dominican Republic,Korea,0,1,7,8,01/06/2021,0,0,1,1,3,2,7,12,0,1,0,1,4,1,12,17,5,0,0,5
1685,135943,2021,Korea,Poland,1,0,6,7,31/05/2021,0,0,0,0,3,4,4,11,0,2,0,2,4,0,10,14,3,0,1,4
1686,135943,2021,Korea,Japan,1,1,7,9,27/05/2021,0,0,0,0,8,5,9,22,1,1,0,2,8,2,15,25,1,0,0,1
1687,135943,2021,Thailand,Korea,1,0,19,20,26/05/2021,0,0,1,1,12,1,11,24,1,2,5,8,17,5,14,36,14,1,1,16
1688,135943,2021,China,Korea,2,2,12,16,25/05/2021,0,0,1,1,14,5,22,41,0,0,3,3,12,3,16,31,10,2,0,12
1689,163822,2021,Korea,Netherlands,0,0,0,0,20/06/2021,0,0,0,0,1,0,0,1,0,0,0,0,0,0,0,0,0,0,0,0
1690,163822,2021,Korea,Türkiye,0,0,2,2,19/06/2021,0,0,1,1,2,0,1,3,1,0,0,1,0,0,0,0,0,0,0,0
1691,163822,2021,Korea,Brazil,0,0,6,6,18/06/2021,0,0,0,0,4,2,3,9,1,5,2,8,0,0,0,0,2,0,0,2
1692,163822,2021,Korea,Canada,0,0,0,0,14/06/2021,0,0,0,0,0,0,0,0,0,0,0,0,0,0,0,0,0,0,0,0
1693,163822,2021,Korea,Serbia,0,2,8,10,13/06/2021,0,0,0,0,4,2,7,13,3,5,8,16,0,0,1,1,3,1,0,4
1694,163822,2021,Russia,Korea,0,0,1,1,12/06/2021,0,0,0,0,0,1,3,4,1,4,2,7,0,1,0,1,2,0,1,3
1695,163822,2021,Korea,USA,0,1,5,6,07/06/2021,0,0,2,2,1,0,6,7,1,2,1,4,0,0,0,0,3,0,0,3
1696,163822,2021,Italy,Korea,0,0,5,5,06/06/2021,0,0,1,1,0,1,1,2,1,1,3,5,0,1,0,1,0,0,0,0
1697,163822,2021,Belgium,Korea,0,0,0,0,02/06/2021,0,0,0,0,0,0,0,0,0,0,0,0,0,0,0,0,0,0,0,0
1698,163822,2021,Dominican Republic,Korea,0,0,0,0,01/06/2021,0,0,0,0,0,0,0,0,0,0,0,0,0,0,0,0,0,0,0,0
1699,163822,2021,Korea,Poland,0,1,5,6,31/05/2021,0,0,1,1,5,1,1,7,2,3,2,7,0,0,0,0,0,1,1,2
1700,163822,2021,Korea,Japan,0,0,0,0,27/05/2021,0,0,0,0,0,0,0,0,0,0,0,0,0,0,0,0,0,0,0,0
1701,163822,2021,Thailand,Korea,0,0,7,7,26/05/2021,0,0,1,1,7,0,2,9,3,3,5,11,0,0,0,0,6,0,0,6
1702,163822,2021,China,Korea,0,0,0,0,25/05/2021,0,0,0,0,0,0,0,0,0,0,0,0,0,0,0,0,0,0,0,0
1703,120148,2021,Korea,Netherlands,0,2,10,12,20/06/2021,9,1,68,78,0,0,1,1,0,1,0,1,0,0,1,1,4,1,4,9
1704,120148,2021,Korea,Türkiye,3,3,11,17,19/06/2021,5,0,89,94,1,0,0,1,0,0,0,0,0,0,1,1,4,7,0,11
1705,120148,2021,Korea,Brazil,2,1,9,12,18/06/2021,31,2,47,80,0,0,0,0,0,0,0,0,0,0,0,0,5,2,3,10
1706,120148,2021,Korea,Canada,0,3,12,15,14/06/2021,17,0,90,107,2,0,0,2,0,2,2,4,0,0,0,0,10,5,2,17
1707,120148,2021,Russia,Korea,1,0,2,3,12/06/2021,1,1,26,28,0,0,0,0,0,1,0,1,0,0,0,0,0,1,1,2
1708,120148,2021,Germany,Korea,0,1,5,6,08/06/2021,1,1,42,44,0,0,1,1,0,1,0,1,0,0,1,1,7,2,0,9
1709,120148,2021,Korea,USA,2,0,3,5,07/06/2021,2,1,15,18,0,0,0,0,0,0,0,0,0,0,0,0,3,2,1,6
1710,120148,2021,Italy,Korea,0,1,11,12,06/06/2021,7,1,53,61,1,0,3,4,0,1,1,2,0,0,0,0,4,2,0,6
1711,120148,2021,Belgium,Korea,0,2,11,13,02/06/2021,7,0,70,77,0,0,1,1,0,0,0,0,0,0,0,0,7,1,0,8
1712,120148,2021,Dominican Republic,Korea,3,2,10,15,01/06/2021,6,0,52,58,1,0,0,1,0,1,2,3,0,0,1,1,8,1,2,11
1713,120148,2021,Korea,Poland,0,2,8,10,31/05/2021,14,0,63,77,0,0,0,0,0,1,1,2,0,0,0,0,8,2,0,10
1714,120148,2021,Korea,Japan,0,0,5,5,27/05/2021,1,1,56,58,0,0,1,1,0,0,0,0,0,0,0,0,0,0,0,0
1715,120148,2021,Thailand,Korea,0,0,4,4,26/05/2021,5,0,9,14,0,0,0,0,0,0,0,0,0,0,0,0,2,1,0,3
1716,181150,2021,Korea,Netherlands,0,0,0,0,20/06/2021,0,0,0,0,0,0,0,0,0,0,0,0,0,0,0,0,0,0,0,0
1717,181150,2021,Korea,Türkiye,0,0,0,0,19/06/2021,0,0,1,1,0,0,0,0,0,0,0,0,3,0,9,12,4,2,0,6
1718,181150,2021,Korea,Brazil,0,0,0,0,18/06/2021,0,0,0,0,0,0,0,0,0,0,0,0,0,0,0,0,0,0,0,0
1719,181150,2021,Korea,Canada,0,0,0,0,14/06/2021,0,0,0,0,0,0,0,0,0,0,0,0,0,0,1,1,0,0,0,0
1720,181150,2021,Korea,Serbia,0,0,0,0,13/06/2021,0,0,0,0,0,0,0,0,0,0,0,0,0,0,0,0,0,0,0,0
1721,181150,2021,Russia,Korea,0,0,0,0,12/06/2021,0,0,0,0,0,0,0,0,0,0,0,0,0,0,0,0,0,0,0,0
1722,181150,2021,Germany,Korea,0,0,0,0,08/06/2021,0,0,0,0,0,0,0,0,0,0,0,0,0,0,2,2,0,0,0,0
1723,181150,2021,Korea,USA,0,0,0,0,07/06/2021,0,0,9,9,0,0,0,0,0,0,0,0,2,1,7,10,10,2,1,13
1724,181150,2021,Italy,Korea,0,0,0,0,06/06/2021,0,0,1,1,0,0,0,0,0,0,0,0,5,0,3,8,6,1,0,7
1725,181150,2021,Belgium,Korea,0,0,0,0,02/06/2021,0,0,0,0,0,0,0,0,0,0,0,0,0,0,0,0,0,0,0,0
1726,181150,2021,Dominican Republic,Korea,0,0,0,0,01/06/2021,0,0,1,1,0,0,0,0,0,0,0,0,0,0,0,0,0,0,0,0
1727,181150,2021,Korea,Poland,0,0,0,0,31/05/2021,0,0,2,2,0,0,0,0,0,0,0,0,3,0,11,14,12,2,1,15
1728,181150,2021,Korea,Japan,0,0,0,0,27/05/2021,0,0,0,0,0,0,0,0,0,0,0,0,0,0,0,0,0,0,0,0
1729,181150,2021,Thailand,Korea,0,0,0,0,26/05/2021,0,0,0,0,0,0,0,0,0,0,0,0,0,0,0,0,0,0,0,0
1730,181150,2021,China,Korea,0,0,0,0,25/05/2021,0,0,0,0,0,0,0,0,0,0,0,0,0,0,0,0,0,0,0,0
1731,181159,2021,Korea,Netherlands,0,2,4,6,20/06/2021,7,0,54,61,0,0,0,0,1,2,1,4,0,0,1,1,11,0,1,12
1732,181159,2021,Korea,Türkiye,0,0,1,1,19/06/2021,2,0,6,8,0,0,0,0,0,0,0,0,0,0,0,0,0,0,0,0
1733,181159,2021,Korea,Brazil,0,0,0,0,18/06/2021,2,0,10,12,0,0,0,0,0,0,0,0,0,0,0,0,1,1,0,2
1734,181159,2021,Korea,Canada,0,0,3,3,14/06/2021,0,1,13,14,0,0,0,0,0,0,0,0,0,0,1,1,3,0,1,4
1735,181159,2021,Korea,Serbia,0,1,6,7,13/06/2021,6,1,61,68,1,0,1,2,1,1,6,8,0,1,0,1,5,0,0,5
1736,181159,2021,Germany,Korea,0,0,0,0,08/06/2021,0,0,0,0,0,0,0,0,0,0,0,0,0,0,0,0,0,0,0,0
1737,181159,2021,Korea,USA,1,2,4,7,07/06/2021,7,0,54,61,0,0,1,1,0,0,0,0,0,0,0,0,5,2,0,7
1738,181159,2021,Italy,Korea,0,1,9,10,06/06/2021,4,0,55,59,0,0,0,0,0,4,1,5,0,0,0,0,3,0,0,3
1739,181159,2021,Belgium,Korea,0,0,12,12,02/06/2021,7,1,55,63,0,1,1,2,0,0,0,0,0,0,0,0,8,1,0,9
1740,181159,2021,Dominican Republic,Korea,0,0,0,0,01/06/2021,1,0,11,12,0,0,0,0,0,0,0,0,0,0,0,0,2,0,0,2
1741,181159,2021,Korea,Poland,0,0,3,3,31/05/2021,5,0,9,14,0,0,0,0,0,0,0,0,0,0,0,0,2,1,1,4
1742,181159,2021,Korea,Japan,0,1,4,5,27/05/2021,2,0,45,47,0,0,1,1,0,0,0,0,0,0,0,0,0,0,0,0
1743,181159,2021,China,Korea,1,1,13,15,25/05/2021,7,1,90,98,0,0,1,1,0,5,0,5,0,0,0,0,4,1,0,5
1744,151959,2021,Korea,Netherlands,0,0,0,0,20/06/2021,0,0,0,0,0,0,0,0,0,0,0,0,0,0,0,0,0,0,0,0
1745,151959,2021,Korea,Türkiye,0,0,0,0,19/06/2021,0,0,0,0,0,0,0,0,0,0,0,0,0,0,0,0,0,0,0,0
1746,151959,2021,Korea,Serbia,0,0,7,7,13/06/2021,5,0,40,45,0,0,1,1,1,2,2,5,0,0,0,0,5,0,0,5
1747,151959,2021,Russia,Korea,1,1,8,10,12/06/2021,6,1,57,64,0,1,0,1,0,0,1,1,0,0,0,0,4,0,0,4
1748,151959,2021,Germany,Korea,1,1,6,8,08/06/2021,2,0,37,39,0,0,0,0,0,0,0,0,0,0,0,0,3,1,0,4
1749,151959,2021,Thailand,Korea,1,1,11,13,26/05/2021,34,2,84,120,1,0,0,1,2,2,5,9,0,0,0,0,7,1,2,10
1750,151959,2021,China,Korea,0,0,7,7,25/05/2021,5,0,32,37,0,0,1,1,0,1,0,1,0,0,0,0,3,1,0,4
1751,168185,2021,Korea,Netherlands,1,0,5,6,20/06/2021,0,0,0,0,0,1,4,5,0,3,4,7,0,0,0,0,1,1,1,3
1752,168185,2021,Korea,Türkiye,1,2,10,13,19/06/2021,0,0,2,2,4,2,4,10,1,2,0,3,0,0,0,0,2,0,0,2
1753,168185,2021,Korea,Brazil,0,0,9,9,18/06/2021,0,0,1,1,0,0,0,0,0,0,0,0,0,0,0,0,1,0,0,1
1754,168185,2021,Korea,Canada,2,4,17,23,14/06/2021,0,0,4,4,5,3,4,12,1,6,3,10,0,0,0,0,3,0,1,4
1755,168185,2021,Korea,Serbia,3,1,15,19,13/06/2021,0,0,2,2,2,0,3,5,0,4,5,9,0,1,0,1,1,0,1,2
1756,168185,2021,Russia,Korea,0,1,3,4,12/06/2021,0,0,0,0,0,0,1,1,0,1,0,1,0,0,0,0,4,0,0,4
1757,168185,2021,Germany,Korea,0,1,3,4,08/06/2021,0,0,0,0,1,1,6,8,0,1,0,1,0,0,0,0,3,1,0,4
1758,168185,2021,Korea,USA,0,0,1,1,07/06/2021,0,0,1,1,2,0,1,3,0,0,0,0,0,0,0,0,1,0,0,1
1759,168185,2021,Italy,Korea,2,0,6,8,06/06/2021,0,0,0,0,2,1,3,6,0,2,2,4,0,0,1,1,2,0,0,2
1760,168185,2021,Belgium,Korea,0,0,8,8,02/06/2021,0,0,1,1,0,0,3,3,0,6,1,7,0,0,0,0,1,2,0,3
1761,168185,2021,Dominican Republic,Korea,1,0,11,12,01/06/2021,0,0,0,0,1,1,7,9,1,2,1,4,0,0,0,0,1,1,0,2
1762,168185,2021,Korea,Poland,0,1,3,4,31/05/2021,0,0,0,0,3,1,0,4,1,0,1,2,0,1,0,1,0,1,1,2
1763,168185,2021,Korea,Japan,0,0,0,0,27/05/2021,0,0,0,0,0,0,0,0,0,0,0,0,0,0,0,0,0,0,0,0
1764,168185,2021,Thailand,Korea,1,1,5,7,26/05/2021,0,0,2,2,5,2,10,17,1,3,4,8,0,0,0,0,1,1,1,3
1765,168185,2021,China,Korea,0,0,0,0,25/05/2021,0,0,0,0,0,0,0,0,0,0,0,0,0,0,0,0,0,0,0,0
1766,116435,2021,Korea,Netherlands,0,0,0,0,20/06/2021,0,0,11,11,0,0,0,0,0,0,0,0,15,1,24,40,18,3,0,21
1767,116435,2021,Korea,Türkiye,0,0,0,0,19/06/2021,0,0,5,5,0,0,0,0,0,0,0,0,9,4,20,33,9,7,1,17
1768,116435,2021,Korea,Brazil,0,0,0,0,18/06/2021,0,0,5,5,0,0,0,0,0,0,0,0,6,2,6,14,14,2,0,16
1769,116435,2021,Korea,Canada,0,0,0,0,14/06/2021,0,0,7,7,0,0,0,0,0,0,0,0,7,1,20,28,22,5,0,27
1770,116435,2021,Korea,Serbia,0,0,0,0,13/06/2021,0,0,6,6,0,0,0,0,0,0,0,0,3,3,12,18,26,5,2,33
1771,116435,2021,Russia,Korea,0,0,0,0,12/06/2021,0,1,4,5,0,0,0,0,0,0,0,0,6,0,10,16,11,2,2,15
1772,116435,2021,Germany,Korea,0,0,0,0,08/06/2021,0,0,7,7,0,0,0,0,0,0,0,0,5,1,14,20,7,4,1,12
1773,116435,2021,Korea,USA,0,0,0,0,07/06/2021,0,0,1,1,0,0,0,0,0,0,0,0,0,0,0,0,1,0,0,1
1774,116435,2021,Italy,Korea,0,0,0,0,06/06/2021,0,0,9,9,0,0,0,0,0,0,0,0,8,1,8,17,11,3,1,15
1775,116435,2021,Belgium,Korea,0,0,0,0,02/06/2021,0,0,12,12,0,0,0,0,0,0,0,0,6,0,18,24,16,4,2,22
1776,116435,2021,Dominican Republic,Korea,0,0,0,0,01/06/2021,1,0,9,10,0,0,0,0,0,0,0,0,7,1,15,23,13,4,0,17
1777,116435,2021,Korea,Poland,0,0,0,0,31/05/2021,0,0,0,0,0,0,0,0,0,0,0,0,0,0,0,0,0,0,0,0
1778,116435,2021,Korea,Japan,0,0,0,0,27/05/2021,0,0,2,2,0,0,0,0,0,0,0,0,6,0,9,15,7,0,0,7
1779,116435,2021,Thailand,Korea,0,0,0,0,26/05/2021,0,0,2,2,0,0,0,0,0,0,0,0,10,0,8,18,19,1,1,21
1780,116435,2021,China,Korea,0,0,0,0,25/05/2021,0,0,8,8,0,0,0,0,0,0,0,0,13,1,8,22,13,3,3,19
1781,116439,2021,Korea,Netherlands,1,1,16,18,20/06/2021,0,0,9,9,19,3,24,46,0,2,4,6,4,1,24,29,12,4,2,18
1782,116439,2021,Korea,Türkiye,1,0,12,13,19/06/2021,0,0,6,6,10,3,8,21,1,0,0,1,3,0,3,6,3,3,0,6
1783,116439,2021,Korea,Brazil,0,0,9,9,18/06/2021,0,0,2,2,16,5,14,35,1,0,2,3,5,1,10,16,7,1,0,8
1784,116439,2021,Korea,Canada,0,1,23,24,14/06/2021,0,0,10,10,21,5,26,52,2,4,6,12,8,2,8,18,10,2,0,12
1785,116439,2021,Korea,Serbia,0,1,19,20,13/06/2021,0,0,5,5,27,5,18,50,0,1,3,4,4,2,13,19,24,1,1,26
1786,116439,2021,Russia,Korea,2,1,9,12,12/06/2021,0,0,2,2,7,2,13,22,0,2,1,3,3,1,9,13,5,3,1,9
1787,116439,2021,Germany,Korea,0,0,11,11,08/06/2021,0,0,5,5,10,3,12,25,0,1,1,2,2,0,14,16,7,3,0,10
1788,116439,2021,Korea,USA,0,0,0,0,07/06/2021,0,0,0,0,0,0,0,0,0,0,0,0,0,0,0,0,0,0,0,0
1789,116439,2021,Italy,Korea,0,0,14,14,06/06/2021,0,1,11,12,12,2,17,31,0,2,3,5,4,1,11,16,16,3,2,21
1790,116439,2021,Belgium,Korea,2,1,12,15,02/06/2021,0,0,8,8,24,6,18,48,1,3,4,8,12,2,19,33,15,3,3,21
1791,116439,2021,Dominican Republic,Korea,0,1,8,9,01/06/2021,0,0,7,7,13,2,16,31,1,2,0,3,4,2,8,14,8,4,0,12
1792,116439,2021,Korea,Poland,0,0,0,0,31/05/2021,0,0,0,0,0,0,0,0,0,0,0,0,0,0,0,0,0,0,0,0
1793,116439,2021,Korea,Japan,1,1,8,10,27/05/2021,0,0,4,4,9,2,21,32,1,0,0,1,11,1,13,25,3,0,0,3
1794,116439,2021,Thailand,Korea,0,0,0,0,26/05/2021,0,0,0,0,0,0,0,0,0,0,0,0,0,0,0,0,0,0,0,0
1795,116439,2021,China,Korea,0,2,11,13,25/05/2021,0,0,2,2,13,8,20,41,1,0,3,4,13,3,13,29,12,1,0,13
1796,112772,2021,Korea,Netherlands,0,0,12,12,20/06/2021,0,0,1,1,5,1,0,6,2,3,2,7,0,0,0,0,2,2,0,4
1797,112772,2021,Korea,Türkiye,0,0,2,2,19/06/2021,0,0,0,0,2,1,5,8,0,2,0,2,1,0,0,1,2,1,0,3
1798,112772,2021,Korea,Brazil,0,0,8,8,18/06/2021,0,0,3,3,5,1,3,9,1,3,1,5,0,0,0,0,0,0,0,0
1799,112772,2021,Korea,Canada,0,0,0,0,14/06/2021,0,0,0,0,0,0,0,0,0,0,0,0,0,0,0,0,0,0,0,0
1800,112772,2021,Korea,Serbia,0,0,0,0,13/06/2021,0,0,0,0,0,0,0,0,0,0,0,0,0,0,0,0,0,0,0,0
1801,112772,2021,Russia,Korea,1,1,3,5,12/06/2021,0,0,0,0,1,0,0,1,1,2,1,4,1,0,0,1,0,0,0,0
1802,112772,2021,Germany,Korea,0,0,1,1,08/06/2021,0,0,0,0,0,0,0,0,0,0,0,0,0,0,0,0,0,0,0,0
1803,112772,2021,Korea,USA,0,1,9,10,07/06/2021,0,1,0,1,1,1,4,6,0,2,2,4,0,0,0,0,2,1,0,3
1804,112772,2021,Italy,Korea,0,0,2,2,06/06/2021,0,0,0,0,2,0,1,3,0,0,4,4,0,0,0,0,1,0,1,2
1805,112772,2021,Belgium,Korea,0,0,7,7,02/06/2021,0,0,0,0,0,0,2,2,0,0,0,0,0,0,0,0,1,0,1,2
1806,112772,2021,Dominican Republic,Korea,0,0,0,0,01/06/2021,0,0,0,0,0,0,0,0,0,0,0,0,0,0,0,0,0,0,0,0
1807,112772,2021,Korea,Poland,0,0,4,4,31/05/2021,0,0,1,1,1,0,2,3,0,5,0,5,1,0,0,1,2,0,0,2
1808,112772,2021,Korea,Japan,0,0,8,8,27/05/2021,0,0,0,0,5,0,1,6,0,0,1,1,1,0,0,1,2,0,0,2
1809,112772,2021,Thailand,Korea,0,0,0,0,26/05/2021,0,0,0,0,0,0,0,0,0,0,0,0,0,0,0,0,0,0,0,0
1810,112772,2021,China,Korea,0,1,10,11,25/05/2021,0,0,0,0,3,2,4,9,1,1,1,3,0,0,0,0,3,0,1,4
1811,131893,2021,Korea,Netherlands,0,3,10,13,20/06/2021,0,0,3,3,24,5,29,58,0,5,1,6,1,0,7,8,11,0,2,13
1812,131893,2021,Korea,Türkiye,0,1,7,8,19/06/2021,0,0,1,1,11,3,18,32,1,2,0,3,1,1,14,16,6,6,0,12
1813,131893,2021,Korea,Brazil,0,0,5,5,18/06/2021,0,0,3,3,3,3,10,16,0,0,0,0,12,1,11,24,6,6,1,13
1814,131893,2021,Korea,Canada,0,3,6,9,14/06/2021,0,0,4,4,22,7,10,39,2,2,2,6,5,6,25,36,6,0,1,7
1815,131893,2021,Korea,Serbia,1,3,7,11,13/06/2021,0,0,3,3,8,0,14,22,3,0,4,7,4,4,13,21,3,1,1,5
1816,131893,2021,Russia,Korea,0,0,4,4,12/06/2021,0,0,1,1,5,0,12,17,2,0,3,5,3,0,11,14,10,1,2,13
1817,131893,2021,Germany,Korea,0,0,7,7,08/06/2021,0,0,1,1,11,3,17,31,2,1,1,4,0,1,3,4,7,2,0,9
1818,131893,2021,Korea,USA,0,1,4,5,07/06/2021,0,0,3,3,3,4,11,18,0,2,2,4,3,1,5,9,5,1,1,7
1819,131893,2021,Italy,Korea,0,2,6,8,06/06/2021,0,0,1,1,8,2,16,26,0,0,4,4,0,0,1,1,2,1,0,3
1820,131893,2021,Belgium,Korea,1,1,3,5,02/06/2021,0,0,5,5,5,6,17,28,1,2,6,9,0,0,0,0,3,1,0,4
1821,131893,2021,Dominican Republic,Korea,0,4,7,11,01/06/2021,3,0,11,14,9,2,11,22,0,3,0,3,0,0,2,2,6,3,0,9
1822,131893,2021,Korea,Poland,0,2,5,7,31/05/2021,0,0,0,0,7,3,18,28,1,0,0,1,2,2,5,9,4,3,0,7
1823,131893,2021,Korea,Japan,0,1,3,4,27/05/2021,0,0,0,0,7,4,15,26,0,1,0,1,0,0,0,0,0,0,0,0
1824,131893,2021,Thailand,Korea,1,2,8,11,26/05/2021,0,0,0,0,19,3,16,38,2,3,7,12,1,0,0,1,6,0,2,8
1825,131893,2021,China,Korea,1,1,4,6,25/05/2021,0,0,0,0,9,5,14,28,0,3,0,3,0,0,0,0,3,1,0,4
1826,116443,2021,Korea,Netherlands,0,1,16,17,20/06/2021,0,0,4,4,5,1,3,9,5,9,7,21,0,0,0,0,4,0,0,4
1827,116443,2021,Korea,Türkiye,0,0,12,12,19/06/2021,0,0,1,1,1,1,8,10,4,3,1,8,0,0,0,0,1,1,1,3
1828,116443,2021,Korea,Brazil,0,0,0,0,18/06/2021,0,0,0,0,0,0,0,0,0,0,0,0,0,0,0,0,0,0,0,0
1829,116443,2021,Korea,Canada,3,2,15,20,14/06/2021,0,0,4,4,8,0,5,13,1,9,2,12,0,0,0,0,8,0,0,8
1830,116443,2021,Korea,Serbia,0,0,0,0,13/06/2021,0,0,0,0,0,0,0,0,0,0,0,0,0,0,0,0,0,0,0,0
1831,116443,2021,Russia,Korea,0,0,3,3,12/06/2021,0,0,1,1,2,0,3,5,1,3,8,12,1,0,0,1,3,0,1,4
1832,116443,2021,Germany,Korea,0,0,9,9,08/06/2021,0,0,5,5,2,2,2,6,1,1,2,4,0,0,0,0,2,0,3,5
1833,116443,2021,Korea,USA,0,0,0,0,07/06/2021,0,0,0,0,0,0,0,0,0,0,0,0,0,0,0,0,0,0,0,0
1834,116443,2021,Italy,Korea,0,1,13,14,06/06/2021,0,0,2,2,6,0,6,12,1,6,0,7,0,0,0,0,2,0,1,3
1835,116443,2021,Belgium,Korea,0,2,16,18,02/06/2021,0,0,1,1,6,2,6,14,3,7,9,19,0,0,0,0,4,1,3,8
1836,116443,2021,Dominican Republic,Korea,0,1,8,9,01/06/2021,0,0,1,1,4,0,4,8,2,2,0,4,0,0,0,0,0,2,0,2
1837,116443,2021,Korea,Poland,0,0,0,0,31/05/2021,0,0,0,0,0,0,0,0,0,0,0,0,0,0,0,0,0,0,0,0
1838,116443,2021,Korea,Japan,0,0,10,10,27/05/2021,0,0,0,0,5,0,3,8,4,0,0,4,0,0,0,0,1,0,0,1
1839,116443,2021,Thailand,Korea,0,1,6,7,26/05/2021,0,0,0,0,4,0,2,6,0,2,2,4,0,0,0,0,0,0,0,0
1840,116443,2021,China,Korea,0,1,11,12,25/05/2021,0,0,0,0,7,1,7,15,1,3,1,5,1,0,0,1,3,0,0,3
1841,181162,2021,Korea,Brazil,0,0,0,0,18/06/2021,0,0,0,0,0,0,0,0,0,0,0,0,0,0,0,0,0,0,0,0
1842,181162,2021,Korea,Canada,0,0,0,0,14/06/2021,0,0,0,0,0,0,0,0,0,0,0,0,0,0,0,0,0,0,0,0
1843,181162,2021,Korea,Serbia,0,0,0,0,13/06/2021,0,0,0,0,0,0,0,0,0,0,0,0,0,0,0,0,0,0,0,0
1844,181162,2021,Russia,Korea,0,0,1,1,12/06/2021,0,0,0,0,0,0,0,0,0,0,0,0,0,0,0,0,0,0,0,0
1845,181162,2021,Germany,Korea,0,0,0,0,08/06/2021,0,0,0,0,0,0,0,0,0,0,0,0,0,0,0,0,0,0,0,0
1846,181162,2021,Korea,USA,0,1,2,3,07/06/2021,0,0,0,0,5,3,7,15,0,0,0,0,4,4,15,23,4,2,0,6
1847,181162,2021,Italy,Korea,0,1,1,2,06/06/2021,0,0,0,0,2,0,2,4,0,0,0,0,1,0,4,5,1,1,0,2
1848,181162,2021,Belgium,Korea,0,0,0,0,02/06/2021,0,0,0,0,0,0,0,0,0,0,0,0,0,0,0,0,0,0,0,0
1849,181162,2021,Dominican Republic,Korea,0,0,0,0,01/06/2021,0,0,0,0,0,0,0,0,0,0,0,0,0,0,0,0,0,0,0,0
1850,181162,2021,Korea,Poland,0,0,1,1,31/05/2021,0,0,0,0,1,1,4,6,0,0,1,1,0,0,0,0,0,0,0,0
1851,181162,2021,Korea,Japan,0,0,0,0,27/05/2021,0,0,0,0,0,0,0,0,0,0,0,0,0,0,0,0,0,0,0,0
1852,181162,2021,Thailand,Korea,0,2,4,6,26/05/2021,0,0,0,0,0,0,0,0,0,0,0,0,0,0,0,0,0,0,0,0
1853,181162,2021,China,Korea,0,0,0,0,25/05/2021,0,0,0,0,0,0,0,0,0,0,0,0,0,0,0,0,0,0,0,0
1854,163832,2021,Korea,Netherlands,0,0,0,0,20/06/2021,0,0,0,0,0,0,0,0,0,0,0,0,0,0,0,0,0,0,0,0
1855,163832,2021,Korea,Türkiye,0,0,3,3,19/06/2021,0,0,0,0,5,5,4,14,0,0,0,0,0,0,0,0,3,0,0,3
1856,163832,2021,Korea,Brazil,0,2,6,8,18/06/2021,0,0,4,4,12,5,10,27,1,0,0,1,0,0,0,0,7,2,3,12
1857,163832,2021,Korea,Canada,2,0,12,14,14/06/2021,0,0,8,8,12,2,17,31,1,7,3,11,0,0,1,1,13,1,0,14
1858,163832,2021,Korea,Serbia,1,2,17,20,13/06/2021,0,0,3,3,11,7,9,27,2,2,2,6,0,0,0,0,7,3,2,12
1859,163832,2021,Russia,Korea,0,0,8,8,12/06/2021,0,0,1,1,9,6,13,28,2,5,3,10,0,0,0,0,3,2,2,7
1860,163832,2021,Germany,Korea,0,0,3,3,08/06/2021,0,0,0,0,4,3,6,13,0,1,1,2,0,0,0,0,1,2,0,3
1861,163832,2021,Korea,USA,1,0,3,4,07/06/2021,0,0,1,1,2,7,13,22,0,0,4,4,0,0,0,0,5,1,0,6
1862,163832,2021,Italy,Korea,0,1,1,2,06/06/2021,0,0,0,0,3,2,4,9,0,1,2,3,1,0,0,1,1,0,0,1
1863,163832,2021,Belgium,Korea,0,1,6,7,02/06/2021,0,0,1,1,8,4,14,26,2,5,5,12,0,0,0,0,6,3,3,12
1864,163832,2021,Dominican Republic,Korea,0,0,0,0,01/06/2021,0,0,0,0,1,1,3,5,0,1,0,1,0,0,0,0,0,1,0,1
1865,163832,2021,Korea,Poland,0,0,2,2,31/05/2021,0,0,0,0,5,4,10,19,1,0,0,1,0,0,0,0,3,2,0,5
1866,163832,2021,Korea,Japan,1,0,7,8,27/05/2021,0,0,0,0,4,4,7,15,0,0,0,0,0,0,0,0,0,0,0,0
1867,163832,2021,Thailand,Korea,0,1,0,1,26/05/2021,0,0,0,0,2,2,4,8,0,0,1,1,0,0,0,0,0,0,0,0
1868,163832,2021,China,Korea,0,0,1,1,25/05/2021,0,0,5,5,2,6,10,18,0,1,1,2,0,0,0,0,1,0,0,1
1869,133482,2021,Korea,Netherlands,0,0,1,1,20/06/2021,0,0,0,0,0,0,2,2,0,0,0,0,0,0,2,2,0,0,0,0
1870,133482,2021,Korea,Türkiye,0,0,4,4,19/06/2021,0,0,0,0,0,0,0,0,0,1,0,1,0,0,2,2,0,0,0,0
1871,133482,2021,Korea,Brazil,0,0,1,1,18/06/2021,0,0,0,0,0,1,2,3,0,1,0,1,0,0,0,0,2,0,0,2
1872,133482,2021,Korea,Canada,0,2,2,4,14/06/2021,0,0,1,1,1,1,1,3,0,0,0,0,1,0,4,5,2,0,0,2
1873,133482,2021,Korea,Serbia,0,0,0,0,13/06/2021,0,0,0,0,0,0,0,0,0,0,0,0,0,0,0,0,0,0,0,0
1874,133482,2021,Russia,Korea,1,0,1,2,12/06/2021,0,0,0,0,1,3,4,8,0,0,0,0,1,0,5,6,2,1,2,5
1875,133482,2021,Germany,Korea,0,0,1,1,08/06/2021,0,0,0,0,0,0,0,0,0,0,0,0,0,0,0,0,0,0,0,0
1876,133482,2021,Korea,USA,0,0,4,4,07/06/2021,0,0,0,0,4,5,14,23,1,4,2,7,4,4,18,26,3,0,1,4
1877,133482,2021,Italy,Korea,0,0,2,2,06/06/2021,0,0,0,0,0,1,1,2,0,0,0,0,1,0,2,3,2,0,1,3
1878,133482,2021,Belgium,Korea,0,0,0,0,02/06/2021,0,0,0,0,0,0,0,0,0,0,0,0,0,0,0,0,0,0,0,0
1879,133482,2021,Dominican Republic,Korea,1,1,3,5,01/06/2021,0,0,2,2,3,6,6,15,0,2,0,2,4,0,4,8,2,0,0,2
1880,133482,2021,Korea,Poland,2,0,13,15,31/05/2021,0,0,0,0,7,4,10,21,0,2,0,2,9,3,17,29,4,2,2,8
1881,133482,2021,Korea,Japan,0,0,3,3,27/05/2021,0,0,0,0,0,1,0,1,0,0,0,0,0,1,3,4,1,0,0,1
1882,133482,2021,Thailand,Korea,1,1,11,13,26/05/2021,0,0,0,0,12,5,19,36,2,3,2,7,6,0,8,14,16,1,0,17
1883,133482,2021,China,Korea,0,0,0,0,25/05/2021,0,0,0,0,1,1,1,3,0,0,0,0,0,0,1,1,0,0,0,0
1884,124071,2021,Korea,Netherlands,0,0,0,0,20/06/2021,0,0,0,0,0,0,0,0,0,0,0,0,0,0,0,0,0,0,0,0
1885,124071,2021,Brazil,Netherlands,0,0,0,0,19/06/2021,0,0,0,0,0,0,0,0,0,0,0,0,0,0,0,0,0,0,0,0
1886,124071,2021,Türkiye,Netherlands,0,0,0,0,18/06/2021,0,0,0,0,0,0,0,0,0,0,0,0,0,0,0,0,0,0,0,0
1887,124071,2021,Netherlands,Dominican Republic,0,0,0,0,14/06/2021,0,0,3,3,0,0,0,0,0,0,0,0,0,0,0,0,3,1,1,5
1888,124071,2021,Poland,Netherlands,0,0,0,0,07/06/2021,0,0,2,2,0,0,0,0,0,0,0,0,1,0,5,6,10,4,2,16
1889,124071,2021,Japan,Netherlands,0,0,0,0,06/06/2021,0,0,0,0,0,0,0,0,0,0,0,0,0,0,0,0,0,0,0,0
1890,124071,2021,Netherlands,Serbia,0,0,0,0,02/06/2021,0,0,0,0,0,0,0,0,0,0,0,0,0,0,0,0,0,0,0,0
1891,124071,2021,USA,Netherlands,0,0,0,0,01/06/2021,0,0,0,0,0,0,0,0,0,0,0,0,0,0,0,0,0,0,0,0
1892,124071,2021,Thailand,Netherlands,0,0,0,0,31/05/2021,0,0,0,0,0,0,0,0,0,0,0,0,2,0,1,3,5,0,0,5
1893,124071,2021,Russia,Netherlands,0,0,0,0,27/05/2021,0,0,0,0,0,0,0,0,0,0,0,0,0,0,0,0,0,0,0,0
1894,124071,2021,Netherlands,Germany,0,0,0,0,26/05/2021,0,0,0,0,0,0,0,0,0,0,0,0,0,0,0,0,0,0,0,0
1895,124071,2021,Netherlands,Belgium,0,0,0,0,25/05/2021,0,0,0,0,0,0,0,0,0,0,0,0,0,0,0,0,0,0,0,0
1896,150828,2021,Korea,Netherlands,0,0,0,0,20/06/2021,0,0,0,0,0,0,0,0,0,0,0,0,0,0,0,0,0,0,0,0
1897,150828,2021,Türkiye,Netherlands,0,0,0,0,18/06/2021,0,0,0,0,0,0,0,0,0,0,0,0,0,0,0,0,0,0,0,0
1898,150828,2021,Netherlands,Dominican Republic,0,0,0,0,14/06/2021,0,0,0,0,0,0,0,0,0,0,0,0,0,0,0,0,0,0,0,0
1899,150828,2021,Italy,Netherlands,0,0,0,0,13/06/2021,0,0,0,0,0,0,0,0,0,0,0,0,0,0,0,0,0,0,0,0
1900,150828,2021,China,Netherlands,0,0,0,0,12/06/2021,0,0,0,0,0,0,0,0,0,0,0,0,0,0,0,0,0,0,0,0
1901,150828,2021,Canada,Netherlands,0,0,0,0,08/06/2021,0,0,0,0,0,0,0,0,0,0,0,0,0,0,0,0,0,0,0,0
1902,150828,2021,Japan,Netherlands,0,0,0,0,06/06/2021,0,0,0,0,0,0,0,0,0,0,0,0,0,0,0,0,0,0,0,0
1903,150828,2021,Netherlands,Serbia,0,0,0,0,02/06/2021,0,0,0,0,0,0,0,0,0,0,0,0,0,0,0,0,0,0,0,0
1904,150828,2021,USA,Netherlands,0,0,0,0,01/06/2021,0,0,0,0,0,0,0,0,0,0,0,0,0,0,0,0,0,0,0,0
1905,150828,2021,Thailand,Netherlands,0,0,0,0,31/05/2021,0,0,0,0,1,0,2,3,0,0,0,0,0,0,0,0,0,0,0,0
1906,150828,2021,Russia,Netherlands,0,0,0,0,27/05/2021,0,0,0,0,0,0,0,0,0,0,0,0,0,0,0,0,0,0,0,0
1907,150828,2021,Netherlands,Germany,0,0,0,0,26/05/2021,0,0,0,0,0,0,0,0,0,0,0,0,0,0,0,0,0,0,0,0
1908,150828,2021,Netherlands,Belgium,0,0,0,0,25/05/2021,0,0,0,0,0,0,0,0,0,0,0,0,0,0,0,0,0,0,0,0
1909,142880,2021,Korea,Netherlands,0,1,7,8,20/06/2021,0,0,0,0,3,1,6,10,0,4,1,5,0,0,0,0,3,1,0,4
1910,142880,2021,Brazil,Netherlands,1,0,12,13,19/06/2021,0,0,1,1,15,4,16,35,1,3,4,8,0,0,0,0,13,2,1,16
1911,142880,2021,Türkiye,Netherlands,0,1,2,3,18/06/2021,0,0,0,0,2,5,2,9,0,1,0,1,0,0,0,0,2,0,0,2
1912,142880,2021,Netherlands,Dominican Republic,0,2,15,17,14/06/2021,0,1,0,1,11,4,15,30,0,2,4,6,0,0,1,1,8,3,2,13
1913,142880,2021,Italy,Netherlands,0,1,5,6,13/06/2021,0,0,0,0,12,3,3,18,0,2,1,3,0,0,0,0,2,1,1,4
1914,142880,2021,China,Netherlands,0,1,6,7,12/06/2021,0,0,2,2,9,1,12,22,1,1,0,2,0,0,0,0,3,3,0,6
1915,142880,2021,Canada,Netherlands,0,0,9,9,08/06/2021,0,0,0,0,4,1,5,10,0,2,0,2,0,0,0,0,3,1,0,4
1916,142880,2021,Poland,Netherlands,0,1,0,1,07/06/2021,0,0,0,0,0,0,0,0,0,0,0,0,0,0,0,0,0,0,0,0
1917,142880,2021,Japan,Netherlands,0,1,1,2,06/06/2021,0,0,0,0,0,0,2,2,0,0,0,0,0,0,0,0,3,1,0,4
1918,142880,2021,Netherlands,Serbia,0,0,1,1,02/06/2021,0,0,0,0,0,0,2,2,0,0,0,0,0,0,0,0,2,0,0,2
1919,151194,2021,Korea,Netherlands,1,2,11,14,20/06/2021,0,0,2,2,5,0,2,7,0,6,5,11,0,0,0,0,3,0,0,3
1920,151194,2021,Brazil,Netherlands,0,1,5,6,19/06/2021,0,0,2,2,3,0,5,8,0,2,2,4,0,0,1,1,2,0,1,3
1921,151194,2021,Türkiye,Netherlands,1,1,11,13,18/06/2021,0,0,1,1,5,0,3,8,0,2,3,5,0,0,0,0,2,0,2,4
1922,151194,2021,Netherlands,Dominican Republic,1,2,15,18,14/06/2021,0,0,1,1,7,1,6,14,3,8,7,18,0,0,0,0,7,0,1,8
1923,151194,2021,Italy,Netherlands,3,3,20,26,13/06/2021,0,0,2,2,11,1,8,20,1,5,3,9,0,0,0,0,4,1,1,6
1924,151194,2021,China,Netherlands,0,0,8,8,12/06/2021,0,0,0,0,1,3,6,10,1,2,1,4,0,0,0,0,0,0,0,0
1925,151194,2021,Canada,Netherlands,1,0,10,11,08/06/2021,0,0,0,0,10,0,2,12,1,3,1,5,0,0,0,0,3,1,0,4
1926,151194,2021,Poland,Netherlands,1,2,14,17,07/06/2021,0,0,1,1,6,1,4,11,1,5,8,14,0,0,0,0,2,2,1,5
1927,151194,2021,Japan,Netherlands,0,1,6,7,06/06/2021,0,0,0,0,5,2,9,16,3,3,7,13,0,0,1,1,1,0,2,3
1928,151194,2021,Netherlands,Serbia,3,1,17,21,02/06/2021,0,0,2,2,9,3,4,16,5,4,6,15,0,0,0,0,3,2,0,5
1929,151194,2021,USA,Netherlands,0,1,6,7,01/06/2021,0,0,0,0,0,0,2,2,0,0,0,0,0,0,0,0,1,0,0,1
1930,151194,2021,Thailand,Netherlands,1,4,13,18,31/05/2021,0,0,0,0,3,0,0,3,0,1,2,3,0,0,0,0,1,1,1,3
1931,167777,2021,Korea,Netherlands,0,0,5,5,20/06/2021,0,0,0,0,1,1,1,3,1,0,1,2,0,0,0,0,0,0,0,0
1932,167777,2021,Brazil,Netherlands,0,0,5,5,19/06/2021,0,0,0,0,2,0,3,5,1,1,1,3,0,0,0,0,2,1,0,3
1933,167777,2021,Türkiye,Netherlands,0,0,0,0,18/06/2021,0,0,0,0,0,0,0,0,0,0,0,0,0,0,0,0,0,0,0,0
1934,167777,2021,Netherlands,Dominican Republic,0,0,2,2,14/06/2021,0,0,0,0,0,0,0,0,0,0,0,0,0,0,0,0,0,0,0,0
1935,167777,2021,Italy,Netherlands,0,0,1,1,13/06/2021,0,0,0,0,0,0,0,0,0,0,0,0,0,0,0,0,0,0,0,0
1936,167777,2021,China,Netherlands,0,0,0,0,12/06/2021,0,0,0,0,0,0,0,0,0,0,0,0,0,0,0,0,0,0,0,0
1937,167777,2021,Canada,Netherlands,0,0,2,2,08/06/2021,0,0,0,0,0,0,1,1,1,0,1,2,0,0,0,0,1,0,0,1
1938,167777,2021,Poland,Netherlands,0,0,0,0,07/06/2021,0,0,0,0,0,0,0,0,0,0,0,0,0,0,0,0,0,0,0,0
1939,167777,2021,Netherlands,Serbia,0,0,3,3,02/06/2021,0,0,0,0,0,0,0,0,0,0,0,0,0,0,0,0,0,1,0,1
1940,167777,2021,USA,Netherlands,0,0,1,1,01/06/2021,0,0,0,0,0,0,0,0,0,0,0,0,0,0,0,0,0,0,0,0
1941,167777,2021,Thailand,Netherlands,0,0,0,0,31/05/2021,0,0,0,0,0,0,0,0,0,0,2,2,0,0,0,0,0,0,0,0
1942,167777,2021,Russia,Netherlands,1,0,4,5,27/05/2021,0,0,0,0,0,0,0,0,0,0,0,0,0,0,0,0,0,0,0,0
1943,167777,2021,Netherlands,Germany,0,1,2,3,26/05/2021,0,0,0,0,0,0,0,0,0,0,0,0,0,0,0,0,0,0,0,0
1944,167777,2021,Netherlands,Belgium,0,0,5,5,25/05/2021,0,0,0,0,0,0,0,0,0,0,0,0,0,0,0,0,0,0,0,0
1945,123468,2021,Korea,Netherlands,0,0,0,0,20/06/2021,0,0,10,10,0,0,0,0,0,0,0,0,2,0,4,6,18,7,6,31
1946,123468,2021,Brazil,Netherlands,0,0,0,0,19/06/2021,0,0,11,11,0,0,0,0,0,0,0,0,4,1,4,9,4,1,6,11
1947,123468,2021,Türkiye,Netherlands,0,0,0,0,18/06/2021,0,0,5,5,0,0,0,0,0,0,0,0,3,1,5,9,12,2,2,16
1948,123468,2021,Netherlands,Dominican Republic,0,0,0,0,14/06/2021,0,0,7,7,0,0,0,0,0,0,0,0,7,0,14,21,9,7,1,17
1949,123468,2021,Italy,Netherlands,0,0,0,0,13/06/2021,0,0,11,11,0,0,0,0,0,0,0,0,9,0,6,15,18,5,1,24
1950,123468,2021,China,Netherlands,0,0,0,0,12/06/2021,0,0,10,10,0,0,0,0,0,0,0,0,6,1,5,12,12,8,2,22
1951,123468,2021,Canada,Netherlands,0,0,0,0,08/06/2021,0,0,6,6,0,0,0,0,0,0,0,0,6,1,9,16,10,1,0,11
1952,123468,2021,Poland,Netherlands,0,0,0,0,07/06/2021,0,0,7,7,0,0,0,0,0,0,0,0,0,0,3,3,5,1,1,7
1953,123468,2021,Japan,Netherlands,0,0,0,0,06/06/2021,0,0,14,14,0,0,0,0,0,0,0,0,4,1,2,7,13,2,2,17
1954,123468,2021,Netherlands,Serbia,0,0,0,0,02/06/2021,0,0,6,6,0,0,0,0,0,0,0,0,6,0,8,14,21,5,4,30
1955,123468,2021,USA,Netherlands,0,0,0,0,01/06/2021,0,0,11,11,0,0,0,0,0,0,0,0,4,0,5,9,13,6,0,19
1956,123468,2021,Thailand,Netherlands,0,0,0,0,31/05/2021,0,1,0,1,0,0,0,0,0,0,0,0,3,0,1,4,7,1,2,10
1957,123468,2021,Russia,Netherlands,0,0,0,0,27/05/2021,0,0,3,3,0,0,0,0,0,0,0,0,10,0,8,18,18,1,0,19
1958,123468,2021,Netherlands,Germany,0,0,0,0,26/05/2021,0,0,6,6,0,0,0,0,0,0,0,0,12,3,27,42,18,0,0,18
1959,123468,2021,Netherlands,Belgium,0,0,0,0,25/05/2021,0,0,2,2,0,0,0,0,0,0,0,0,4,0,6,10,15,2,1,18
1960,162356,2021,Korea,Netherlands,0,0,0,0,20/06/2021,0,0,0,0,0,0,0,0,0,0,0,0,0,0,0,0,0,0,0,0
1961,162356,2021,Brazil,Netherlands,0,0,0,0,19/06/2021,1,0,5,6,0,0,0,0,0,0,0,0,0,0,0,0,0,0,0,0
1962,162356,2021,Türkiye,Netherlands,0,0,0,0,18/06/2021,0,0,0,0,0,0,0,0,0,0,0,0,0,0,0,0,0,0,0,0
1963,162356,2021,Netherlands,Dominican Republic,0,0,0,0,14/06/2021,0,0,0,0,0,0,0,0,0,0,0,0,0,0,0,0,0,0,0,0
1964,162356,2021,Italy,Netherlands,0,0,0,0,13/06/2021,0,0,0,0,0,0,0,0,0,0,0,0,0,0,0,0,0,0,0,0
1965,162356,2021,China,Netherlands,0,0,0,0,12/06/2021,1,0,0,1,0,0,0,0,0,0,0,0,0,0,0,0,0,0,0,0
1966,162356,2021,Canada,Netherlands,0,0,0,0,08/06/2021,0,0,0,0,0,0,0,0,0,0,0,0,0,0,0,0,0,0,0,0
1967,162356,2021,Poland,Netherlands,0,0,0,0,07/06/2021,0,0,0,0,0,0,0,0,0,0,0,0,0,0,0,0,0,0,0,0
1968,162356,2021,Japan,Netherlands,0,0,0,0,06/06/2021,0,0,0,0,0,0,0,0,0,0,0,0,0,0,0,0,0,0,0,0
1969,162356,2021,Netherlands,Serbia,0,0,0,0,02/06/2021,0,0,0,0,0,0,0,0,0,0,0,0,0,0,0,0,0,0,0,0
1970,162356,2021,USA,Netherlands,0,0,0,0,01/06/2021,0,0,0,0,0,0,0,0,0,0,0,0,0,0,0,0,0,0,0,0
1971,162356,2021,Thailand,Netherlands,0,0,1,1,31/05/2021,0,0,0,0,0,0,0,0,0,0,0,0,0,0,0,0,0,0,0,0
1972,162356,2021,Russia,Netherlands,0,0,0,0,27/05/2021,0,0,0,0,0,0,0,0,0,0,0,0,0,0,0,0,0,0,0,0
1973,162356,2021,Netherlands,Germany,0,0,0,0,26/05/2021,0,0,0,0,0,0,0,0,0,0,0,0,0,0,0,0,0,0,0,0
1974,162356,2021,Netherlands,Belgium,0,0,0,0,25/05/2021,0,0,0,0,0,0,0,0,0,0,0,0,0,0,0,0,0,0,0,0
1975,120503,2021,Korea,Netherlands,0,1,13,14,20/06/2021,0,0,1,1,14,6,11,31,1,4,3,8,14,1,21,36,9,4,3,16
1976,120503,2021,Brazil,Netherlands,0,1,9,10,19/06/2021,0,0,2,2,6,3,6,15,0,2,1,3,12,2,12,26,6,5,1,12
1977,120503,2021,Türkiye,Netherlands,1,1,4,6,18/06/2021,0,0,0,0,2,1,5,8,0,0,0,0,3,0,14,17,1,1,0,2
1978,120503,2021,Netherlands,Dominican Republic,0,3,7,10,14/06/2021,0,0,0,0,16,9,23,48,0,4,5,9,11,1,20,32,13,2,3,18
1979,120503,2021,Italy,Netherlands,0,3,6,9,13/06/2021,0,0,2,2,14,4,25,43,1,2,1,4,12,2,19,33,1,2,0,3
1980,120503,2021,China,Netherlands,0,0,8,8,12/06/2021,0,0,0,0,8,4,23,35,1,3,0,4,12,2,12,26,3,2,0,5
1981,120503,2021,Canada,Netherlands,1,0,13,14,08/06/2021,0,0,0,0,11,2,10,23,3,2,0,5,6,0,10,16,2,1,0,3
1982,120503,2021,Poland,Netherlands,0,0,21,21,07/06/2021,0,0,2,2,16,7,22,45,1,4,3,8,15,2,30,47,11,3,1,15
1983,120503,2021,Japan,Netherlands,0,1,4,5,06/06/2021,0,0,1,1,3,3,7,13,0,2,0,2,4,0,11,15,4,1,1,6
1984,120503,2021,Netherlands,Serbia,0,0,0,0,02/06/2021,0,0,0,0,0,0,0,0,0,0,0,0,0,0,0,0,0,0,0,0
1985,120503,2021,USA,Netherlands,0,0,8,8,01/06/2021,0,0,6,6,5,2,24,31,4,4,1,9,9,3,11,23,11,2,2,15
1986,120503,2021,Thailand,Netherlands,3,0,16,19,31/05/2021,0,0,0,0,10,1,8,19,0,1,0,1,5,1,11,17,5,2,3,10
1987,120503,2021,Russia,Netherlands,0,0,17,17,27/05/2021,0,0,1,1,12,2,12,26,3,3,0,6,8,4,15,27,15,2,0,17
1988,120503,2021,Netherlands,Germany,0,1,15,16,26/05/2021,0,0,0,0,13,6,21,40,1,0,0,1,13,3,19,35,9,1,0,10
1989,120503,2021,Netherlands,Belgium,0,1,10,11,25/05/2021,0,0,1,1,12,4,11,27,0,3,4,7,13,2,12,27,10,0,0,10
1990,147432,2021,Korea,Netherlands,1,0,13,14,20/06/2021,35,0,94,129,4,0,4,8,0,8,11,19,0,0,0,0,9,2,1,12
1991,147432,2021,Brazil,Netherlands,0,2,4,6,19/06/2021,17,2,65,84,1,1,2,4,0,1,1,2,0,0,0,0,13,3,1,17
1992,147432,2021,Türkiye,Netherlands,0,2,10,12,18/06/2021,10,0,75,85,2,0,0,2,0,2,3,5,0,0,0,0,5,5,0,10
1993,147432,2021,Netherlands,Dominican Republic,1,0,13,14,14/06/2021,30,0,106,136,1,0,5,6,0,4,1,5,0,0,0,0,5,3,1,9
1994,147432,2021,Italy,Netherlands,0,1,10,11,13/06/2021,22,1,118,141,4,1,3,8,3,3,4,10,0,0,0,0,6,5,0,11
1995,147432,2021,China,Netherlands,1,0,15,16,12/06/2021,6,1,105,112,1,0,0,1,0,3,0,3,0,0,0,0,3,3,0,6
1996,147432,2021,Canada,Netherlands,1,1,6,8,08/06/2021,10,1,67,78,1,0,2,3,2,1,3,6,0,0,0,0,4,3,1,8
1997,147432,2021,Poland,Netherlands,0,0,13,13,07/06/2021,29,0,97,126,2,0,1,3,1,1,2,4,0,1,0,1,12,1,1,14
1998,147432,2021,Japan,Netherlands,0,2,11,13,06/06/2021,35,0,60,95,1,0,3,4,0,3,5,8,0,0,0,0,6,1,3,10
1999,147432,2021,Netherlands,Serbia,0,0,12,12,02/06/2021,28,1,94,123,1,0,2,3,2,2,5,9,0,0,0,0,9,3,1,13
2000,147432,2021,USA,Netherlands,0,2,7,9,01/06/2021,20,0,74,94,0,0,0,0,0,3,4,7,0,1,0,1,6,5,0,11
2001,147432,2021,Thailand,Netherlands,0,0,6,6,31/05/2021,19,0,0,19,4,0,3,7,3,2,1,6,0,0,0,0,2,2,1,5
2002,147432,2021,Russia,Netherlands,3,0,14,17,27/05/2021,22,0,87,109,1,0,2,3,0,3,0,3,0,0,0,0,5,1,0,6
2003,147432,2021,Netherlands,Germany,3,1,14,18,26/05/2021,33,0,103,136,2,0,3,5,0,4,1,5,0,0,0,0,7,0,0,7
2004,147432,2021,Netherlands,Belgium,0,1,8,9,25/05/2021,36,0,62,98,2,0,3,5,1,1,3,5,0,0,0,0,2,1,0,3
2005,167778,2021,Canada,Netherlands,0,0,0,0,08/06/2021,0,0,0,0,0,0,0,0,0,0,0,0,0,0,0,0,0,0,0,0
2006,150807,2021,Brazil,Netherlands,0,0,0,0,19/06/2021,0,0,0,0,0,0,0,0,0,0,0,0,0,0,0,0,0,0,0,0
2007,150807,2021,Türkiye,Netherlands,0,1,0,1,18/06/2021,0,0,0,0,0,0,0,0,0,0,0,0,0,0,0,0,0,0,0,0
2008,159904,2021,Korea,Netherlands,0,0,5,5,20/06/2021,0,0,1,1,0,1,0,1,0,0,0,0,4,0,2,6,3,1,2,6
2009,159904,2021,Brazil,Netherlands,0,0,1,1,19/06/2021,0,0,2,2,2,0,2,4,1,0,2,3,3,0,4,7,1,1,0,2
2010,159904,2021,Türkiye,Netherlands,0,0,6,6,18/06/2021,0,0,2,2,8,2,11,21,0,4,2,6,4,0,9,13,6,1,0,7
2011,159904,2021,Netherlands,Dominican Republic,0,1,1,2,14/06/2021,0,0,1,1,0,0,0,0,0,0,0,0,2,0,7,9,4,0,0,4
2012,159904,2021,Italy,Netherlands,1,0,8,9,13/06/2021,0,0,0,0,0,0,0,0,0,0,0,0,2,1,0,3,2,1,0,3
2013,159904,2021,China,Netherlands,0,0,2,2,12/06/2021,0,0,0,0,0,0,0,0,0,0,0,0,1,0,6,7,2,1,1,4
2014,159904,2021,Canada,Netherlands,0,0,1,1,08/06/2021,0,0,1,1,0,1,1,2,0,0,0,0,0,0,4,4,2,2,0,4
2015,159904,2021,Poland,Netherlands,1,0,5,6,07/06/2021,0,0,0,0,0,0,3,3,0,0,0,0,3,0,3,6,3,1,0,4
2016,159904,2021,Japan,Netherlands,0,1,9,10,06/06/2021,0,0,0,0,5,3,9,17,0,1,3,4,7,0,4,11,10,1,0,11
2017,159904,2021,Netherlands,Serbia,1,0,13,14,02/06/2021,0,0,2,2,4,5,15,24,0,0,1,1,8,0,9,17,15,1,1,17
2018,159904,2021,USA,Netherlands,0,1,1,2,01/06/2021,0,0,0,0,1,0,3,4,0,0,1,1,2,1,5,8,3,2,1,6
2019,159904,2021,Thailand,Netherlands,0,1,2,3,31/05/2021,0,0,0,0,0,0,0,0,0,0,0,0,0,0,1,1,1,0,0,1
2020,159904,2021,Russia,Netherlands,0,0,0,0,27/05/2021,0,0,0,0,0,0,0,0,0,0,0,0,0,1,0,1,0,0,0,0
2021,159904,2021,Netherlands,Germany,0,0,5,5,26/05/2021,0,0,0,0,0,0,0,0,0,0,0,0,0,0,0,0,1,0,0,1
2022,159904,2021,Netherlands,Belgium,0,0,0,0,25/05/2021,0,0,0,0,0,0,0,0,0,0,0,0,0,0,0,0,0,0,0,0
2023,150809,2021,Korea,Netherlands,0,2,13,15,20/06/2021,0,0,4,4,28,7,30,65,2,2,4,8,10,1,27,38,12,4,2,18
2024,150809,2021,Brazil,Netherlands,0,1,10,11,19/06/2021,0,0,4,4,12,2,16,30,0,0,2,2,13,0,16,29,4,2,5,11
2025,150809,2021,Türkiye,Netherlands,1,1,9,11,18/06/2021,0,0,2,2,7,4,8,19,1,2,3,6,9,3,16,28,9,3,0,12
2026,150809,2021,Netherlands,Dominican Republic,3,3,12,18,14/06/2021,0,0,3,3,19,4,20,43,1,1,2,4,5,1,20,26,13,0,3,16
2027,150809,2021,Italy,Netherlands,2,3,13,18,13/06/2021,0,0,0,0,16,1,26,43,2,6,2,10,18,3,22,43,13,3,0,16
2028,150809,2021,China,Netherlands,0,0,10,10,12/06/2021,0,0,1,1,11,4,24,39,0,0,2,2,11,1,20,32,5,4,0,9
2029,150809,2021,Canada,Netherlands,1,1,13,15,08/06/2021,0,0,0,0,7,3,11,21,1,0,1,2,3,1,7,11,3,4,1,8
2030,150809,2021,Poland,Netherlands,1,1,10,12,07/06/2021,0,0,2,2,16,7,16,39,1,3,7,11,6,1,17,24,4,4,2,10
2031,150809,2021,Japan,Netherlands,2,2,9,13,06/06/2021,0,0,0,0,19,3,14,36,1,2,1,4,4,1,24,29,4,2,4,10
2032,150809,2021,Netherlands,Serbia,2,2,10,14,02/06/2021,0,0,0,0,15,5,23,43,3,3,6,12,11,2,29,42,8,0,2,10
2033,150809,2021,USA,Netherlands,0,1,5,6,01/06/2021,0,0,2,2,6,7,20,33,0,3,1,4,5,2,13,20,4,2,1,7
2034,150809,2021,Thailand,Netherlands,0,1,9,10,31/05/2021,0,0,0,0,11,1,9,21,1,3,2,6,12,1,3,16,7,1,0,8
2035,150809,2021,Russia,Netherlands,1,3,12,16,27/05/2021,0,0,0,0,13,4,16,33,1,4,2,7,5,2,16,23,4,6,0,10
2036,150809,2021,Netherlands,Germany,1,4,16,21,26/05/2021,0,0,1,1,21,5,20,46,3,1,0,4,7,0,10,17,13,2,0,15
2037,150809,2021,Netherlands,Belgium,1,1,14,16,25/05/2021,0,0,0,0,7,3,11,21,2,3,2,7,6,0,5,11,8,6,1,15
2038,168147,2021,Korea,Netherlands,0,0,0,0,20/06/2021,0,0,0,0,0,0,0,0,0,0,0,0,0,0,0,0,0,0,0,0
2039,168147,2021,Brazil,Netherlands,0,0,0,0,19/06/2021,0,0,0,0,0,0,0,0,0,0,0,0,0,0,0,0,0,0,0,0
2040,168147,2021,Netherlands,Dominican Republic,0,0,1,1,14/06/2021,0,0,0,0,0,0,0,0,0,0,0,0,0,0,0,0,0,1,0,1
2041,168147,2021,Italy,Netherlands,0,0,0,0,13/06/2021,0,0,0,0,0,0,0,0,0,0,0,0,0,0,0,0,0,0,0,0
2042,168147,2021,China,Netherlands,0,0,2,2,12/06/2021,0,0,0,0,0,0,2,2,0,0,0,0,0,0,0,0,1,0,0,1
2043,168147,2021,Thailand,Netherlands,0,0,0,0,31/05/2021,0,0,0,0,1,0,1,2,0,0,0,0,0,0,0,0,0,0,0,0
2044,172894,2021,Korea,Netherlands,1,2,12,15,20/06/2021,0,0,0,0,8,1,7,16,4,10,9,23,1,0,1,2,5,1,3,9
2045,172894,2021,Brazil,Netherlands,0,1,7,8,19/06/2021,0,0,1,1,5,3,6,14,0,9,4,13,0,0,0,0,0,0,1,1
2046,172894,2021,Türkiye,Netherlands,0,1,6,7,18/06/2021,0,0,2,2,7,0,8,15,2,4,4,10,1,0,0,1,2,0,1,3
2047,172894,2021,Netherlands,Dominican Republic,0,4,8,12,14/06/2021,0,0,2,2,8,5,4,17,1,7,10,18,0,0,1,1,6,0,2,8
2048,172894,2021,Italy,Netherlands,0,4,11,15,13/06/2021,0,0,4,4,7,3,6,16,0,4,1,5,1,0,0,1,1,0,1,2
2049,172894,2021,China,Netherlands,0,1,5,6,12/06/2021,0,0,0,0,6,0,7,13,3,3,1,7,0,0,0,0,2,2,0,4
2050,172894,2021,Canada,Netherlands,0,3,5,8,08/06/2021,0,0,1,1,6,1,4,11,4,2,1,7,0,0,0,0,3,1,1,5
2051,172894,2021,Poland,Netherlands,1,2,17,20,07/06/2021,0,0,4,4,10,1,4,15,5,8,13,26,0,0,1,1,6,2,1,9
2052,172894,2021,Japan,Netherlands,2,0,9,11,06/06/2021,0,0,0,0,7,1,2,10,3,2,6,11,0,0,0,0,3,0,0,3
2053,172894,2021,Netherlands,Serbia,1,2,7,10,02/06/2021,0,0,1,1,6,2,6,14,4,9,6,19,0,0,0,0,2,0,0,2
2054,172894,2021,USA,Netherlands,0,2,5,7,01/06/2021,0,0,0,0,3,2,5,10,1,5,8,14,0,0,0,0,3,1,1,5
2055,172894,2021,Thailand,Netherlands,1,3,5,9,31/05/2021,0,0,0,0,4,0,6,10,6,2,1,9,0,0,1,1,1,0,0,1
2056,172894,2021,Russia,Netherlands,0,4,10,14,27/05/2021,0,0,0,0,10,1,3,14,2,8,0,10,0,0,0,0,5,0,0,5
2057,172894,2021,Netherlands,Germany,1,2,15,18,26/05/2021,0,0,1,1,7,4,10,21,1,2,2,5,0,0,1,1,5,0,0,5
2058,172894,2021,Netherlands,Belgium,2,3,8,13,25/05/2021,0,0,1,1,7,2,2,11,1,4,4,9,0,0,0,0,4,0,1,5
2059,162357,2021,Russia,Netherlands,0,0,0,0,27/05/2021,0,0,0,0,0,0,0,0,0,0,0,0,0,0,0,0,1,0,0,1
2060,162357,2021,Netherlands,Germany,0,0,0,0,26/05/2021,0,0,0,0,0,0,0,0,0,0,0,0,0,0,0,0,0,0,0,0
2061,162357,2021,Netherlands,Belgium,0,0,0,0,25/05/2021,0,0,0,0,0,0,0,0,0,0,0,0,0,0,0,0,0,0,0,0
2062,148581,2021,Italy,Netherlands,0,0,0,0,13/06/2021,0,0,0,0,0,0,0,0,0,0,0,0,0,0,0,0,0,0,0,0
2063,148581,2021,China,Netherlands,0,0,0,0,12/06/2021,0,0,0,0,0,0,0,0,0,0,0,0,0,0,0,0,0,0,0,0
2064,162372,2021,Korea,Netherlands,1,0,18,19,20/06/2021,0,0,3,3,9,2,8,19,0,3,8,11,0,1,0,1,4,2,3,9
2065,162372,2021,Brazil,Netherlands,0,0,0,0,19/06/2021,0,0,0,0,1,0,1,2,0,1,1,2,0,0,0,0,0,0,0,0
2066,162372,2021,Türkiye,Netherlands,1,1,6,8,18/06/2021,0,0,2,2,4,2,12,18,2,2,0,4,0,0,0,0,3,1,1,5
2067,162372,2021,Netherlands,Dominican Republic,0,1,4,5,14/06/2021,0,0,0,0,2,0,4,6,1,0,0,1,0,0,0,0,6,2,1,9
2068,162372,2021,Italy,Netherlands,0,0,15,15,13/06/2021,0,0,1,1,5,2,11,18,2,1,0,3,0,0,0,0,6,1,0,7
2069,162372,2021,China,Netherlands,1,0,2,3,12/06/2021,0,0,0,0,2,0,6,8,1,0,2,3,0,0,0,0,0,0,0,0
2070,162372,2021,Canada,Netherlands,0,0,0,0,08/06/2021,0,0,0,0,0,0,0,0,0,0,0,0,0,0,0,0,0,0,0,0
2071,162372,2021,Poland,Netherlands,0,0,2,2,07/06/2021,0,0,0,0,0,1,0,1,0,1,0,1,0,0,0,0,2,0,0,2
2072,162372,2021,Japan,Netherlands,0,0,0,0,06/06/2021,0,0,0,0,0,0,0,0,0,0,0,0,0,0,0,0,0,0,0,0
2073,162372,2021,USA,Netherlands,0,0,0,0,01/06/2021,0,0,0,0,0,0,0,0,0,0,0,0,0,0,0,0,0,0,0,0
2074,162372,2021,Russia,Netherlands,0,0,0,0,27/05/2021,0,0,0,0,0,0,0,0,0,0,0,0,0,0,0,0,0,0,0,0
2075,162372,2021,Netherlands,Germany,0,0,0,0,26/05/2021,0,0,0,0,0,0,0,0,0,0,0,0,0,0,0,0,0,0,0,0
2076,162372,2021,Netherlands,Belgium,0,0,0,0,25/05/2021,0,0,0,0,0,0,0,0,0,0,0,0,0,0,0,0,0,0,0,0
2077,152216,2021,Russia,Poland,0,0,7,7,20/06/2021,2,0,5,7,0,0,1,1,0,0,0,0,0,0,0,0,3,0,0,3
2078,152216,2021,China,Poland,0,0,0,0,19/06/2021,2,0,2,4,0,0,0,0,0,0,0,0,0,0,0,0,1,0,0,1
2079,152216,2021,Poland,USA,0,1,2,3,18/06/2021,1,0,15,16,0,0,0,0,0,0,0,0,0,0,0,0,3,1,0,4
2080,152216,2021,Germany,Poland,0,0,7,7,14/06/2021,1,0,11,12,0,0,0,0,0,0,1,1,0,0,0,0,1,0,0,1
2081,152216,2021,Thailand,Poland,0,0,0,0,13/06/2021,6,0,10,16,0,0,0,0,0,0,0,0,0,0,0,0,1,0,0,1
2082,152216,2021,Poland,Brazil,0,0,3,3,12/06/2021,0,0,4,4,0,0,0,0,0,0,0,0,0,0,0,0,3,1,1,5
2083,152216,2021,Japan,Poland,0,1,19,20,08/06/2021,29,2,95,126,4,0,4,8,1,7,0,8,0,0,0,0,6,2,1,9
2084,152216,2021,Poland,Netherlands,1,4,16,21,07/06/2021,33,0,71,104,0,0,0,0,0,2,5,7,0,0,1,1,14,1,2,17
2085,152216,2021,Canada,Poland,1,2,17,20,06/06/2021,12,0,91,103,1,1,2,4,2,1,1,4,0,0,0,0,4,4,0,8
2086,152216,2021,Poland,Dominican Republic,1,1,17,19,02/06/2021,36,0,81,117,1,1,6,8,2,4,0,6,0,0,0,0,16,0,1,17
2087,152216,2021,Belgium,Poland,1,1,21,23,01/06/2021,20,1,92,113,0,0,3,3,0,2,5,7,0,0,0,0,11,3,3,17
2088,152216,2021,Korea,Poland,3,1,21,25,31/05/2021,20,1,47,68,1,0,2,3,0,0,0,0,0,0,1,1,7,1,0,8
2089,152216,2021,Poland,Türkiye,0,0,20,20,27/05/2021,27,2,80,109,2,0,2,4,3,2,1,6,0,0,2,2,8,3,1,12
2090,152216,2021,Serbia,Poland,0,0,8,8,26/05/2021,10,1,50,61,1,1,2,4,2,2,3,7,0,0,1,1,1,2,1,4
2091,152216,2021,Italy,Poland,0,2,16,18,25/05/2021,16,3,112,131,2,1,4,7,0,5,4,9,0,0,0,0,13,2,0,15
2092,162398,2021,Russia,Poland,2,0,11,13,20/06/2021,0,0,1,1,0,3,2,5,2,0,1,3,0,0,0,0,3,1,0,4
2093,162398,2021,China,Poland,0,1,5,6,19/06/2021,0,0,0,0,4,3,0,7,1,2,0,3,0,0,1,1,2,0,0,2
2094,162398,2021,Poland,USA,1,0,12,13,18/06/2021,0,0,0,0,6,1,1,8,0,0,5,5,0,0,1,1,4,0,0,4
2095,162398,2021,Germany,Poland,1,0,12,13,14/06/2021,0,0,1,1,4,1,2,7,2,3,4,9,0,0,0,0,3,0,0,3
2096,162398,2021,Thailand,Poland,0,2,6,8,13/06/2021,0,0,1,1,4,0,3,7,1,4,3,8,0,0,0,0,2,4,0,6
2097,162398,2021,Poland,Brazil,0,2,8,10,12/06/2021,0,0,4,4,4,1,2,7,0,5,1,6,0,0,0,0,2,1,1,4
2098,162398,2021,Japan,Poland,0,2,22,24,08/06/2021,0,0,0,0,5,1,2,8,2,4,2,8,0,0,0,0,4,4,0,8
2099,162398,2021,Poland,Netherlands,0,0,4,4,07/06/2021,0,0,1,1,2,0,1,3,0,0,2,2,0,0,0,0,2,0,0,2
2100,162398,2021,Canada,Poland,1,0,15,16,06/06/2021,0,0,0,0,6,3,2,11,2,3,2,7,0,0,1,1,2,2,0,4
2101,162398,2021,Poland,Dominican Republic,0,2,20,22,02/06/2021,0,0,1,1,9,1,4,14,0,3,4,7,0,0,1,1,5,2,0,7
2102,162398,2021,Belgium,Poland,0,2,14,16,01/06/2021,0,0,1,1,8,2,1,11,4,5,7,16,0,0,1,1,7,1,0,8
2103,162398,2021,Korea,Poland,0,0,9,9,31/05/2021,0,0,2,2,4,0,3,7,2,3,4,9,0,0,0,0,2,0,0,2
2104,162398,2021,Poland,Türkiye,0,1,14,15,27/05/2021,0,0,1,1,3,2,1,6,3,1,0,4,0,0,0,0,1,1,2,4
2105,162398,2021,Serbia,Poland,0,0,5,5,26/05/2021,0,0,1,1,0,0,3,3,0,1,0,1,0,0,0,0,0,0,0,0
2106,162398,2021,Italy,Poland,1,0,11,12,25/05/2021,0,0,1,1,3,1,0,4,1,0,3,4,0,0,1,1,2,0,0,2
2107,136317,2021,Russia,Poland,1,0,7,8,20/06/2021,0,0,0,0,2,0,1,3,7,2,1,10,0,0,0,0,2,1,2,5
2108,136317,2021,China,Poland,0,0,2,2,19/06/2021,0,0,0,0,2,0,0,2,0,0,1,1,0,0,0,0,1,1,0,2
2109,136317,2021,Poland,USA,0,0,1,1,18/06/2021,0,0,1,1,0,0,0,0,0,0,0,0,0,0,0,0,0,0,0,0
2110,136317,2021,Japan,Poland,0,1,12,13,08/06/2021,0,0,1,1,5,1,8,14,2,5,4,11,0,0,0,0,3,0,0,3
2111,136317,2021,Poland,Netherlands,1,2,11,14,07/06/2021,0,0,1,1,7,4,5,16,0,3,10,13,0,1,0,1,4,1,3,8
2112,136317,2021,Canada,Poland,0,0,0,0,06/06/2021,0,0,0,0,0,0,0,0,0,0,0,0,0,0,0,0,0,0,0,0
2113,136317,2021,Poland,Dominican Republic,0,1,10,11,02/06/2021,0,0,1,1,3,2,2,7,6,4,3,13,0,0,0,0,5,3,3,11
2114,136317,2021,Belgium,Poland,0,0,0,0,01/06/2021,0,0,0,0,0,0,0,0,0,0,0,0,0,0,0,0,0,0,0,0
2115,136317,2021,Korea,Poland,0,0,0,0,31/05/2021,0,0,0,0,0,0,0,0,0,0,0,0,0,0,0,0,0,0,0,0
2116,136317,2021,Serbia,Poland,1,1,7,9,26/05/2021,0,0,1,1,7,2,8,17,1,3,0,4,2,0,0,2,1,2,0,3
2117,136317,2021,Italy,Poland,2,2,6,10,25/05/2021,0,0,1,1,2,0,7,9,1,1,7,9,0,0,0,0,1,0,0,1
2118,152233,2021,Russia,Poland,0,0,0,0,20/06/2021,0,0,7,7,0,0,0,0,0,0,0,0,12,3,13,28,5,0,0,5
2119,152233,2021,China,Poland,0,0,0,0,19/06/2021,0,0,8,8,0,0,0,0,0,0,0,0,10,1,6,17,3,0,0,3
2120,152233,2021,Poland,USA,0,0,0,0,18/06/2021,0,0,11,11,0,0,0,0,0,0,0,0,8,1,5,14,6,3,0,9
2121,152233,2021,Germany,Poland,0,0,0,0,14/06/2021,0,0,10,10,0,0,0,0,0,0,0,0,6,3,8,17,9,1,0,10
2122,152233,2021,Thailand,Poland,0,0,0,0,13/06/2021,0,0,18,18,0,0,0,0,0,0,0,0,2,0,19,21,14,1,0,15
2123,152233,2021,Poland,Brazil,0,0,0,0,12/06/2021,0,0,9,9,0,0,0,0,0,0,0,0,10,0,7,17,10,1,0,11
2124,152233,2021,Japan,Poland,0,0,0,0,08/06/2021,0,0,12,12,0,0,0,0,0,0,0,0,10,0,13,23,10,3,1,14
2125,152233,2021,Poland,Netherlands,0,0,0,0,07/06/2021,0,0,8,8,0,0,0,0,0,0,0,0,13,1,20,34,4,1,0,5
2126,152233,2021,Canada,Poland,0,0,0,0,06/06/2021,1,0,8,9,0,0,0,0,0,0,0,0,13,1,12,26,3,2,0,5
2127,152233,2021,Poland,Dominican Republic,0,0,0,0,02/06/2021,0,0,13,13,0,0,0,0,0,0,0,0,14,1,11,26,10,3,3,16
2128,152233,2021,Belgium,Poland,0,0,0,0,01/06/2021,0,0,16,16,0,0,0,0,0,0,0,0,5,4,26,35,10,0,1,11
2129,152233,2021,Korea,Poland,0,0,0,0,31/05/2021,0,0,2,2,0,0,0,0,0,0,0,0,6,0,11,17,4,2,1,7
2130,152233,2021,Poland,Türkiye,0,0,0,0,27/05/2021,0,0,7,7,0,0,0,0,0,0,0,0,7,0,13,20,7,2,0,9
2131,152233,2021,Serbia,Poland,0,0,0,0,26/05/2021,0,0,8,8,0,0,0,0,0,0,0,0,18,0,14,32,5,3,0,8
2132,152233,2021,Italy,Poland,0,0,0,0,25/05/2021,0,0,5,5,0,0,0,0,0,0,0,0,13,2,16,31,8,2,0,10
2133,152217,2021,Russia,Poland,0,1,5,6,20/06/2021,0,0,1,1,25,10,19,54,1,2,1,4,0,0,0,0,6,2,4,12
2134,152217,2021,China,Poland,0,2,5,7,19/06/2021,0,0,1,1,15,4,10,29,1,6,1,8,0,0,0,0,4,1,0,5
2135,152217,2021,Poland,USA,1,3,13,17,18/06/2021,0,0,1,1,15,10,14,39,1,1,3,5,5,3,10,18,6,3,2,11
2136,152217,2021,Germany,Poland,0,3,5,8,14/06/2021,0,0,0,0,13,7,3,23,0,1,0,1,1,0,4,5,2,2,0,4
2137,152217,2021,Thailand,Poland,1,2,12,15,13/06/2021,0,0,1,1,14,2,11,27,1,2,2,5,0,0,0,0,10,1,2,13
2138,152217,2021,Poland,Brazil,2,5,6,13,12/06/2021,0,0,1,1,9,9,15,33,3,1,0,4,3,0,12,15,2,1,0,3
2139,152217,2021,Japan,Poland,0,4,12,16,08/06/2021,0,0,2,2,33,8,17,58,2,4,1,7,0,0,0,0,14,3,2,19
2140,152217,2021,Poland,Netherlands,0,1,0,1,07/06/2021,0,0,1,1,8,2,5,15,0,2,0,2,0,0,0,0,0,0,0,0
2141,152217,2021,Canada,Poland,1,3,3,7,06/06/2021,0,0,0,0,7,3,7,17,0,1,0,1,1,1,3,5,3,1,1,5
2142,152217,2021,Poland,Dominican Republic,1,4,7,12,02/06/2021,0,0,2,2,21,12,27,60,4,7,5,16,0,0,0,0,14,1,1,16
2143,152217,2021,Belgium,Poland,0,2,13,15,01/06/2021,0,0,1,1,19,11,17,47,2,3,1,6,0,2,11,13,4,4,1,9
2144,152217,2021,Korea,Poland,0,2,8,10,31/05/2021,0,0,0,0,16,3,6,25,1,1,0,2,4,0,7,11,3,2,0,5
2145,152217,2021,Poland,Türkiye,5,4,10,19,27/05/2021,0,0,0,0,19,8,13,40,2,1,1,4,4,2,21,27,5,1,0,6
2146,152217,2021,Serbia,Poland,4,3,15,22,26/05/2021,0,0,1,1,10,9,13,32,1,0,2,3,3,0,6,9,9,0,0,9
2147,152217,2021,Italy,Poland,1,6,9,16,25/05/2021,0,0,2,2,21,6,25,52,3,3,2,8,6,1,10,17,6,2,0,8
2148,119138,2021,Russia,Poland,0,0,11,11,20/06/2021,0,0,0,0,5,1,2,8,3,4,5,12,0,0,0,0,3,1,0,4
2149,119138,2021,China,Poland,0,0,7,7,19/06/2021,0,0,2,2,2,0,1,3,0,2,0,2,0,0,3,3,1,0,0,1
2150,119138,2021,Poland,USA,0,1,6,7,18/06/2021,0,0,0,0,5,1,6,12,1,5,2,8,0,0,0,0,1,1,0,2
2151,119138,2021,Germany,Poland,1,0,5,6,14/06/2021,0,0,0,0,2,1,1,4,0,1,1,2,0,1,0,1,1,3,0,4
2152,119138,2021,Thailand,Poland,0,1,5,6,13/06/2021,0,0,0,0,2,0,4,6,1,3,8,12,0,0,0,0,3,0,1,4
2153,119138,2021,Poland,Brazil,1,2,4,7,12/06/2021,0,0,0,0,2,0,5,7,0,2,3,5,0,0,0,0,1,1,0,2
2154,119138,2021,Poland,Netherlands,1,1,11,13,07/06/2021,0,0,0,0,10,1,3,14,2,7,9,18,0,0,0,0,3,0,0,3
2155,119138,2021,Canada,Poland,1,1,10,12,06/06/2021,0,0,1,1,5,0,8,13,4,3,4,11,0,0,0,0,1,1,0,2
2156,119138,2021,Belgium,Poland,2,1,14,17,01/06/2021,0,0,0,0,4,1,4,9,2,5,7,14,0,1,0,1,6,0,0,6
2157,119138,2021,Korea,Poland,0,0,8,8,31/05/2021,0,0,0,0,3,0,3,6,1,4,4,9,0,0,0,0,2,2,1,5
2158,119138,2021,Poland,Türkiye,0,2,12,14,27/05/2021,0,0,0,0,4,1,4,9,1,3,0,4,1,0,0,1,1,0,0,1
2159,119138,2021,Serbia,Poland,0,2,4,6,26/05/2021,0,0,1,1,4,0,1,5,0,1,0,1,0,0,0,0,2,0,0,2
2160,119138,2021,Italy,Poland,2,3,11,16,25/05/2021,0,0,0,0,4,0,2,6,5,3,4,12,1,0,0,1,2,1,0,3
2161,163098,2021,Russia,Poland,3,1,19,23,20/06/2021,0,0,2,2,8,4,6,18,3,3,0,6,11,2,16,29,10,2,0,12
2162,163098,2021,China,Poland,3,0,14,17,19/06/2021,0,0,0,0,14,3,11,28,0,4,1,5,2,1,11,14,3,4,0,7
2163,163098,2021,Poland,USA,0,1,9,10,18/06/2021,0,1,1,2,6,6,16,28,1,4,1,6,11,1,24,36,6,3,1,10
2164,163098,2021,Germany,Poland,0,0,5,5,14/06/2021,0,0,0,0,4,2,4,10,1,0,0,1,2,1,3,6,1,2,1,4
2165,163098,2021,Thailand,Poland,0,3,12,15,13/06/2021,0,0,0,0,12,1,12,25,1,3,1,5,3,2,13,18,8,1,2,11
2166,163098,2021,Poland,Brazil,0,0,0,0,12/06/2021,0,0,0,0,0,0,0,0,0,0,0,0,0,0,0,0,0,0,0,0
2167,163098,2021,Japan,Poland,0,2,7,9,08/06/2021,0,0,1,1,3,0,4,7,0,0,3,3,3,0,3,6,4,1,0,5
2168,163098,2021,Poland,Netherlands,2,4,13,19,07/06/2021,0,0,3,3,13,2,19,34,3,5,3,11,3,4,28,35,14,0,1,15
2169,163098,2021,Canada,Poland,1,2,18,21,06/06/2021,0,0,2,2,10,1,15,26,6,1,0,7,5,2,9,16,10,4,1,15
2170,163098,2021,Poland,Dominican Republic,2,1,15,18,02/06/2021,0,0,3,3,10,6,11,27,0,3,1,4,3,1,16,20,10,0,1,11
2171,163098,2021,Belgium,Poland,0,1,12,13,01/06/2021,0,0,0,0,7,5,11,23,1,2,2,5,6,1,27,34,7,2,3,12
2172,163098,2021,Korea,Poland,2,0,9,11,31/05/2021,0,0,3,3,6,3,9,18,0,1,1,2,4,2,10,16,10,3,0,13
2173,163098,2021,Poland,Türkiye,3,0,12,15,27/05/2021,0,0,2,2,6,5,17,28,1,5,0,6,9,1,25,35,5,2,0,7
2174,163098,2021,Serbia,Poland,0,0,0,0,26/05/2021,0,0,0,0,0,0,1,1,0,0,0,0,1,1,1,3,0,0,0,0
2175,163098,2021,Italy,Poland,0,0,1,1,25/05/2021,0,0,0,0,1,0,3,4,0,0,0,0,1,0,0,1,1,0,0,1
2176,164106,2021,Russia,Poland,0,0,0,0,20/06/2021,0,0,5,5,0,0,0,0,0,0,0,0,0,0,0,0,9,0,2,11
2177,164106,2021,China,Poland,0,0,0,0,19/06/2021,0,0,1,1,0,0,0,0,0,0,0,0,0,0,0,0,9,0,1,10
2178,164106,2021,Poland,USA,0,0,0,0,18/06/2021,0,0,6,6,0,0,0,0,0,0,0,0,0,0,0,0,3,1,1,5
2179,164106,2021,Germany,Poland,0,0,0,0,14/06/2021,0,0,0,0,0,0,0,0,0,0,0,0,0,0,0,0,0,0,0,0
2180,164106,2021,Thailand,Poland,0,0,0,0,13/06/2021,0,0,0,0,0,0,0,0,0,0,0,0,0,0,0,0,0,0,0,0
2181,164106,2021,Poland,Brazil,0,0,0,0,12/06/2021,0,0,3,3,0,0,0,0,0,0,0,0,0,0,0,0,6,0,1,7
2182,164106,2021,Japan,Poland,0,0,0,0,08/06/2021,0,0,4,4,0,0,0,0,0,0,0,0,0,0,0,0,6,4,1,11
2183,164106,2021,Poland,Netherlands,0,0,0,0,07/06/2021,0,0,4,4,0,0,0,0,0,0,0,0,0,0,0,0,7,0,1,8
2184,164106,2021,Canada,Poland,0,0,0,0,06/06/2021,0,0,3,3,0,0,0,0,0,0,0,0,0,0,0,0,9,13,0,22
2185,164106,2021,Poland,Dominican Republic,0,0,0,0,02/06/2021,0,0,6,6,0,0,0,0,0,0,0,0,0,0,0,0,4,5,0,9
2186,164106,2021,Belgium,Poland,0,0,0,0,01/06/2021,0,0,6,6,0,0,0,0,0,0,0,0,0,0,0,0,6,8,1,15
2187,164106,2021,Korea,Poland,0,0,0,0,31/05/2021,0,0,2,2,0,0,0,0,0,0,0,0,0,0,0,0,8,4,1,13
2188,164106,2021,Poland,Türkiye,0,0,0,0,27/05/2021,1,0,4,5,0,0,0,0,0,0,0,0,0,0,0,0,5,5,2,12
2189,164106,2021,Serbia,Poland,0,0,0,0,26/05/2021,0,0,1,1,0,0,0,0,0,0,0,0,0,0,0,0,11,5,0,16
2190,164106,2021,Italy,Poland,0,0,0,0,25/05/2021,0,0,5,5,0,0,0,0,0,0,0,0,0,0,0,0,9,7,1,17
2191,143463,2021,Poland,USA,0,1,4,5,18/06/2021,0,0,3,3,7,4,7,18,1,3,5,9,1,0,2,3,8,1,1,10
2192,143463,2021,Germany,Poland,0,0,5,5,14/06/2021,0,0,1,1,7,4,11,22,2,1,6,9,0,1,2,3,5,1,0,6
2193,143463,2021,Thailand,Poland,0,0,0,0,13/06/2021,0,0,0,0,0,0,0,0,0,0,0,0,0,0,0,0,0,0,0,0
2194,143463,2021,Poland,Brazil,0,1,9,10,12/06/2021,0,0,3,3,13,4,22,39,0,3,1,4,0,0,3,3,7,1,2,10
2195,143463,2021,Japan,Poland,0,0,0,0,08/06/2021,0,0,0,0,0,0,0,0,0,0,0,0,0,0,0,0,0,0,0,0
2196,143463,2021,Poland,Netherlands,0,1,7,8,07/06/2021,1,0,2,3,16,8,23,47,3,3,2,8,0,0,0,0,5,1,0,6
2197,143463,2021,Canada,Poland,1,0,12,13,06/06/2021,0,0,0,0,21,6,19,46,1,2,2,5,0,0,3,3,9,4,1,14
2198,143463,2021,Belgium,Poland,0,0,8,8,01/06/2021,0,0,1,1,17,5,28,50,2,4,4,10,0,0,1,1,6,2,4,12
2199,143463,2021,Korea,Poland,1,2,4,7,31/05/2021,0,0,3,3,11,6,9,26,6,1,5,12,2,1,3,6,6,0,1,7
2200,143463,2021,Poland,Türkiye,0,1,8,9,27/05/2021,0,0,2,2,21,4,18,43,2,1,2,5,0,0,1,1,6,1,0,7
2201,143463,2021,Serbia,Poland,0,1,8,9,26/05/2021,0,0,1,1,10,2,12,24,0,3,2,5,0,0,1,1,8,1,0,9
2202,143463,2021,Italy,Poland,1,1,17,19,25/05/2021,0,0,2,2,17,12,22,51,0,4,3,7,0,0,0,0,5,1,1,7
2203,152231,2021,Russia,Poland,0,0,0,0,20/06/2021,0,0,0,0,0,0,0,0,0,0,0,0,0,0,0,0,0,0,0,0
2204,152231,2021,China,Poland,0,0,0,0,19/06/2021,0,0,0,0,0,0,0,0,0,0,0,0,0,0,0,0,0,0,0,0
2205,152231,2021,Poland,USA,0,0,0,0,18/06/2021,0,0,0,0,0,0,0,0,0,0,0,0,0,0,0,0,0,0,0,0
2206,152231,2021,Germany,Poland,0,0,0,0,14/06/2021,0,0,0,0,0,0,0,0,0,0,0,0,0,0,0,0,0,0,0,0
2207,152231,2021,Thailand,Poland,0,0,0,0,13/06/2021,0,0,0,0,0,0,0,0,0,0,0,0,0,0,0,0,0,0,0,0
2208,152231,2021,Poland,Brazil,0,0,0,0,12/06/2021,0,0,0,0,0,0,0,0,0,0,0,0,0,0,0,0,0,0,0,0
2209,152231,2021,Japan,Poland,0,0,0,0,08/06/2021,0,0,0,0,0,0,0,0,0,0,0,0,0,0,0,0,0,0,0,0
2210,152231,2021,Canada,Poland,0,0,0,0,06/06/2021,0,0,0,0,0,0,0,0,0,0,0,0,0,0,0,0,0,0,0,0
2211,152231,2021,Poland,Dominican Republic,0,0,0,0,02/06/2021,0,0,0,0,0,0,0,0,0,0,0,0,0,0,0,0,0,0,0,0
2212,152231,2021,Belgium,Poland,0,0,1,1,01/06/2021,0,0,0,0,0,0,3,3,0,1,0,1,1,0,8,9,2,2,0,4
2213,152231,2021,Korea,Poland,0,0,0,0,31/05/2021,0,0,1,1,0,1,2,3,0,0,0,0,1,0,1,2,1,0,0,1
2214,152231,2021,Poland,Türkiye,0,0,0,0,27/05/2021,0,0,0,0,1,0,0,1,0,0,0,0,1,1,4,6,0,0,0,0
2215,152231,2021,Serbia,Poland,0,0,8,8,26/05/2021,0,0,0,0,5,2,8,15,0,2,1,3,9,1,7,17,5,2,0,7
2216,152231,2021,Italy,Poland,0,1,0,1,25/05/2021,0,0,0,0,0,0,0,0,0,0,0,0,0,0,0,0,0,0,0,0
2217,181268,2021,Russia,Poland,0,0,0,0,20/06/2021,0,0,1,1,4,1,4,9,0,0,0,0,0,0,0,0,0,0,0,0
2218,181268,2021,China,Poland,0,0,0,0,19/06/2021,0,0,0,0,2,0,1,3,0,0,0,0,0,0,0,0,0,0,0,0
2219,181268,2021,Poland,USA,0,0,0,0,18/06/2021,0,0,1,1,3,0,5,8,0,1,0,1,0,0,1,1,1,0,0,1
2220,181268,2021,Germany,Poland,0,1,0,1,14/06/2021,0,0,0,0,1,0,2,3,0,1,0,1,1,0,1,2,0,1,0,1
2221,181268,2021,Thailand,Poland,0,0,0,0,13/06/2021,0,0,0,0,1,1,1,3,1,0,0,1,0,0,0,0,2,1,0,3
2222,181268,2021,Poland,Brazil,0,1,6,7,12/06/2021,0,0,0,0,3,4,9,16,4,1,3,8,6,1,17,24,4,3,0,7
2223,181268,2021,Japan,Poland,0,0,0,0,08/06/2021,0,0,0,0,0,0,0,0,0,0,0,0,0,0,0,0,0,0,0,0
2224,181268,2021,Poland,Netherlands,0,0,17,17,07/06/2021,0,0,2,2,11,3,12,26,1,2,6,9,3,1,19,23,14,5,4,23
2225,181268,2021,Canada,Poland,0,0,0,0,06/06/2021,0,0,0,0,0,0,0,0,0,0,0,0,0,0,0,0,0,0,0,0
2226,181268,2021,Poland,Dominican Republic,0,0,0,0,02/06/2021,0,0,0,0,0,0,0,0,0,0,0,0,0,0,0,0,0,0,0,0
2227,181268,2021,Belgium,Poland,0,0,0,0,01/06/2021,0,0,0,0,1,0,4,5,0,2,0,2,0,0,0,0,0,0,0,0
2228,181268,2021,Poland,Türkiye,0,0,0,0,27/05/2021,0,0,0,0,0,0,0,0,0,0,0,0,0,0,0,0,0,0,0,0
2229,181268,2021,Serbia,Poland,0,0,1,1,26/05/2021,0,0,0,0,3,1,1,5,0,0,0,0,0,0,0,0,0,1,0,1
2230,181268,2021,Italy,Poland,0,0,0,0,25/05/2021,0,0,0,0,0,0,0,0,0,0,0,0,0,0,0,0,0,0,0,0
2231,181267,2021,China,Poland,0,0,0,0,19/06/2021,0,0,0,0,0,0,0,0,0,0,0,0,0,0,0,0,0,0,0,0
2232,181267,2021,Poland,Netherlands,0,0,0,0,07/06/2021,0,0,0,0,0,0,0,0,0,0,0,0,0,0,0,0,0,0,0,0
2233,181267,2021,Poland,Dominican Republic,0,0,0,0,02/06/2021,0,0,3,3,0,0,0,0,0,0,0,0,0,0,0,0,0,0,0,0
2234,181267,2021,Poland,Türkiye,0,0,0,0,27/05/2021,0,0,0,0,0,0,0,0,0,0,0,0,0,0,0,0,0,0,0,0
2235,181273,2021,,,-,-,-,-,-,-,-,-,-,-,-,-,-,-,-,-,-,-,-,-,-,-,-,-,-
2236,181263,2021,Russia,Poland,1,1,23,25,20/06/2021,23,1,72,96,1,0,1,2,0,4,2,6,0,0,0,0,1,2,0,3
2237,181263,2021,China,Poland,0,0,15,15,19/06/2021,11,0,64,75,0,0,2,2,0,1,0,1,0,0,0,0,4,0,0,4
2238,181263,2021,Poland,USA,1,1,11,13,18/06/2021,10,0,63,73,1,0,1,2,1,0,3,4,0,0,0,0,7,4,2,13
2239,181263,2021,Germany,Poland,0,1,9,10,14/06/2021,10,1,51,62,1,0,1,2,0,0,2,2,0,0,0,0,3,4,2,9
2240,181263,2021,Thailand,Poland,0,1,11,12,13/06/2021,24,1,44,69,1,0,1,2,0,2,2,4,0,0,0,0,7,4,2,13
2241,181263,2021,Poland,Brazil,1,4,10,15,12/06/2021,11,0,73,84,1,0,0,1,0,0,0,0,0,0,0,0,9,3,0,12
2242,173996,2021,Japan,Poland,0,0,0,0,08/06/2021,0,0,2,2,0,0,0,0,1,1,1,3,0,0,0,0,0,0,0,0
2243,173996,2021,Poland,Netherlands,0,0,7,7,07/06/2021,3,0,19,22,0,0,0,0,0,1,0,1,0,0,0,0,0,1,0,1
2244,173996,2021,Canada,Poland,0,1,0,1,06/06/2021,3,0,16,19,1,0,1,2,0,0,0,0,0,0,0,0,1,1,0,2
2245,173996,2021,Poland,Dominican Republic,0,0,1,1,02/06/2021,0,0,0,0,0,0,0,0,0,0,0,0,0,0,0,0,0,0,0,0
2246,173996,2021,Belgium,Poland,0,1,1,2,01/06/2021,3,0,6,9,0,0,0,0,0,0,0,0,0,0,0,0,2,0,0,2
2247,173996,2021,Korea,Poland,0,0,2,2,31/05/2021,2,1,7,10,0,0,0,0,0,0,0,0,0,0,0,0,0,0,0,0
2248,173996,2021,Poland,Türkiye,0,0,2,2,27/05/2021,1,0,2,3,0,0,0,0,0,0,0,0,0,0,0,0,0,0,0,0
2249,173996,2021,Serbia,Poland,0,0,7,7,26/05/2021,4,2,40,46,2,1,0,3,0,2,1,3,0,0,0,0,2,3,0,5
2250,173996,2021,Italy,Poland,0,0,1,1,25/05/2021,1,0,10,11,0,0,0,0,0,0,0,0,0,0,0,0,0,0,0,0
2251,151231,2021,Russia,Poland,0,0,0,0,20/06/2021,0,0,0,0,0,0,0,0,0,0,0,0,0,0,0,0,0,0,0,0
2252,151231,2021,China,Poland,0,0,0,0,19/06/2021,0,0,0,0,0,0,2,2,0,0,1,1,0,0,1,1,0,0,1,1
2253,151231,2021,Germany,Poland,0,0,0,0,14/06/2021,0,0,0,0,0,0,0,0,0,0,0,0,0,0,0,0,0,0,0,0
2254,151231,2021,Thailand,Poland,0,0,0,0,13/06/2021,0,0,0,0,0,0,0,0,0,0,0,0,0,0,0,0,0,0,0,0
2255,151231,2021,Poland,Brazil,0,0,0,0,12/06/2021,0,0,0,0,0,1,1,2,0,0,0,0,0,0,0,0,0,0,0,0
2256,151231,2021,Japan,Poland,0,2,7,9,08/06/2021,0,0,0,0,9,3,14,26,3,0,2,5,1,1,12,14,5,3,2,10
2257,151231,2021,Poland,Netherlands,0,0,0,0,07/06/2021,0,0,0,0,0,0,0,0,0,0,0,0,0,0,0,0,0,0,0,0
2258,151231,2021,Poland,Dominican Republic,0,0,0,0,02/06/2021,0,0,0,0,0,2,1,3,0,0,0,0,0,0,0,0,1,0,0,1
2259,151231,2021,Belgium,Poland,0,0,0,0,01/06/2021,0,0,0,0,0,1,0,1,0,0,0,0,0,0,0,0,0,0,0,0
2260,151231,2021,Korea,Poland,0,0,0,0,31/05/2021,0,0,0,0,4,0,0,4,0,2,0,2,0,0,0,0,0,0,0,0
2261,151231,2021,Poland,Türkiye,0,0,0,0,27/05/2021,0,0,1,1,1,0,0,1,0,0,0,0,0,0,0,0,0,0,0,0
2262,151231,2021,Serbia,Poland,0,0,0,0,26/05/2021,0,0,0,0,0,0,0,0,0,0,0,0,0,0,0,0,0,0,0,0
2263,151231,2021,Italy,Poland,0,0,0,0,25/05/2021,0,0,0,0,0,0,0,0,0,0,0,0,0,1,1,2,0,0,0,0
2264,163097,2021,Russia,Poland,0,0,0,0,20/06/2021,0,0,0,0,0,0,0,0,0,0,0,0,0,0,0,0,0,0,0,0
2265,163097,2021,Poland,USA,0,0,0,0,18/06/2021,0,0,0,0,0,0,0,0,0,0,0,0,0,0,0,0,0,0,0,0
2266,163097,2021,Germany,Poland,0,0,3,3,14/06/2021,0,0,0,0,2,0,2,4,1,2,2,5,0,0,0,0,1,1,0,2
2267,163097,2021,Thailand,Poland,1,1,3,5,13/06/2021,0,0,0,0,3,0,3,6,0,1,4,5,0,0,1,1,0,0,0,0
2268,163097,2021,Poland,Brazil,0,0,0,0,12/06/2021,0,0,0,0,0,0,0,0,0,0,0,0,0,0,0,0,0,0,0,0
2269,163097,2021,Japan,Poland,0,0,0,0,08/06/2021,0,0,0,0,0,0,0,0,0,1,0,1,0,0,0,0,0,0,0,0
2270,163097,2021,Canada,Poland,0,0,0,0,06/06/2021,0,0,0,0,0,0,0,0,0,0,0,0,0,0,0,0,0,0,0,0
2271,163097,2021,Poland,Dominican Republic,0,0,0,0,02/06/2021,0,0,0,0,0,0,0,0,0,0,0,0,0,0,0,0,0,0,0,0
2272,163097,2021,Korea,Poland,0,0,1,1,31/05/2021,0,0,0,0,0,0,0,0,0,0,0,0,0,0,0,0,0,0,0,0
2273,163097,2021,Poland,Türkiye,0,0,0,0,27/05/2021,0,0,0,0,0,0,0,0,0,0,0,0,0,0,0,0,0,0,0,0
2274,152223,2021,Russia,Poland,1,0,12,13,20/06/2021,1,0,2,3,13,4,10,27,3,4,3,10,5,1,18,24,7,3,2,12
2275,152223,2021,China,Poland,0,1,8,9,19/06/2021,0,0,2,2,8,1,13,22,0,4,0,4,14,2,19,35,4,4,1,9
2276,152223,2021,Poland,USA,0,0,0,0,18/06/2021,0,0,0,0,0,0,0,0,0,0,0,0,0,0,0,0,0,0,0,0
2277,152223,2021,Germany,Poland,1,0,8,9,14/06/2021,0,0,4,4,6,0,6,12,2,1,0,3,9,2,19,30,9,3,1,13
2278,152223,2021,Thailand,Poland,1,2,9,12,13/06/2021,0,0,1,1,15,0,15,30,2,2,1,5,5,0,9,14,11,1,1,13
2279,152223,2021,Poland,Brazil,0,0,1,1,12/06/2021,0,0,1,1,1,2,0,3,0,0,0,0,0,0,6,6,2,0,0,2
2280,152223,2021,Japan,Poland,0,1,17,18,08/06/2021,0,0,4,4,15,2,19,36,4,1,1,6,14,4,39,57,13,4,1,18
2281,152223,2021,Poland,Netherlands,0,0,0,0,07/06/2021,0,0,0,0,0,0,0,0,0,0,0,0,0,1,2,3,0,0,0,0
2282,152223,2021,Canada,Poland,2,1,15,18,06/06/2021,0,0,0,0,6,6,10,22,1,1,0,2,13,1,16,30,3,3,0,6
2283,152223,2021,Poland,Dominican Republic,1,0,11,12,02/06/2021,0,0,1,1,11,0,21,32,0,1,4,5,13,4,24,41,9,1,2,12
2284,152223,2021,Belgium,Poland,0,0,1,1,01/06/2021,0,0,0,0,1,0,1,2,0,0,0,0,0,0,4,4,2,0,1,3
2285,152223,2021,Korea,Poland,0,0,0,0,31/05/2021,0,0,0,0,0,0,0,0,0,0,0,0,0,0,0,0,0,0,0,0
2286,152223,2021,Serbia,Poland,0,1,4,5,26/05/2021,0,0,0,0,2,4,8,14,0,4,1,5,5,1,11,17,2,1,0,3
2287,152223,2021,Italy,Poland,1,2,11,14,25/05/2021,0,0,0,0,9,5,10,24,1,0,3,4,10,6,30,46,14,3,3,20
2288,142377,2021,Japan,Russia,0,0,0,0,02/06/2021,0,0,0,0,0,0,0,0,0,0,0,0,0,0,0,0,0,0,0,0
2289,142377,2021,Brazil,Russia,0,1,6,7,01/06/2021,0,0,1,1,2,0,4,6,0,1,1,2,0,0,0,0,2,0,0,2
2290,142377,2021,Russia,Italy,0,0,0,0,31/05/2021,0,0,0,0,0,0,0,0,0,0,0,0,0,0,0,0,0,0,0,0
2291,142377,2021,Russia,Netherlands,1,2,7,10,27/05/2021,0,0,0,0,2,1,3,6,3,2,3,8,0,0,0,0,0,1,0,1
2292,142377,2021,Belgium,Russia,0,1,0,1,26/05/2021,0,0,0,0,0,0,1,1,0,1,2,3,0,0,0,0,0,0,0,0
2293,142377,2021,Germany,Russia,0,0,0,0,25/05/2021,0,0,0,0,0,0,0,0,0,0,0,0,0,0,0,0,0,0,0,0
2294,119361,2021,Russia,Poland,0,0,0,0,20/06/2021,0,0,5,5,0,0,0,0,0,0,0,0,3,2,12,17,6,2,1,9
2295,119361,2021,USA,Russia,0,0,0,0,19/06/2021,0,0,5,5,0,0,0,0,0,0,0,0,2,1,5,8,3,2,2,7
2296,119361,2021,China,Russia,0,0,0,0,18/06/2021,0,0,0,0,0,0,0,0,0,0,0,0,0,0,0,0,0,0,0,0
2297,119361,2021,Russia,Serbia,0,0,0,0,14/06/2021,0,0,0,0,0,0,0,0,0,0,0,0,0,0,1,1,3,1,1,5
2298,119361,2021,Russia,Canada,0,0,0,0,13/06/2021,0,0,0,0,0,0,0,0,0,0,0,0,0,0,0,0,0,0,0,0
2299,119361,2021,Russia,Korea,0,0,0,0,12/06/2021,0,0,0,0,0,0,0,0,0,0,0,0,0,0,0,0,0,0,0,0
2300,119361,2021,Türkiye,Russia,0,0,0,0,08/06/2021,0,0,6,6,0,0,0,0,0,0,0,0,7,5,12,24,10,5,4,19
2301,119361,2021,Russia,Thailand,0,0,0,0,07/06/2021,0,0,9,9,0,0,0,0,0,0,0,0,5,0,13,18,10,5,3,18
2302,119361,2021,Dominican Republic,Russia,0,0,0,0,06/06/2021,0,0,8,8,0,0,0,0,0,0,0,0,11,1,15,27,22,4,1,27
2303,119361,2021,Japan,Russia,0,0,0,0,02/06/2021,0,0,8,8,0,0,0,0,0,0,0,0,6,1,14,21,10,6,0,16
2304,119361,2021,Brazil,Russia,0,0,0,0,01/06/2021,0,0,6,6,0,0,0,0,0,0,0,0,2,2,4,8,10,3,1,14
2305,119361,2021,Russia,Italy,0,0,0,0,31/05/2021,0,0,5,5,0,0,0,0,0,0,0,0,3,1,10,14,12,5,0,17
2306,119361,2021,Russia,Netherlands,0,0,0,0,27/05/2021,0,0,2,2,0,0,0,0,0,0,0,0,1,0,5,6,1,2,1,4
2307,119361,2021,Belgium,Russia,0,0,0,0,26/05/2021,0,0,6,6,0,0,0,0,0,0,0,0,3,0,5,8,5,3,0,8
2308,119361,2021,Germany,Russia,0,0,0,0,25/05/2021,0,0,0,0,0,0,0,0,0,0,0,0,1,1,1,3,4,0,0,4
2309,175202,2021,Russia,Poland,2,2,19,23,20/06/2021,0,0,2,2,15,9,8,32,0,4,2,6,13,3,20,36,1,3,2,6
2310,175202,2021,USA,Russia,1,3,11,15,19/06/2021,0,0,2,2,13,3,17,33,0,1,2,3,9,7,19,35,6,1,1,8
2311,175202,2021,China,Russia,1,1,5,7,18/06/2021,0,0,0,0,8,5,8,21,0,0,0,0,1,1,13,15,0,3,1,4
2312,175202,2021,Russia,Serbia,3,0,7,10,14/06/2021,0,0,2,2,8,2,3,13,1,0,0,1,2,0,6,8,1,0,0,1
2313,175202,2021,Russia,Canada,2,2,6,10,13/06/2021,0,0,1,1,13,0,6,19,1,1,0,2,4,0,11,15,6,0,2,8
2314,175202,2021,Russia,Korea,0,1,8,9,12/06/2021,0,0,2,2,10,3,10,23,2,1,4,7,4,6,7,17,1,1,0,2
2315,175202,2021,Türkiye,Russia,1,2,12,15,08/06/2021,0,0,1,1,11,5,11,27,1,0,0,1,6,3,19,28,5,4,4,13
2316,175202,2021,Russia,Thailand,3,2,17,22,07/06/2021,0,0,1,1,16,3,12,31,1,2,5,8,6,3,13,22,4,1,4,9
2317,175202,2021,Dominican Republic,Russia,0,3,17,20,06/06/2021,0,1,3,4,18,7,22,47,2,2,2,6,11,1,23,35,8,1,2,11
2318,175202,2021,Japan,Russia,0,2,4,6,02/06/2021,0,0,1,1,4,1,5,10,0,0,0,0,2,2,6,10,1,0,0,1
2319,175202,2021,Brazil,Russia,0,1,6,7,01/06/2021,0,0,0,0,6,4,10,20,1,2,0,3,1,2,3,6,3,2,1,6
2320,175202,2021,Russia,Italy,3,0,7,10,31/05/2021,0,0,0,0,13,2,9,24,2,2,0,4,3,0,5,8,3,1,0,4
2321,175202,2021,Russia,Netherlands,1,2,9,12,27/05/2021,0,1,1,2,14,2,9,25,3,0,0,3,9,1,17,27,2,2,0,4
2322,175202,2021,Belgium,Russia,0,1,14,15,26/05/2021,0,0,0,0,10,3,7,20,0,0,2,2,4,3,14,21,4,1,1,6
2323,175202,2021,Germany,Russia,0,1,3,4,25/05/2021,0,0,0,0,0,0,0,0,0,0,1,1,0,1,1,2,1,0,0,1
2324,168181,2021,Russia,Poland,1,0,7,8,20/06/2021,0,0,1,1,11,2,4,17,5,3,8,16,0,0,1,1,0,2,2,4
2325,168181,2021,USA,Russia,0,0,10,10,19/06/2021,0,1,0,1,7,0,2,9,3,5,9,17,0,0,1,1,1,3,2,6
2326,168181,2021,China,Russia,1,0,9,10,18/06/2021,0,0,1,1,3,3,2,8,1,3,4,8,0,0,1,1,2,1,6,9
2327,168181,2021,Russia,Serbia,4,0,10,14,14/06/2021,0,0,0,0,3,2,4,9,4,1,4,9,1,0,0,1,3,0,0,3
2328,168181,2021,Russia,Canada,2,0,7,9,13/06/2021,0,0,2,2,6,1,2,9,1,3,7,11,0,0,0,0,1,0,2,3
2329,168181,2021,Russia,Korea,0,2,3,5,12/06/2021,0,0,0,0,3,0,5,8,4,4,4,12,0,0,0,0,2,0,0,2
2330,168181,2021,Türkiye,Russia,0,2,11,13,08/06/2021,0,0,1,1,3,0,5,8,5,7,3,15,0,0,1,1,2,1,0,3
2331,168181,2021,Russia,Thailand,1,0,14,15,07/06/2021,0,0,0,0,8,0,4,12,2,5,9,16,0,0,0,0,3,0,0,3
2332,168181,2021,Dominican Republic,Russia,0,0,15,15,06/06/2021,0,0,4,4,6,1,3,10,4,11,19,34,0,0,0,0,4,1,2,7
2333,168181,2021,Japan,Russia,0,0,8,8,02/06/2021,0,0,0,0,5,0,5,10,1,3,1,5,0,0,0,0,1,0,0,1
2334,168181,2021,Brazil,Russia,0,0,7,7,01/06/2021,0,0,1,1,0,0,2,2,1,1,1,3,0,1,1,2,1,1,0,2
2335,168181,2021,Russia,Italy,0,1,8,9,31/05/2021,0,0,0,0,4,0,3,7,2,4,2,8,0,0,0,0,2,0,0,2
2336,168181,2021,Russia,Netherlands,0,1,2,3,27/05/2021,0,0,0,0,1,0,0,1,0,1,0,1,0,0,0,0,0,0,0,0
2337,168181,2021,Belgium,Russia,0,0,10,10,26/05/2021,0,0,0,0,7,2,5,14,4,5,8,17,0,0,0,0,8,0,0,8
2338,168181,2021,Germany,Russia,2,0,7,9,25/05/2021,0,0,0,0,5,1,2,8,1,6,2,9,0,0,0,0,1,0,0,1
2339,132071,2021,Russia,Poland,0,0,0,0,20/06/2021,0,0,0,0,0,0,0,0,0,0,0,0,0,0,0,0,0,0,0,0
2340,132071,2021,USA,Russia,0,0,9,9,19/06/2021,0,0,0,0,12,5,14,31,1,2,4,7,0,0,1,1,6,3,3,12
2341,132071,2021,China,Russia,1,0,9,10,18/06/2021,0,0,7,7,13,2,15,30,0,1,2,3,0,0,0,0,8,2,2,12
2342,132071,2021,Russia,Serbia,0,0,5,5,14/06/2021,0,0,1,1,7,0,2,9,1,2,0,3,0,0,0,0,2,0,0,2
2343,132071,2021,Russia,Canada,1,1,9,11,13/06/2021,0,0,0,0,5,1,6,12,1,0,0,1,0,0,0,0,5,2,2,9
2344,132071,2021,Russia,Korea,0,0,10,10,12/06/2021,0,0,3,3,8,2,16,26,1,0,4,5,0,0,0,0,8,1,1,10
2345,132071,2021,Türkiye,Russia,0,2,10,12,08/06/2021,0,0,3,3,13,7,9,29,1,3,2,6,0,0,0,0,6,1,1,8
2346,132071,2021,Russia,Thailand,1,2,10,13,07/06/2021,0,0,1,1,14,2,15,31,4,1,5,10,0,0,1,1,8,2,1,11
2347,132071,2021,Dominican Republic,Russia,0,1,14,15,06/06/2021,0,0,3,3,30,7,21,58,1,0,8,9,0,0,0,0,13,3,2,18
2348,132071,2021,Japan,Russia,0,0,10,10,02/06/2021,0,0,0,0,12,2,21,35,1,4,1,6,0,0,0,0,3,3,0,6
2349,132071,2021,Russia,Italy,0,0,5,5,31/05/2021,0,0,1,1,7,3,11,21,3,0,5,8,0,0,0,0,1,1,0,2
2350,132071,2021,Russia,Netherlands,0,0,1,1,27/05/2021,0,1,0,1,3,1,2,6,0,0,0,0,0,0,1,1,3,0,0,3
2351,132071,2021,Belgium,Russia,1,1,13,15,26/05/2021,0,0,1,1,20,5,23,48,3,1,3,7,0,0,0,0,10,0,2,12
2352,132071,2021,Germany,Russia,0,0,14,14,25/05/2021,0,0,1,1,18,3,10,31,2,3,6,11,0,0,0,0,5,0,0,5
2353,173154,2021,Türkiye,Russia,0,0,0,0,08/06/2021,0,0,0,0,0,0,0,0,0,0,0,0,0,0,0,0,0,0,0,0
2354,173154,2021,Russia,Thailand,0,0,0,0,07/06/2021,0,0,0,0,0,0,0,0,0,0,0,0,0,0,0,0,0,0,0,0
2355,173154,2021,Dominican Republic,Russia,0,0,0,0,06/06/2021,0,0,0,0,0,0,0,0,0,0,0,0,0,0,0,0,0,0,0,0
2356,173154,2021,Brazil,Russia,0,0,0,0,01/06/2021,0,0,0,0,0,0,0,0,0,0,0,0,0,0,0,0,0,0,0,0
2357,173154,2021,Belgium,Russia,0,0,1,1,26/05/2021,0,0,0,0,0,0,3,3,0,0,0,0,0,0,1,1,1,0,0,1
2358,164015,2021,Russia,Poland,0,1,7,8,20/06/2021,9,0,34,43,1,0,0,1,1,1,1,3,0,0,0,0,4,4,1,9
2359,164015,2021,USA,Russia,0,2,1,3,19/06/2021,0,0,12,12,0,0,0,0,0,0,0,0,0,0,1,1,0,0,0,0
2360,164015,2021,China,Russia,0,1,1,2,18/06/2021,0,0,23,23,0,0,0,0,0,2,0,2,0,0,0,0,0,0,0,0
2361,164015,2021,Russia,Canada,0,0,1,1,13/06/2021,1,0,8,9,0,0,0,0,1,0,0,1,0,0,0,0,2,0,1,3
2362,164015,2021,Russia,Korea,0,0,0,0,12/06/2021,0,0,0,0,0,0,0,0,0,0,0,0,0,0,0,0,0,0,0,0
2363,164015,2021,Türkiye,Russia,0,0,1,1,08/06/2021,0,0,13,13,0,0,1,1,0,1,1,2,0,0,0,0,1,1,2,4
2364,164015,2021,Russia,Thailand,1,3,10,14,07/06/2021,14,2,62,78,4,0,1,5,2,0,1,3,0,0,0,0,7,2,0,9
2365,164015,2021,Dominican Republic,Russia,0,0,9,9,06/06/2021,13,0,64,77,0,1,0,1,0,4,3,7,0,0,0,0,8,2,0,10
2366,164015,2021,Japan,Russia,0,0,0,0,02/06/2021,0,0,0,0,0,0,0,0,0,0,0,0,0,0,0,0,0,0,0,0
2367,164015,2021,Brazil,Russia,0,0,2,2,01/06/2021,3,0,40,43,0,0,2,2,0,0,0,0,0,0,1,1,4,2,0,6
2368,164015,2021,Belgium,Russia,0,0,0,0,26/05/2021,0,0,16,16,0,0,0,0,0,0,1,1,0,0,0,0,0,0,0,0
2369,163842,2021,Russia,Poland,0,1,11,12,20/06/2021,0,0,1,1,5,1,2,8,2,3,4,9,1,0,0,1,1,0,0,1
2370,163842,2021,USA,Russia,1,0,7,8,19/06/2021,0,0,1,1,1,0,1,2,2,2,1,5,0,0,0,0,2,1,1,4
2371,163842,2021,China,Russia,0,0,0,0,18/06/2021,0,0,0,0,0,0,0,0,0,0,0,0,0,0,0,0,0,0,0,0
2372,163842,2021,Russia,Serbia,0,0,0,0,14/06/2021,0,0,0,0,0,0,0,0,0,0,0,0,0,0,0,0,0,0,0,0
2373,163842,2021,Russia,Canada,0,0,0,0,13/06/2021,0,0,0,0,0,0,0,0,0,0,0,0,0,0,0,0,0,0,0,0
2374,163842,2021,Russia,Korea,0,0,3,3,12/06/2021,0,0,1,1,2,0,1,3,0,1,2,3,0,0,0,0,1,0,0,1
2375,163842,2021,Türkiye,Russia,0,0,0,0,08/06/2021,0,0,0,0,0,0,0,0,0,0,0,0,0,0,0,0,0,0,0,0
2376,163842,2021,Russia,Thailand,0,0,1,1,07/06/2021,0,0,0,0,2,0,0,2,0,0,0,0,0,0,0,0,0,0,0,0
2377,163842,2021,Dominican Republic,Russia,0,0,0,0,06/06/2021,0,0,1,1,0,0,2,2,0,1,1,2,0,0,0,0,0,0,0,0
2378,163842,2021,Japan,Russia,0,0,0,0,02/06/2021,0,0,0,0,0,0,0,0,0,0,0,0,0,0,0,0,0,0,0,0
2379,163842,2021,Brazil,Russia,0,0,2,2,01/06/2021,0,0,0,0,1,0,2,3,2,2,1,5,0,0,0,0,1,0,0,1
2380,163842,2021,Russia,Italy,0,0,0,0,31/05/2021,0,0,0,0,0,0,0,0,0,0,0,0,0,0,0,0,0,0,0,0
2381,163842,2021,Russia,Netherlands,1,0,8,9,27/05/2021,0,0,0,0,5,0,6,11,1,6,0,7,0,0,0,0,0,0,0,0
2382,163842,2021,Belgium,Russia,0,0,1,1,26/05/2021,0,0,0,0,0,1,0,1,0,0,0,0,0,0,0,0,0,0,0,0
2383,163842,2021,Germany,Russia,0,0,8,8,25/05/2021,0,0,0,0,0,1,0,1,0,1,0,1,0,0,0,0,0,0,0,0
2384,153448,2021,Russia,Poland,0,1,5,6,20/06/2021,0,0,1,1,7,6,6,19,2,0,1,3,0,0,0,0,3,2,0,5
2385,153448,2021,USA,Russia,0,1,4,5,19/06/2021,0,0,0,0,1,1,3,5,0,1,1,2,0,0,0,0,0,0,0,0
2386,153448,2021,China,Russia,0,0,0,0,18/06/2021,0,0,0,0,1,1,0,2,0,1,0,1,0,0,0,0,0,0,0,0
2387,153448,2021,Russia,Serbia,0,1,2,3,14/06/2021,0,0,0,0,5,4,9,18,0,2,2,4,0,0,0,0,3,2,0,5
2388,153448,2021,Russia,Canada,0,0,2,2,13/06/2021,0,0,0,0,4,0,4,8,0,1,1,2,0,0,0,0,2,0,0,2
2389,153448,2021,Russia,Korea,0,1,0,1,12/06/2021,0,0,0,0,3,0,1,4,0,0,1,1,0,0,0,0,2,0,0,2
2390,119097,2021,Russia,Poland,0,1,2,3,20/06/2021,12,1,54,67,0,0,1,1,0,0,0,0,0,0,0,0,5,3,0,8
2391,119097,2021,USA,Russia,0,0,12,12,19/06/2021,12,1,73,86,3,1,1,5,1,1,2,4,0,0,1,1,9,5,2,16
2392,119097,2021,China,Russia,0,0,4,4,18/06/2021,6,0,61,67,0,0,0,0,0,1,2,3,0,0,0,0,3,0,3,6
2393,119097,2021,Russia,Serbia,0,0,3,3,14/06/2021,3,0,22,25,1,0,0,1,1,1,1,3,0,0,1,1,3,2,1,6
2394,119097,2021,Russia,Canada,0,1,9,10,13/06/2021,8,0,38,46,1,1,0,2,1,1,1,3,0,0,0,0,7,1,0,8
2395,119097,2021,Russia,Korea,1,1,6,8,12/06/2021,12,1,59,72,1,0,0,1,1,0,2,3,0,0,0,0,13,2,1,16
2396,119097,2021,Türkiye,Russia,0,0,12,12,08/06/2021,6,0,74,80,1,0,2,3,0,3,5,8,0,0,0,0,4,3,1,8
2397,119097,2021,Dominican Republic,Russia,0,0,5,5,06/06/2021,5,0,53,58,0,0,2,2,0,0,0,0,0,0,0,0,5,0,0,5
2398,119097,2021,Japan,Russia,1,1,9,11,02/06/2021,3,0,92,95,1,0,1,2,1,4,0,5,0,0,1,1,6,2,2,10
2399,119097,2021,Russia,Italy,0,4,13,17,31/05/2021,9,1,68,78,1,0,1,2,0,2,3,5,0,0,0,0,6,5,1,12
2400,119097,2021,Russia,Netherlands,0,0,1,1,27/05/2021,1,0,14,15,1,0,0,1,0,0,0,0,0,0,0,0,2,1,0,3
2401,119097,2021,Belgium,Russia,1,1,9,11,26/05/2021,9,1,110,120,2,2,0,4,0,4,2,6,0,0,1,1,12,4,2,18
2402,119097,2021,Germany,Russia,0,1,6,7,25/05/2021,6,0,77,83,3,0,0,3,0,3,6,9,0,0,0,0,3,2,1,6
2403,142339,2021,Russia,Poland,0,0,4,4,20/06/2021,0,0,0,0,1,0,1,2,1,1,1,3,0,0,0,0,0,0,0,0
2404,142339,2021,USA,Russia,0,0,9,9,19/06/2021,0,0,3,3,3,0,4,7,1,3,2,6,0,0,0,0,6,2,0,8
2405,142339,2021,China,Russia,0,1,9,10,18/06/2021,0,0,0,0,0,1,1,2,1,2,6,9,0,0,3,3,1,2,0,3
2406,142339,2021,Russia,Serbia,1,1,10,12,14/06/2021,0,0,2,2,4,1,1,6,0,1,2,3,0,0,0,0,0,0,0,0
2407,142339,2021,Russia,Canada,1,0,9,10,13/06/2021,0,0,2,2,4,0,0,4,1,2,1,4,0,0,2,2,3,0,1,4
2408,142339,2021,Russia,Korea,0,2,9,11,12/06/2021,0,0,1,1,3,1,1,5,1,2,8,11,0,0,0,0,3,0,1,4
2409,142339,2021,Türkiye,Russia,1,0,12,13,08/06/2021,0,0,3,3,5,0,5,10,6,5,8,19,1,0,4,5,5,2,0,7
2410,142339,2021,Russia,Thailand,0,1,11,12,07/06/2021,0,0,1,1,4,1,1,6,6,4,6,16,0,0,0,0,3,0,0,3
2411,142339,2021,Dominican Republic,Russia,0,1,23,24,06/06/2021,0,0,5,5,2,0,0,2,2,5,10,17,0,0,0,0,5,2,3,10
2412,142339,2021,Japan,Russia,0,0,8,8,02/06/2021,0,0,2,2,2,0,9,11,4,6,1,11,0,0,0,0,1,5,0,6
2413,142339,2021,Russia,Italy,1,1,16,18,31/05/2021,0,1,1,2,3,0,1,4,1,3,4,8,0,0,0,0,3,2,0,5
2414,142339,2021,Russia,Netherlands,0,0,2,2,27/05/2021,0,0,0,0,0,0,2,2,0,0,0,0,0,0,0,0,0,0,0,0
2415,142339,2021,Belgium,Russia,0,2,15,17,26/05/2021,0,0,0,0,1,1,2,4,2,4,3,9,1,0,0,1,2,1,2,5
2416,142339,2021,Germany,Russia,0,1,3,4,25/05/2021,0,0,0,0,0,0,2,2,0,2,2,4,0,0,0,0,0,0,0,0
2417,119677,2021,Russia,Poland,1,1,3,5,20/06/2021,0,0,1,1,1,1,3,5,2,1,0,3,2,0,10,12,0,1,0,1
2418,119677,2021,USA,Russia,0,0,2,2,19/06/2021,0,0,0,0,2,1,3,6,1,1,0,2,1,0,6,7,0,0,0,0
2419,119677,2021,China,Russia,0,0,3,3,18/06/2021,0,0,0,0,3,3,8,14,0,2,0,2,1,0,6,7,1,2,0,3
2420,119677,2021,Russia,Serbia,1,0,5,6,14/06/2021,0,0,0,0,2,2,1,5,0,1,1,2,1,0,1,2,4,0,0,4
2421,119677,2021,Russia,Canada,2,0,7,9,13/06/2021,0,0,2,2,7,0,8,15,0,0,1,1,2,2,5,9,4,0,0,4
2422,119677,2021,Japan,Russia,0,0,7,7,02/06/2021,0,0,2,2,5,2,14,21,1,2,0,3,5,3,10,18,3,5,0,8
2423,119677,2021,Brazil,Russia,1,0,7,8,01/06/2021,0,1,0,1,5,0,3,8,0,4,0,4,7,2,18,27,6,1,2,9
2424,119677,2021,Russia,Italy,0,1,7,8,31/05/2021,0,0,0,0,10,1,5,16,1,2,0,3,7,2,26,35,4,3,1,8
2425,119677,2021,Russia,Netherlands,0,0,1,1,27/05/2021,0,0,1,1,1,1,2,4,0,1,1,2,2,0,2,4,0,1,0,1
2426,119677,2021,Belgium,Russia,0,1,7,8,26/05/2021,0,0,1,1,6,2,11,19,6,2,7,15,6,0,8,14,7,1,4,12
2427,119677,2021,Germany,Russia,0,1,4,5,25/05/2021,0,0,0,0,10,1,11,22,1,2,5,8,4,3,11,18,1,1,1,3
2428,142329,2021,Russia,Poland,1,0,8,9,20/06/2021,0,0,0,0,10,6,11,27,2,2,3,7,6,3,18,27,3,1,1,5
2429,142329,2021,USA,Russia,1,3,6,10,19/06/2021,0,0,5,5,12,2,10,24,0,3,2,5,4,1,13,18,8,3,3,14
2430,142329,2021,China,Russia,1,0,7,8,18/06/2021,0,0,1,1,12,3,14,29,0,1,4,5,7,0,21,28,8,4,1,13
2431,142329,2021,Russia,Serbia,0,1,7,8,14/06/2021,0,0,0,0,8,1,3,12,1,0,2,3,2,0,3,5,6,0,1,7
2432,142329,2021,Russia,Canada,0,0,0,0,13/06/2021,0,0,0,0,0,0,0,0,0,0,0,0,0,0,0,0,0,0,0,0
2433,142329,2021,Russia,Korea,2,2,16,20,12/06/2021,0,0,3,3,14,4,6,24,2,1,5,8,3,0,12,15,5,2,2,9
2434,142329,2021,Türkiye,Russia,1,1,9,11,08/06/2021,0,0,1,1,9,6,15,30,0,1,4,5,5,1,13,19,10,1,0,11
2435,142329,2021,Russia,Thailand,0,2,8,10,07/06/2021,0,0,2,2,5,2,10,17,1,2,0,3,10,1,11,22,13,1,0,14
2436,142329,2021,Dominican Republic,Russia,1,3,14,18,06/06/2021,0,0,5,5,18,6,19,43,0,3,6,9,5,1,22,28,14,0,2,16
2437,142329,2021,Japan,Russia,1,1,9,11,02/06/2021,0,0,0,0,10,2,10,22,0,2,1,3,10,1,7,18,2,2,0,4
2438,142329,2021,Brazil,Russia,0,0,5,5,01/06/2021,0,0,0,0,5,4,12,21,1,0,0,1,3,1,4,8,2,2,2,6
2439,142329,2021,Russia,Italy,0,1,2,3,31/05/2021,0,0,0,0,3,4,6,13,0,0,0,0,0,1,2,3,4,1,0,5
2440,142329,2021,Russia,Netherlands,0,0,2,2,27/05/2021,0,0,1,1,0,1,4,5,0,0,0,0,1,0,1,2,3,1,0,4
2441,142329,2021,Belgium,Russia,1,4,13,18,26/05/2021,0,0,1,1,16,3,18,37,0,6,2,8,13,0,24,37,9,2,1,12
2442,142329,2021,Germany,Russia,3,1,10,14,25/05/2021,0,0,1,1,10,3,8,21,1,3,2,6,9,2,11,22,5,0,0,5
2443,173153,2021,Russia,Poland,0,0,0,0,20/06/2021,0,0,6,6,0,0,0,0,0,0,0,0,2,0,4,6,11,3,1,15
2444,173153,2021,USA,Russia,0,0,0,0,19/06/2021,0,0,4,4,0,0,0,0,0,0,0,0,0,1,10,11,6,3,1,10
2445,173153,2021,China,Russia,0,0,0,0,18/06/2021,0,0,6,6,0,0,0,0,0,0,0,0,1,0,16,17,14,3,2,19
2446,173153,2021,Russia,Serbia,0,0,0,0,14/06/2021,0,0,4,4,0,0,0,0,0,0,0,0,3,1,7,11,10,3,2,15
2447,173153,2021,Russia,Canada,0,0,0,0,13/06/2021,0,0,4,4,0,0,0,0,0,0,0,0,0,0,5,5,10,3,0,13
2448,173153,2021,Russia,Korea,0,0,0,0,12/06/2021,0,0,12,12,0,0,0,0,0,0,0,0,3,0,10,13,17,2,4,23
2449,180970,2021,Russia,Serbia,1,0,4,5,14/06/2021,6,0,39,45,1,0,2,3,0,2,2,4,0,0,0,0,1,1,0,2
2450,180970,2021,Russia,Korea,0,0,0,0,12/06/2021,2,0,8,10,0,1,0,1,0,0,0,0,0,0,0,0,0,0,0,0
2451,180970,2021,Türkiye,Russia,0,0,1,1,08/06/2021,2,1,14,17,0,0,0,0,0,0,1,1,0,0,0,0,0,0,0,0
2452,180970,2021,Russia,Thailand,0,1,2,3,07/06/2021,3,0,18,21,0,0,1,1,0,0,0,0,0,0,0,0,3,0,1,4
2453,180970,2021,Brazil,Russia,0,0,3,3,01/06/2021,1,3,42,46,0,0,0,0,0,1,1,2,0,0,0,0,7,2,1,10
2454,180970,2021,Russia,Italy,0,0,0,0,31/05/2021,0,0,0,0,0,0,0,0,0,0,0,0,0,0,0,0,0,0,0,0
2455,180970,2021,Russia,Netherlands,1,1,12,14,27/05/2021,8,0,77,85,1,0,1,2,0,2,0,2,0,0,0,0,10,4,0,14
2456,180970,2021,Germany,Russia,0,0,0,0,25/05/2021,0,0,0,0,0,0,0,0,0,0,0,0,0,0,0,0,0,0,0,0
2457,164025,2021,Russia,Poland,0,1,1,2,20/06/2021,0,0,0,0,0,0,0,0,0,0,0,0,0,0,0,0,0,0,0,0
2458,164025,2021,USA,Russia,0,0,0,0,19/06/2021,0,0,0,0,0,0,0,0,0,0,0,0,0,0,0,0,0,0,0,0
2459,164025,2021,China,Russia,0,1,0,1,18/06/2021,0,0,0,0,0,0,0,0,0,0,0,0,0,0,0,0,0,0,0,0
2460,164025,2021,Russia,Serbia,1,0,1,2,14/06/2021,0,0,0,0,0,0,0,0,0,0,0,0,0,0,0,0,0,0,0,0
2461,164025,2021,Russia,Canada,0,1,1,2,13/06/2021,0,0,1,1,0,0,0,0,0,0,0,0,0,0,1,1,0,0,0,0
2462,164025,2021,Russia,Korea,0,0,0,0,12/06/2021,0,0,0,0,0,0,0,0,0,0,0,0,0,0,0,0,2,0,0,2
2463,164025,2021,Türkiye,Russia,1,2,3,6,08/06/2021,0,0,0,0,0,0,0,0,0,0,0,0,0,0,0,0,2,2,0,4
2464,164025,2021,Russia,Thailand,0,0,0,0,07/06/2021,0,0,0,0,0,0,0,0,0,0,0,0,0,0,1,1,1,0,0,1
2465,164025,2021,Dominican Republic,Russia,0,0,0,0,06/06/2021,0,0,0,0,0,0,0,0,0,0,0,0,0,0,0,0,0,0,0,0
2466,164025,2021,Brazil,Russia,0,0,0,0,01/06/2021,0,0,0,0,0,2,2,4,0,0,1,1,0,1,4,5,2,0,0,2
2467,151625,2021,Russia,Poland,1,2,8,11,20/06/2021,0,0,1,1,5,5,8,18,0,1,2,3,2,0,1,3,3,0,0,3
2468,151625,2021,USA,Russia,0,1,3,4,19/06/2021,0,0,0,0,2,0,2,4,0,2,0,2,1,3,3,7,0,0,1,1
2469,151625,2021,China,Russia,0,0,3,3,18/06/2021,0,0,0,0,0,0,0,0,0,0,0,0,0,0,0,0,0,0,0,0
2470,151625,2021,Russia,Serbia,0,0,6,6,14/06/2021,0,0,0,0,4,3,1,8,0,0,0,0,3,2,12,17,3,1,0,4
2471,151625,2021,Russia,Canada,2,1,6,9,13/06/2021,0,0,0,0,0,1,2,3,0,2,1,3,1,0,1,2,1,0,0,1
2472,151625,2021,Russia,Korea,0,1,5,6,12/06/2021,0,0,0,0,4,3,5,12,0,1,0,1,2,0,8,10,2,1,0,3
2473,151625,2021,Türkiye,Russia,2,2,8,12,08/06/2021,0,0,1,1,10,3,6,19,0,2,2,4,2,1,12,15,6,2,0,8
2474,151625,2021,Russia,Thailand,0,1,1,2,07/06/2021,0,0,0,0,5,1,3,9,2,1,0,3,1,2,3,6,2,0,0,2
2475,151625,2021,Dominican Republic,Russia,0,0,1,1,06/06/2021,0,0,0,0,0,0,2,2,0,0,0,0,0,0,1,1,3,0,0,3
2476,151625,2021,Japan,Russia,0,1,1,2,02/06/2021,0,0,0,0,0,0,0,0,0,0,0,0,0,0,0,0,0,0,0,0
2477,151625,2021,Brazil,Russia,0,0,7,7,01/06/2021,0,0,1,1,8,5,20,33,0,1,0,1,1,0,0,1,6,3,0,9
2478,151625,2021,Russia,Italy,0,1,4,5,31/05/2021,0,0,0,0,0,0,0,0,0,0,0,0,0,0,0,0,1,0,0,1
2479,151625,2021,Russia,Netherlands,1,3,8,12,27/05/2021,0,1,0,1,17,5,18,40,0,0,0,0,0,0,0,0,5,3,0,8
2480,151625,2021,Germany,Russia,0,0,4,4,25/05/2021,0,0,0,0,0,0,1,1,0,0,0,0,0,0,0,0,1,0,0,1
2481,152168,2021,Canada,Serbia,0,0,0,0,12/06/2021,0,0,0,0,0,0,0,0,0,0,0,0,0,0,0,0,1,0,0,1
2482,152168,2021,Belgium,Serbia,0,3,16,19,08/06/2021,0,0,5,5,14,9,32,55,2,6,7,15,5,0,21,26,24,2,8,34
2483,152168,2021,China,Serbia,3,1,14,18,07/06/2021,0,0,3,3,22,12,14,48,1,2,1,4,14,0,22,36,9,3,0,12
2484,152168,2021,Brazil,Serbia,0,1,4,5,06/06/2021,0,0,2,2,6,2,6,14,0,0,1,1,12,4,12,28,4,0,1,5
2485,152168,2021,Netherlands,Serbia,2,3,10,15,02/06/2021,0,0,3,3,14,6,16,36,0,0,3,3,7,1,27,35,11,5,5,21
2486,152168,2021,Serbia,Thailand,0,2,16,18,01/06/2021,1,0,1,2,14,2,12,28,0,2,0,2,8,0,12,20,14,0,1,15
2487,152168,2021,Serbia,USA,2,2,2,6,31/05/2021,0,0,0,0,8,3,10,21,2,2,4,8,6,1,16,23,5,2,1,8
2488,152168,2021,Serbia,Italy,0,3,14,17,27/05/2021,0,0,4,4,17,8,22,47,1,2,3,6,7,0,15,22,10,0,1,11
2489,152168,2021,Serbia,Poland,0,4,17,21,26/05/2021,0,0,3,3,17,3,18,38,1,4,0,5,7,3,22,32,4,2,1,7
2490,152168,2021,Türkiye,Serbia,5,2,23,30,25/05/2021,0,0,0,0,10,10,21,41,2,4,4,10,9,2,14,25,14,2,1,17
2491,163120,2021,Canada,Serbia,1,1,13,15,12/06/2021,0,0,3,3,12,6,14,32,2,2,3,7,0,0,0,0,9,3,0,12
2492,163120,2021,Belgium,Serbia,0,1,14,15,08/06/2021,0,0,3,3,18,5,24,47,1,5,11,17,0,0,0,0,12,4,1,17
2493,163120,2021,China,Serbia,0,1,12,13,07/06/2021,0,0,0,0,20,5,17,42,2,4,0,6,0,0,0,0,6,2,1,9
2494,163120,2021,Brazil,Serbia,1,0,5,6,06/06/2021,0,0,5,5,3,3,11,17,0,1,1,2,0,0,0,0,3,1,0,4
2495,163120,2021,Netherlands,Serbia,0,0,8,8,02/06/2021,0,0,1,1,7,8,20,35,0,1,2,3,0,0,0,0,8,3,3,14
2496,163120,2021,Serbia,Thailand,0,1,9,10,01/06/2021,0,0,0,0,8,7,16,31,6,3,3,12,0,0,0,0,13,2,2,17
2497,163120,2021,Serbia,Italy,0,4,5,9,27/05/2021,0,0,2,2,8,9,10,27,3,1,1,5,0,0,0,0,8,0,1,9
2498,163120,2021,Serbia,Poland,0,1,8,9,26/05/2021,0,0,1,1,19,3,13,35,2,2,1,5,0,0,0,0,5,2,0,7
2499,163120,2021,Türkiye,Serbia,0,4,9,13,25/05/2021,0,0,0,0,18,8,26,52,4,1,2,7,1,1,3,5,10,0,1,11
2500,181204,2021,Japan,Serbia,0,0,6,6,20/06/2021,0,0,0,0,1,4,13,18,1,0,0,1,3,1,7,11,1,0,0,1
2501,181204,2021,Dominican Republic,Serbia,0,3,8,11,19/06/2021,0,0,4,4,14,0,8,22,2,1,0,3,11,2,18,31,4,1,0,5
2502,181204,2021,Germany,Serbia,0,0,0,0,18/06/2021,0,0,0,0,0,1,0,1,0,0,0,0,0,0,0,0,0,1,0,1
2503,181204,2021,Russia,Serbia,0,0,5,5,14/06/2021,0,0,1,1,4,2,4,10,0,0,1,1,0,2,2,4,0,2,1,3
2504,181204,2021,Korea,Serbia,1,1,5,7,13/06/2021,0,0,0,0,3,2,7,12,0,2,1,3,1,1,2,4,8,0,1,9
2505,181204,2021,Canada,Serbia,0,0,1,1,12/06/2021,0,0,0,0,0,1,1,2,0,0,0,0,0,0,5,5,1,1,0,2
2506,181204,2021,Belgium,Serbia,0,0,4,4,08/06/2021,0,0,1,1,1,2,4,7,0,2,1,3,0,0,0,0,1,0,0,1
2507,181204,2021,China,Serbia,0,0,0,0,07/06/2021,0,0,0,0,0,0,0,0,0,0,0,0,0,0,0,0,0,0,0,0
2508,181204,2021,Brazil,Serbia,0,0,0,0,06/06/2021,0,0,0,0,0,0,0,0,0,0,0,0,0,0,0,0,0,0,0,0
2509,181204,2021,Netherlands,Serbia,0,1,0,1,02/06/2021,0,0,0,0,1,2,0,3,0,0,0,0,0,0,0,0,1,0,0,1
2510,181204,2021,Serbia,Thailand,0,0,0,0,01/06/2021,0,0,0,0,0,0,0,0,0,0,0,0,0,0,0,0,0,0,0,0
2511,181204,2021,Serbia,USA,0,0,11,11,31/05/2021,0,1,3,4,8,7,8,23,0,1,0,1,3,3,8,14,4,2,3,9
2512,181204,2021,Serbia,Italy,0,0,0,0,27/05/2021,0,0,0,0,0,0,0,0,0,0,0,0,0,0,0,0,0,0,0,0
2513,181204,2021,Serbia,Poland,0,0,0,0,26/05/2021,0,0,0,0,0,0,0,0,0,0,0,0,0,0,0,0,0,0,0,0
2514,181204,2021,Türkiye,Serbia,0,0,0,0,25/05/2021,0,0,0,0,0,0,0,0,0,0,0,0,0,0,0,0,0,0,0,0
2515,152169,2021,Japan,Serbia,0,0,1,1,20/06/2021,1,0,20,21,0,0,0,0,1,2,1,4,0,0,0,0,0,0,0,0
2516,152169,2021,Dominican Republic,Serbia,0,1,5,6,19/06/2021,11,1,36,48,1,0,1,2,0,1,0,1,0,0,0,0,4,3,0,7
2517,152169,2021,Germany,Serbia,0,0,8,8,18/06/2021,2,0,50,52,2,0,1,3,0,1,1,2,0,0,0,0,5,3,1,9
2518,152169,2021,Russia,Serbia,1,0,5,6,14/06/2021,5,0,53,58,1,0,1,2,1,3,2,6,0,0,0,0,3,2,1,6
2519,152169,2021,Korea,Serbia,0,1,3,4,13/06/2021,3,0,30,33,0,0,2,2,0,1,2,3,0,1,0,1,1,1,1,3
2520,152169,2021,Canada,Serbia,0,1,9,10,12/06/2021,9,0,54,63,1,0,0,1,0,3,1,4,0,0,0,0,7,3,1,11
2521,152169,2021,Belgium,Serbia,1,1,17,19,08/06/2021,23,3,104,130,1,0,2,3,2,1,4,7,0,0,0,0,8,3,1,12
2522,152169,2021,China,Serbia,1,2,13,16,07/06/2021,5,0,71,76,3,0,1,4,0,1,0,1,0,0,0,0,2,5,0,7
2523,152169,2021,Brazil,Serbia,0,0,1,1,06/06/2021,1,0,24,25,0,0,2,2,0,1,0,1,0,0,0,0,2,0,0,2
2524,152169,2021,Netherlands,Serbia,0,1,1,2,02/06/2021,3,0,21,24,0,0,1,1,0,0,0,0,0,0,0,0,2,0,0,2
2525,152169,2021,Serbia,Thailand,1,0,9,10,01/06/2021,14,1,75,90,3,0,3,6,2,0,3,5,0,0,0,0,3,0,1,4
2526,152169,2021,Serbia,USA,0,0,5,5,31/05/2021,5,0,66,71,0,1,0,1,0,1,3,4,0,1,0,1,7,3,2,12
2527,152169,2021,Serbia,Italy,1,1,19,21,27/05/2021,20,1,81,102,1,0,1,2,1,0,0,1,0,0,0,0,11,0,1,12
2528,152169,2021,Serbia,Poland,0,2,11,13,26/05/2021,10,1,90,101,1,0,0,1,1,2,0,3,0,0,0,0,4,1,0,5
2529,152169,2021,Türkiye,Serbia,0,0,14,14,25/05/2021,8,0,124,132,0,0,1,1,1,1,3,5,0,0,0,0,2,1,2,5
2530,152167,2021,Japan,Serbia,0,0,7,7,20/06/2021,0,0,0,0,4,2,2,8,3,2,0,5,0,0,0,0,2,0,0,2
2531,152167,2021,Dominican Republic,Serbia,0,1,3,4,19/06/2021,0,0,1,1,1,2,2,5,2,5,4,11,0,0,0,0,1,0,0,1
2532,152167,2021,Germany,Serbia,0,0,8,8,18/06/2021,0,0,0,0,1,1,1,3,3,4,0,7,0,0,0,0,1,1,0,2
2533,152167,2021,Russia,Serbia,0,0,6,6,14/06/2021,0,0,1,1,0,3,2,5,2,2,1,5,0,0,0,0,0,0,0,0
2534,152167,2021,Korea,Serbia,2,0,11,13,13/06/2021,0,0,2,2,4,1,2,7,1,8,5,14,0,0,0,0,3,1,3,7
2535,152167,2021,Canada,Serbia,0,0,12,12,12/06/2021,0,0,1,1,6,1,4,11,1,5,5,11,0,0,0,0,3,0,2,5
2536,152167,2021,Belgium,Serbia,1,0,18,19,08/06/2021,0,0,3,3,5,0,6,11,4,8,12,24,0,0,0,0,9,0,0,9
2537,152167,2021,China,Serbia,0,0,9,9,07/06/2021,0,0,0,0,7,2,5,14,2,0,1,3,0,0,0,0,4,0,0,4
2538,152167,2021,Brazil,Serbia,0,0,3,3,06/06/2021,0,0,1,1,2,0,3,5,0,3,1,4,0,0,0,0,2,0,0,2
2539,152167,2021,Netherlands,Serbia,0,0,13,13,02/06/2021,0,0,4,4,7,0,7,14,7,5,10,22,0,0,2,2,4,0,1,5
2540,152167,2021,Serbia,Thailand,0,1,12,13,01/06/2021,0,0,1,1,4,1,4,9,5,4,6,15,1,0,1,2,2,0,1,3
2541,152167,2021,Serbia,USA,0,0,0,0,31/05/2021,0,0,0,0,0,0,0,0,0,0,0,0,0,0,0,0,0,0,0,0
2542,152167,2021,Serbia,Italy,0,1,22,23,27/05/2021,0,0,2,2,8,0,6,14,1,7,2,10,0,0,0,0,0,2,0,2
2543,152167,2021,Serbia,Poland,0,1,16,17,26/05/2021,0,0,0,0,3,0,2,5,6,4,4,14,0,0,1,1,3,0,0,3
2544,152167,2021,Türkiye,Serbia,1,3,15,19,25/05/2021,0,0,0,0,5,2,3,10,6,10,5,21,0,0,1,1,4,2,0,6
2545,142479,2021,Japan,Serbia,0,1,4,5,20/06/2021,0,0,5,5,6,2,9,17,1,1,0,2,14,5,17,36,1,4,0,5
2546,142479,2021,Dominican Republic,Serbia,0,0,0,0,19/06/2021,0,0,0,0,0,0,0,0,0,0,0,0,0,0,0,0,0,0,0,0
2547,142479,2021,Germany,Serbia,1,1,9,11,18/06/2021,0,0,5,5,8,3,10,21,1,0,0,1,9,1,11,21,8,4,0,12
2548,142479,2021,Russia,Serbia,1,0,9,10,14/06/2021,0,0,5,5,7,5,9,21,1,1,1,3,2,2,15,19,6,4,0,10
2549,142479,2021,Korea,Serbia,0,2,8,10,13/06/2021,0,0,4,4,7,4,25,36,1,1,1,3,9,1,29,39,11,5,2,18
2550,142479,2021,Canada,Serbia,3,0,11,14,12/06/2021,0,0,5,5,12,5,13,30,1,0,3,4,8,3,22,33,11,5,0,16
2551,142479,2021,Belgium,Serbia,2,1,14,17,08/06/2021,0,0,7,7,13,3,27,43,1,3,8,12,8,4,24,36,16,1,1,18
2552,142479,2021,China,Serbia,3,2,10,15,07/06/2021,0,0,4,4,11,5,14,30,2,1,0,3,12,1,14,27,10,2,0,12
2553,142479,2021,Brazil,Serbia,0,2,0,2,06/06/2021,0,0,1,1,2,3,3,8,0,1,0,1,4,1,4,9,1,0,1,2
2554,142479,2021,Netherlands,Serbia,0,2,3,5,02/06/2021,0,0,3,3,7,5,14,26,1,2,2,5,0,3,13,16,3,2,0,5
2555,142479,2021,Serbia,Thailand,3,0,5,8,01/06/2021,0,0,1,1,3,4,9,16,0,0,0,0,3,2,9,14,5,0,0,5
2556,142479,2021,Serbia,USA,0,0,0,0,31/05/2021,0,0,0,0,0,0,1,1,0,0,0,0,0,0,0,0,0,0,0,0
2557,142479,2021,Serbia,Italy,0,1,7,8,27/05/2021,0,0,1,1,8,4,7,19,0,1,0,1,5,0,20,25,7,1,0,8
2558,142479,2021,Serbia,Poland,0,1,13,14,26/05/2021,0,0,4,4,13,6,12,31,0,5,1,6,6,1,14,21,12,1,1,14
2559,142479,2021,Türkiye,Serbia,1,3,9,13,25/05/2021,0,0,0,0,13,2,21,36,1,0,2,3,13,2,28,43,7,0,2,9
2560,163056,2021,Japan,Serbia,0,2,7,9,20/06/2021,2,0,55,57,3,0,1,4,2,6,2,10,0,0,0,0,4,3,0,7
2561,163056,2021,Dominican Republic,Serbia,0,2,0,2,19/06/2021,4,0,22,26,1,0,0,1,0,1,0,1,0,0,0,0,2,3,0,5
2562,163056,2021,Germany,Serbia,0,1,1,2,18/06/2021,0,0,21,21,0,2,0,2,1,0,0,1,0,0,0,0,3,0,0,3
2563,163056,2021,Russia,Serbia,0,0,0,0,14/06/2021,1,0,2,3,0,0,0,0,0,0,0,0,0,0,0,0,1,0,0,1
2564,163056,2021,Korea,Serbia,1,0,6,7,13/06/2021,7,0,77,84,1,1,0,2,0,4,2,6,0,0,0,0,5,1,0,6
2565,163056,2021,Canada,Serbia,0,1,3,4,12/06/2021,3,0,39,42,0,0,3,3,3,3,2,8,0,0,0,0,2,3,0,5
2566,163056,2021,Belgium,Serbia,0,0,0,0,08/06/2021,2,0,19,21,0,1,0,1,1,1,0,2,0,0,0,0,2,2,0,4
2567,163056,2021,China,Serbia,0,2,1,3,07/06/2021,2,0,46,48,0,0,0,0,0,1,0,1,0,0,0,0,2,0,0,2
2568,163056,2021,Brazil,Serbia,0,2,3,5,06/06/2021,6,1,35,42,1,0,0,1,1,1,1,3,0,0,0,0,3,1,1,5
2569,163056,2021,Netherlands,Serbia,0,1,18,19,02/06/2021,21,2,83,106,0,0,2,2,0,1,1,2,0,0,0,0,12,0,2,14
2570,163056,2021,Serbia,Thailand,0,0,1,1,01/06/2021,2,0,12,14,1,0,0,1,0,1,0,1,0,0,0,0,1,0,0,1
2571,163056,2021,Serbia,USA,0,0,0,0,31/05/2021,0,1,15,16,0,0,0,0,0,0,0,0,0,0,0,0,2,2,2,6
2572,163056,2021,Serbia,Italy,0,1,1,2,27/05/2021,1,0,14,15,1,0,0,1,0,1,0,1,0,0,0,0,1,2,0,3
2573,163056,2021,Serbia,Poland,0,1,0,1,26/05/2021,0,1,8,9,0,0,0,0,0,0,0,0,0,0,0,0,0,0,0,0
2574,163056,2021,Türkiye,Serbia,0,0,1,1,25/05/2021,1,0,28,29,1,1,0,2,0,0,1,1,0,0,0,0,1,1,0,2
2575,138480,2021,Japan,Serbia,0,0,1,1,20/06/2021,0,0,0,0,0,1,1,2,0,0,0,0,0,0,0,0,0,0,0,0
2576,138480,2021,Dominican Republic,Serbia,0,0,0,0,19/06/2021,0,0,0,0,0,0,0,0,0,0,0,0,0,0,0,0,0,0,0,0
2577,138480,2021,Germany,Serbia,1,0,4,5,18/06/2021,0,0,0,0,0,0,0,0,0,2,0,2,0,0,1,1,0,0,0,0
2578,138480,2021,Russia,Serbia,1,1,3,5,14/06/2021,0,0,0,0,2,0,0,2,1,1,0,2,0,0,0,0,2,0,0,2
2579,138480,2021,Korea,Serbia,1,1,5,7,13/06/2021,0,0,0,0,2,1,1,4,1,3,4,8,0,0,0,0,0,0,0,0
2580,138480,2021,Canada,Serbia,0,1,5,6,12/06/2021,0,0,0,0,1,2,3,6,1,5,2,8,0,0,1,1,5,0,0,5
2581,138480,2021,Belgium,Serbia,0,0,2,2,08/06/2021,0,0,1,1,0,0,0,0,1,2,1,4,0,0,0,0,0,0,0,0
2582,138480,2021,China,Serbia,1,0,16,17,07/06/2021,0,0,1,1,3,2,3,8,1,3,1,5,0,0,0,0,1,0,0,1
2583,138480,2021,Brazil,Serbia,0,0,0,0,06/06/2021,0,0,0,0,0,0,0,0,0,0,0,0,0,0,0,0,0,0,0,0
2584,138480,2021,Netherlands,Serbia,0,2,8,10,02/06/2021,0,0,2,2,4,1,4,9,3,7,7,17,0,0,1,1,4,0,1,5
2585,138480,2021,Serbia,Thailand,0,2,6,8,01/06/2021,0,0,0,0,1,3,3,7,3,0,7,10,0,0,0,0,1,0,0,1
2586,138480,2021,Serbia,USA,1,0,4,5,31/05/2021,0,0,2,2,2,1,4,7,2,2,5,9,0,0,0,0,3,0,0,3
2587,138480,2021,Serbia,Italy,1,1,11,13,27/05/2021,0,0,1,1,5,0,6,11,2,4,3,9,0,0,1,1,0,0,0,0
2588,138480,2021,Serbia,Poland,0,0,2,2,26/05/2021,0,0,0,0,0,1,3,4,0,1,0,1,0,0,1,1,0,0,0,0
2589,138480,2021,Türkiye,Serbia,2,2,9,13,25/05/2021,0,0,0,0,5,2,7,14,4,2,6,12,0,0,0,0,3,1,1,5
2590,153452,2021,Japan,Serbia,0,2,2,4,20/06/2021,0,0,0,0,2,1,4,7,0,0,0,0,0,0,0,0,0,0,0,0
2591,153452,2021,Dominican Republic,Serbia,0,0,2,2,19/06/2021,0,0,0,0,0,1,2,3,0,1,0,1,0,0,0,0,1,0,0,1
2592,153452,2021,Germany,Serbia,0,1,6,7,18/06/2021,0,0,0,0,1,0,7,8,0,2,0,2,1,0,1,2,1,1,0,2
2593,153452,2021,Russia,Serbia,0,1,2,3,14/06/2021,0,0,0,0,0,0,2,2,0,2,1,3,0,0,1,1,2,0,0,2
2594,153452,2021,Korea,Serbia,0,0,2,2,13/06/2021,0,0,0,0,3,3,0,6,0,2,2,4,0,0,0,0,0,0,0,0
2595,153452,2021,Canada,Serbia,0,0,1,1,12/06/2021,0,0,0,0,0,0,0,0,0,0,0,0,0,0,0,0,1,0,0,1
2596,153452,2021,Belgium,Serbia,0,1,7,8,08/06/2021,0,0,1,1,9,1,3,13,1,9,13,23,0,0,0,0,2,1,1,4
2597,153452,2021,China,Serbia,0,0,1,1,07/06/2021,0,0,0,0,0,0,0,0,0,0,0,0,0,0,0,0,0,1,0,1
2598,153452,2021,Brazil,Serbia,0,1,8,9,06/06/2021,0,0,2,2,2,2,4,8,1,4,5,10,0,0,0,0,2,0,2,4
2599,153452,2021,Serbia,Italy,0,0,0,0,27/05/2021,0,0,0,0,0,0,0,0,0,0,0,0,0,0,0,0,0,0,0,0
2600,153452,2021,Serbia,Poland,3,0,12,15,26/05/2021,0,0,0,0,5,1,0,6,1,4,0,5,0,0,0,0,1,0,0,1
2601,153452,2021,Türkiye,Serbia,0,0,0,0,25/05/2021,0,0,0,0,0,0,0,0,0,0,0,0,0,0,0,0,0,0,0,0
2602,173974,2021,Japan,Serbia,1,1,10,12,20/06/2021,0,0,2,2,6,6,14,26,0,2,0,2,0,0,0,0,4,4,0,8
2603,173974,2021,Dominican Republic,Serbia,0,2,7,9,19/06/2021,0,0,1,1,9,2,7,18,0,2,1,3,0,0,0,0,3,1,0,4
2604,173974,2021,Germany,Serbia,0,1,8,9,18/06/2021,0,0,0,0,10,5,10,25,3,0,0,3,0,0,0,0,1,3,0,4
2605,173974,2021,Russia,Serbia,0,0,6,6,14/06/2021,0,0,0,0,7,3,8,18,0,3,0,3,0,0,0,0,1,2,2,5
2606,173974,2021,Korea,Serbia,3,0,7,10,13/06/2021,0,0,0,0,7,4,14,25,0,2,1,3,0,0,0,0,10,2,0,12
2607,173974,2021,Canada,Serbia,0,2,1,3,12/06/2021,0,0,0,0,1,0,4,5,0,2,2,4,0,0,0,0,1,0,0,1
2608,173974,2021,Brazil,Serbia,0,0,0,0,06/06/2021,0,0,1,1,0,3,1,4,0,0,0,0,0,0,0,0,1,2,0,3
2609,173974,2021,Netherlands,Serbia,1,0,2,3,02/06/2021,0,0,0,0,3,1,3,7,0,0,1,1,0,0,0,0,2,1,0,3
2610,173974,2021,Serbia,Thailand,0,0,0,0,01/06/2021,0,0,0,0,0,0,0,0,0,0,0,0,0,0,0,0,0,0,0,0
2611,173974,2021,Serbia,USA,0,1,4,5,31/05/2021,0,0,0,0,1,5,16,22,0,3,3,6,0,0,0,0,3,0,2,5
2612,173974,2021,Serbia,Italy,0,0,0,0,27/05/2021,0,0,0,0,1,2,1,4,1,0,0,1,0,0,0,0,0,0,0,0
2613,173974,2021,Serbia,Poland,0,1,0,1,26/05/2021,0,0,0,0,0,1,2,3,0,0,1,1,0,0,0,0,1,0,0,1
2614,173974,2021,Türkiye,Serbia,0,1,1,2,25/05/2021,0,0,0,0,3,1,5,9,0,1,1,2,0,0,0,0,2,0,1,3
2615,152176,2021,Japan,Serbia,0,0,0,0,20/06/2021,0,0,0,0,0,0,0,0,0,0,0,0,0,0,0,0,0,0,0,0
2616,152176,2021,Dominican Republic,Serbia,0,1,2,3,19/06/2021,0,0,0,0,3,2,4,9,0,0,0,0,0,0,0,0,1,3,0,4
2617,152176,2021,Germany,Serbia,0,1,0,1,18/06/2021,0,0,0,0,0,0,1,1,0,0,0,0,0,0,0,0,0,0,0,0
2618,152176,2021,Russia,Serbia,0,0,0,0,14/06/2021,0,0,1,1,1,0,0,1,0,0,1,1,0,0,0,0,0,0,0,0
2619,152176,2021,Korea,Serbia,0,0,0,0,13/06/2021,0,0,0,0,0,0,0,0,0,0,0,0,0,0,0,0,0,0,0,0
2620,152176,2021,Belgium,Serbia,0,0,0,0,08/06/2021,0,0,0,0,0,0,0,0,0,0,0,0,0,0,0,0,0,0,0,0
2621,152176,2021,China,Serbia,0,0,0,0,07/06/2021,0,0,0,0,0,1,0,1,0,0,0,0,0,0,0,0,0,0,0,0
2622,152176,2021,Netherlands,Serbia,0,0,0,0,02/06/2021,0,0,0,0,0,0,0,0,0,0,0,0,0,0,0,0,0,0,0,0
2623,152176,2021,Serbia,USA,0,0,3,3,31/05/2021,0,0,0,0,1,3,8,12,0,2,1,3,0,0,0,0,2,0,2,4
2624,163967,2021,Japan,Serbia,0,0,0,0,20/06/2021,0,0,0,0,0,0,0,0,0,0,0,0,0,0,0,0,0,0,0,0
2625,163967,2021,Dominican Republic,Serbia,0,0,6,6,19/06/2021,0,0,0,0,0,2,1,3,3,2,1,6,0,0,0,0,4,0,1,5
2626,163967,2021,Germany,Serbia,1,0,3,4,18/06/2021,0,0,0,0,0,0,1,1,1,1,0,2,0,0,0,0,0,0,0,0
2627,163967,2021,Russia,Serbia,0,1,1,2,14/06/2021,0,0,1,1,0,0,1,1,2,1,0,3,0,0,0,0,0,0,0,0
2628,163967,2021,Korea,Serbia,0,0,0,0,13/06/2021,0,0,0,0,0,0,0,0,0,0,0,0,0,0,0,0,0,0,0,0
2629,163967,2021,Canada,Serbia,1,0,5,6,12/06/2021,0,0,1,1,0,0,0,0,0,0,0,0,0,0,0,0,0,1,0,1
2630,163967,2021,Belgium,Serbia,0,0,0,0,08/06/2021,0,0,0,0,0,0,0,0,0,0,0,0,0,0,0,0,0,0,0,0
2631,163967,2021,China,Serbia,0,0,0,0,07/06/2021,0,0,0,0,0,0,0,0,0,0,0,0,0,0,0,0,0,0,0,0
2632,163967,2021,Brazil,Serbia,0,1,2,3,06/06/2021,0,0,0,0,0,0,0,0,0,1,0,1,0,0,0,0,0,0,0,0
2633,163967,2021,Netherlands,Serbia,0,0,0,0,02/06/2021,0,0,0,0,0,0,0,0,0,0,0,0,0,0,0,0,0,0,0,0
2634,163967,2021,Serbia,Thailand,0,0,0,0,01/06/2021,0,0,0,0,0,0,0,0,0,0,0,0,0,0,0,0,0,0,0,0
2635,163967,2021,Serbia,USA,0,0,7,7,31/05/2021,0,0,1,1,0,0,4,4,1,3,2,6,0,0,0,0,1,1,0,2
2636,163967,2021,Serbia,Italy,0,0,0,0,27/05/2021,0,0,0,0,0,0,0,0,0,0,0,0,0,0,0,0,0,0,0,0
2637,163967,2021,Serbia,Poland,0,0,0,0,26/05/2021,0,0,0,0,0,0,0,0,0,0,0,0,0,0,0,0,0,0,0,0
2638,163967,2021,Türkiye,Serbia,0,0,0,0,25/05/2021,0,0,0,0,0,0,0,0,0,0,0,0,0,0,0,0,0,0,0,0
2639,163117,2021,Japan,Serbia,0,0,0,0,20/06/2021,0,0,5,5,0,0,0,0,0,0,0,0,1,0,4,5,6,3,0,9
2640,163117,2021,Dominican Republic,Serbia,0,0,0,0,19/06/2021,0,0,0,0,0,0,0,0,0,0,0,0,0,2,0,2,0,0,0,0
2641,163117,2021,Germany,Serbia,0,0,0,0,18/06/2021,0,0,6,6,0,0,0,0,0,0,0,0,2,1,8,11,12,6,2,20
2642,163117,2021,Russia,Serbia,0,0,0,0,14/06/2021,0,0,3,3,0,0,0,0,0,0,0,0,4,2,12,18,5,2,0,7
2643,163117,2021,Korea,Serbia,0,0,0,0,13/06/2021,0,0,8,8,0,0,0,0,0,0,0,0,4,1,18,23,15,3,4,22
2644,163117,2021,China,Serbia,0,0,0,0,07/06/2021,0,0,12,12,0,0,0,0,0,0,0,0,9,2,11,22,6,5,1,12
2645,163117,2021,Brazil,Serbia,0,0,0,0,06/06/2021,0,0,1,1,0,0,0,0,0,0,0,0,1,0,1,2,2,1,1,4
2646,163117,2021,Netherlands,Serbia,0,0,0,0,02/06/2021,0,0,9,9,0,0,0,0,0,0,0,0,4,4,20,28,22,2,2,26
2647,163117,2021,Serbia,Thailand,0,0,0,0,01/06/2021,0,0,3,3,0,0,0,0,0,0,0,0,1,2,8,11,17,1,3,21
2648,163117,2021,Serbia,USA,0,0,0,0,31/05/2021,0,0,0,0,0,0,0,0,0,0,0,0,0,0,0,0,0,0,0,0
2649,163117,2021,Serbia,Italy,0,0,0,0,27/05/2021,0,0,6,6,0,0,0,0,0,0,0,0,7,1,12,20,5,6,0,11
2650,163117,2021,Serbia,Poland,0,0,0,0,26/05/2021,0,0,4,4,0,0,0,0,0,0,0,0,3,1,13,17,25,3,0,28
2651,163117,2021,Türkiye,Serbia,0,0,0,0,25/05/2021,0,0,3,3,0,0,0,0,0,0,0,0,8,1,12,21,20,3,3,26
2652,173178,2021,Japan,Serbia,0,0,0,0,20/06/2021,0,0,1,1,0,0,0,0,0,0,0,0,2,0,0,2,3,1,0,4
2653,173178,2021,Dominican Republic,Serbia,0,0,0,0,19/06/2021,0,0,5,5,0,0,0,0,0,0,0,0,6,0,11,17,7,4,0,11
2654,173178,2021,Germany,Serbia,0,0,0,0,18/06/2021,0,0,0,0,0,0,0,0,0,0,0,0,0,0,0,0,0,0,0,0
2655,173178,2021,Russia,Serbia,0,0,0,0,14/06/2021,0,0,4,4,0,0,0,0,0,0,0,0,3,3,11,17,2,1,1,4
2656,173178,2021,Korea,Serbia,0,0,0,0,13/06/2021,0,0,0,0,0,0,0,0,0,0,0,0,0,0,0,0,0,0,0,0
2657,173178,2021,Canada,Serbia,0,0,0,0,12/06/2021,0,0,4,4,0,0,0,0,0,0,0,0,10,5,12,27,14,3,1,18
2658,173178,2021,Belgium,Serbia,0,0,0,0,08/06/2021,0,1,11,12,0,0,0,0,0,0,0,0,5,4,26,35,25,2,1,28
2659,173178,2021,China,Serbia,0,0,0,0,07/06/2021,0,0,0,0,0,0,0,0,0,0,0,0,0,0,0,0,0,0,0,0
2660,173178,2021,Brazil,Serbia,0,0,0,0,06/06/2021,0,0,2,2,0,0,0,0,0,0,0,0,6,0,11,17,3,0,1,4
2661,173178,2021,Netherlands,Serbia,0,0,0,0,02/06/2021,0,0,0,0,0,0,0,0,0,0,0,0,0,0,0,0,0,0,0,0
2662,173178,2021,Serbia,Thailand,0,0,0,0,01/06/2021,0,0,0,0,0,0,0,0,0,0,0,0,0,0,0,0,0,0,0,0
2663,173178,2021,Serbia,USA,0,0,0,0,31/05/2021,0,0,6,6,0,0,0,0,0,0,0,0,4,0,6,10,13,3,4,20
2664,173178,2021,Serbia,Italy,0,0,0,0,27/05/2021,0,0,1,1,0,0,0,0,0,0,0,0,0,0,0,0,3,2,0,5
2665,173178,2021,Serbia,Poland,0,0,0,0,26/05/2021,0,0,0,0,0,0,0,0,0,0,0,0,0,0,0,0,0,0,0,0
2666,173178,2021,Türkiye,Serbia,0,0,0,0,25/05/2021,0,0,0,0,0,0,0,0,0,0,0,0,0,0,0,0,0,0,0,0
2667,173979,2021,Japan,Serbia,0,1,1,2,20/06/2021,0,0,0,0,0,0,4,4,0,0,0,0,2,0,6,8,1,0,0,1
2668,173979,2021,Dominican Republic,Serbia,0,1,1,2,19/06/2021,0,0,0,0,0,0,3,3,0,0,0,0,1,0,2,3,0,0,0,0
2669,173979,2021,Germany,Serbia,0,0,3,3,18/06/2021,0,0,7,7,2,1,9,12,0,1,1,2,4,3,5,12,3,2,0,5
2670,173979,2021,Russia,Serbia,0,0,0,0,14/06/2021,0,0,0,0,0,0,0,0,0,0,0,0,0,0,0,0,0,0,0,0
2671,173979,2021,Korea,Serbia,0,1,0,1,13/06/2021,0,0,1,1,0,0,0,0,0,0,0,0,1,0,2,3,0,0,0,0
2672,173979,2021,Canada,Serbia,0,0,0,0,12/06/2021,0,0,1,1,0,0,0,0,0,0,0,0,0,0,3,3,0,1,0,1
2673,173979,2021,Belgium,Serbia,0,0,0,0,08/06/2021,0,0,0,0,0,0,0,0,0,0,0,0,0,0,0,0,0,0,0,0
2674,173979,2021,Serbia,Thailand,0,0,0,0,01/06/2021,0,0,0,0,0,0,0,0,0,0,0,0,0,0,0,0,0,0,0,0
2675,173979,2021,Serbia,USA,0,0,2,2,31/05/2021,0,0,0,0,0,0,0,0,0,0,0,0,0,0,0,0,0,0,0,0
2676,163119,2021,Japan,Serbia,1,0,3,4,20/06/2021,0,0,0,0,0,1,7,8,0,1,1,2,0,1,3,4,0,2,1,3
2677,163119,2021,Dominican Republic,Serbia,0,1,8,9,19/06/2021,0,0,3,3,5,4,13,22,0,1,3,4,5,0,14,19,3,0,0,3
2678,163119,2021,Germany,Serbia,0,0,3,3,18/06/2021,0,0,1,1,7,2,11,20,0,1,0,1,6,1,9,16,4,1,0,5
2679,163119,2021,Russia,Serbia,0,0,6,6,14/06/2021,0,0,2,2,5,5,7,17,1,3,2,6,3,2,7,12,5,2,0,7
2680,163119,2021,Korea,Serbia,3,1,10,14,13/06/2021,0,0,2,2,8,8,24,40,5,3,0,8,7,1,8,16,10,2,1,13
2681,163119,2021,Canada,Serbia,1,0,13,14,12/06/2021,0,0,4,4,15,8,13,36,1,2,0,3,8,0,3,11,9,5,1,15
2682,163119,2021,Belgium,Serbia,0,0,2,2,08/06/2021,0,0,0,0,1,0,1,2,0,0,1,1,0,0,3,3,0,0,0,0
2683,163119,2021,China,Serbia,0,0,1,1,07/06/2021,0,0,0,0,0,0,0,0,0,0,0,0,0,0,0,0,0,0,0,0
2684,163119,2021,Brazil,Serbia,0,2,5,7,06/06/2021,0,0,3,3,8,4,13,25,1,1,1,3,5,0,4,9,3,4,1,8
2685,163119,2021,Netherlands,Serbia,0,1,8,9,02/06/2021,0,0,0,0,11,2,7,20,0,1,1,2,3,0,1,4,6,3,0,9
2686,163119,2021,Serbia,Thailand,0,1,4,5,01/06/2021,0,0,0,0,6,3,9,18,2,0,1,3,8,1,9,18,5,2,0,7
2687,163119,2021,Serbia,USA,0,0,6,6,31/05/2021,0,0,1,1,3,0,6,9,0,1,2,3,3,0,9,12,4,1,0,5
2688,163119,2021,Serbia,Italy,0,1,4,5,27/05/2021,0,0,0,0,6,1,6,13,0,0,0,0,4,0,3,7,3,0,0,3
2689,163119,2021,Serbia,Poland,0,1,0,1,26/05/2021,0,0,0,0,0,0,0,0,0,0,0,0,0,0,0,0,0,0,0,0
2690,163119,2021,Türkiye,Serbia,0,0,4,4,25/05/2021,0,0,0,0,1,1,1,3,0,0,0,0,1,0,3,4,2,1,0,3
2691,131866,2021,Thailand,Italy,0,0,0,0,20/06/2021,0,0,5,5,0,0,0,0,0,0,0,0,12,0,13,25,7,2,0,9
2692,131866,2021,Thailand,Canada,0,0,0,0,19/06/2021,0,0,5,5,0,0,0,0,0,0,0,0,10,1,4,15,6,0,3,9
2693,131866,2021,Thailand,Belgium,0,0,0,0,18/06/2021,0,0,8,8,0,0,0,0,0,0,0,0,14,1,17,32,5,4,0,9
2694,131866,2021,Brazil,Thailand,0,0,0,0,14/06/2021,0,0,8,8,0,0,0,0,0,0,0,0,5,0,8,13,14,5,0,19
2695,131866,2021,Thailand,Poland,0,0,0,0,13/06/2021,0,0,5,5,0,0,0,0,0,0,0,0,4,0,10,14,9,1,1,11
2696,131866,2021,Thailand,Germany,0,0,0,0,12/06/2021,0,0,8,8,0,0,0,0,0,0,0,0,4,0,7,11,7,1,2,10
2697,131866,2021,Thailand,Dominican Republic,0,0,0,0,08/06/2021,0,0,9,9,0,0,0,0,0,0,0,0,20,1,19,40,4,0,0,4
2698,131866,2021,Russia,Thailand,0,0,0,0,07/06/2021,0,0,1,1,0,0,0,0,0,0,0,0,14,3,18,35,4,1,2,7
2699,131866,2021,Türkiye,Thailand,0,0,0,0,06/06/2021,0,0,10,10,0,0,0,0,0,0,0,0,11,2,10,23,10,1,0,11
2700,131866,2021,Thailand,USA,0,0,0,0,02/06/2021,0,0,7,7,0,0,0,0,0,0,0,0,4,1,5,10,5,7,1,13
2701,131866,2021,Serbia,Thailand,0,0,0,0,01/06/2021,0,0,4,4,0,0,0,0,0,0,0,0,6,0,6,12,12,2,1,15
2702,131866,2021,Thailand,Netherlands,0,0,0,0,31/05/2021,0,0,1,1,0,0,0,0,0,0,0,0,4,1,9,14,6,5,0,11
2703,131866,2021,China,Thailand,0,0,0,0,27/05/2021,0,0,6,6,0,0,0,0,0,0,0,0,13,0,7,20,6,2,1,9
2704,131866,2021,Thailand,Korea,0,0,0,0,26/05/2021,0,0,8,8,0,0,0,0,0,0,0,0,11,1,6,18,9,1,1,11
2705,131866,2021,Japan,Thailand,0,0,0,0,25/05/2021,0,0,0,0,0,0,0,0,0,0,0,0,1,3,5,9,6,0,1,7
2706,181410,2021,Thailand,Italy,0,0,0,0,20/06/2021,0,0,0,0,0,0,0,0,0,0,0,0,0,0,0,0,0,0,0,0
2707,181410,2021,Thailand,Canada,0,0,0,0,19/06/2021,0,0,0,0,0,0,0,0,0,0,0,0,0,0,0,0,0,0,0,0
2708,181410,2021,Thailand,Poland,0,0,0,0,13/06/2021,1,0,4,5,0,0,0,0,0,0,0,0,0,0,0,0,0,2,0,2
2709,181410,2021,Thailand,Germany,0,0,0,0,12/06/2021,0,0,0,0,0,0,0,0,0,0,0,0,0,0,0,0,0,0,0,0
2710,181410,2021,Türkiye,Thailand,0,0,7,7,06/06/2021,7,0,50,57,0,0,0,0,0,0,1,1,0,0,0,0,4,0,2,6
2711,181410,2021,Thailand,USA,0,0,2,2,02/06/2021,2,0,26,28,0,0,0,0,0,0,0,0,0,0,0,0,0,2,0,2
2712,181410,2021,Serbia,Thailand,0,0,1,1,01/06/2021,0,0,7,7,1,1,0,2,0,1,1,2,0,0,0,0,0,0,0,0
2713,181410,2021,Thailand,Netherlands,0,0,0,0,31/05/2021,0,0,0,0,0,0,0,0,0,0,0,0,0,0,0,0,0,1,0,1
2714,181410,2021,China,Thailand,0,0,0,0,27/05/2021,0,0,4,4,0,0,0,0,0,0,0,0,0,0,0,0,0,0,0,0
2715,181410,2021,Thailand,Korea,0,0,1,1,26/05/2021,2,0,12,14,0,0,0,0,0,0,0,0,0,0,0,0,3,0,0,3
2716,181410,2021,Japan,Thailand,0,0,0,0,25/05/2021,1,0,7,8,0,0,0,0,0,0,0,0,0,0,0,0,1,0,0,1
2717,113352,2021,Thailand,Italy,1,1,11,13,20/06/2021,0,0,3,3,12,2,15,29,3,5,4,12,0,0,0,0,6,3,1,10
2718,113352,2021,Thailand,Canada,2,1,9,12,19/06/2021,0,0,3,3,10,1,11,22,1,4,7,12,0,0,0,0,2,0,1,3
2719,113352,2021,Thailand,Belgium,0,4,9,13,18/06/2021,0,0,3,3,12,2,15,29,1,2,1,4,0,0,0,0,3,1,0,4
2720,113352,2021,Brazil,Thailand,0,1,4,5,14/06/2021,0,0,2,2,8,2,8,18,0,0,0,0,0,0,0,0,0,0,0,0
2721,113352,2021,Thailand,Poland,0,1,8,9,13/06/2021,0,1,4,5,6,1,8,15,0,2,7,9,0,0,0,0,1,1,1,3
2722,113352,2021,Thailand,Germany,2,2,12,16,12/06/2021,0,0,1,1,12,1,10,23,1,5,4,10,0,0,3,3,10,0,2,12
2723,113352,2021,Thailand,Dominican Republic,0,1,8,9,08/06/2021,0,0,1,1,9,3,16,28,3,2,1,6,0,0,0,0,1,2,1,4
2724,113352,2021,Russia,Thailand,3,0,9,12,07/06/2021,0,0,5,5,15,4,13,32,1,5,4,10,1,0,3,4,5,2,1,8
2725,113352,2021,Türkiye,Thailand,0,0,10,10,06/06/2021,0,0,4,4,6,3,11,20,2,4,1,7,0,0,1,1,2,0,0,2
2726,113352,2021,Thailand,USA,0,0,8,8,02/06/2021,0,0,2,2,4,0,12,16,0,3,0,3,0,0,0,0,2,1,0,3
2727,113352,2021,Serbia,Thailand,1,0,12,13,01/06/2021,0,0,1,1,6,3,18,27,1,3,4,8,1,0,1,2,4,1,0,5
2728,113352,2021,Thailand,Netherlands,2,1,4,7,31/05/2021,0,0,0,0,5,2,6,13,1,2,2,5,0,0,0,0,0,0,0,0
2729,113352,2021,China,Thailand,0,0,6,6,27/05/2021,0,0,1,1,6,2,8,16,2,2,2,6,0,0,0,0,1,1,0,2
2730,113352,2021,Thailand,Korea,1,1,6,8,26/05/2021,0,0,2,2,12,4,26,42,2,7,4,13,0,0,0,0,3,0,1,4
2731,113352,2021,Japan,Thailand,0,2,7,9,25/05/2021,0,0,0,0,9,1,8,18,1,2,2,5,0,0,1,1,2,0,0,2
2732,114638,2021,Thailand,Italy,0,2,15,17,20/06/2021,0,0,7,7,24,4,25,53,0,4,2,6,4,1,7,12,15,3,1,19
2733,114638,2021,Thailand,Canada,0,1,7,8,19/06/2021,0,0,0,0,10,2,6,18,0,1,1,2,0,0,5,5,5,1,0,6
2734,114638,2021,Thailand,Belgium,1,0,12,13,18/06/2021,0,0,6,6,11,8,22,41,0,2,1,3,0,1,2,3,7,6,1,14
2735,114638,2021,Brazil,Thailand,0,1,6,7,14/06/2021,0,1,3,4,8,6,13,27,0,0,0,0,7,0,7,14,3,2,0,5
2736,114638,2021,Thailand,Poland,0,1,11,12,13/06/2021,0,1,1,2,10,5,14,29,0,2,2,4,1,1,1,3,7,2,2,11
2737,114638,2021,Thailand,Germany,0,2,17,19,12/06/2021,0,0,4,4,20,5,25,50,0,0,8,8,2,1,9,12,11,2,2,15
2738,114638,2021,Thailand,Dominican Republic,1,0,5,6,08/06/2021,1,0,0,1,6,6,25,37,0,2,1,3,3,0,0,3,5,2,0,7
2739,114638,2021,Russia,Thailand,0,1,13,14,07/06/2021,0,0,2,2,9,12,17,38,0,4,2,6,4,0,3,7,8,2,2,12
2740,114638,2021,Türkiye,Thailand,0,1,9,10,06/06/2021,0,0,4,4,14,4,13,31,0,2,0,2,2,0,6,8,2,7,1,10
2741,114638,2021,Thailand,USA,0,2,7,9,02/06/2021,0,0,4,4,7,5,12,24,0,0,0,0,3,4,17,24,2,1,0,3
2742,114638,2021,Serbia,Thailand,1,1,10,12,01/06/2021,0,0,4,4,12,4,21,37,0,1,0,1,4,0,11,15,10,3,2,15
2743,114638,2021,Thailand,Netherlands,0,0,7,7,31/05/2021,0,0,0,0,10,4,17,31,0,0,1,1,1,0,3,4,1,3,0,4
2744,114638,2021,China,Thailand,2,1,10,13,27/05/2021,0,0,1,1,11,4,11,26,0,2,0,2,4,3,12,19,5,0,1,6
2745,114638,2021,Thailand,Korea,0,1,8,9,26/05/2021,0,0,2,2,8,4,21,33,0,4,3,7,1,1,6,8,11,0,0,11
2746,114638,2021,Japan,Thailand,0,1,6,7,25/05/2021,0,0,0,0,7,6,16,29,1,0,2,3,2,0,4,6,4,2,0,6
2747,152186,2021,Brazil,Thailand,0,0,0,0,14/06/2021,0,0,0,0,0,0,0,0,0,0,0,0,0,0,0,0,0,0,0,0
2748,152186,2021,Thailand,USA,0,0,0,0,02/06/2021,0,0,0,0,0,0,1,1,0,0,0,0,0,0,0,0,0,0,0,0
2749,152186,2021,Japan,Thailand,0,0,0,0,25/05/2021,0,0,0,0,0,0,0,0,0,0,0,0,0,0,0,0,0,0,0,0
2750,122866,2021,Thailand,Italy,0,0,16,16,20/06/2021,0,0,3,3,12,5,18,35,0,3,2,5,6,2,12,20,11,4,1,16
2751,122866,2021,Thailand,Canada,0,1,9,10,19/06/2021,0,0,2,2,8,4,10,22,0,2,2,4,4,0,7,11,12,1,1,14
2752,122866,2021,Thailand,Belgium,0,0,14,14,18/06/2021,0,0,2,2,12,1,13,26,0,0,0,0,6,1,20,27,4,5,0,9
2753,122866,2021,Brazil,Thailand,0,0,5,5,14/06/2021,0,0,1,1,0,2,6,8,0,0,0,0,2,2,8,12,3,1,0,4
2754,122866,2021,Thailand,Poland,0,0,5,5,13/06/2021,0,0,2,2,3,0,10,13,0,0,2,2,4,0,12,16,3,3,0,6
2755,122866,2021,Thailand,Germany,1,0,15,16,12/06/2021,0,0,2,2,13,1,7,21,0,0,1,1,5,3,15,23,10,2,2,14
2756,122866,2021,Thailand,Dominican Republic,0,0,11,11,08/06/2021,0,0,0,0,4,1,7,12,0,2,0,2,1,1,3,5,3,1,0,4
2757,122866,2021,Russia,Thailand,0,0,4,4,07/06/2021,0,0,3,3,1,2,2,5,0,0,1,1,1,1,7,9,2,2,1,5
2758,122866,2021,Türkiye,Thailand,0,1,9,10,06/06/2021,0,0,2,2,7,5,11,23,0,3,0,3,4,3,12,19,0,0,0,0
2759,122866,2021,Thailand,USA,0,0,5,5,02/06/2021,0,0,1,1,4,1,8,13,0,0,0,0,0,0,8,8,2,1,0,3
2760,122866,2021,Serbia,Thailand,1,0,6,7,01/06/2021,0,0,0,0,5,6,6,17,0,3,0,3,2,0,6,8,5,1,0,6
2761,122866,2021,Thailand,Netherlands,0,0,5,5,31/05/2021,0,0,0,0,2,3,5,10,0,1,0,1,2,2,8,12,1,2,0,3
2762,122866,2021,China,Thailand,0,0,3,3,27/05/2021,0,0,0,0,2,0,7,9,0,1,0,1,1,1,0,2,1,0,0,1
2763,122866,2021,Thailand,Korea,0,0,10,10,26/05/2021,0,0,0,0,8,4,19,31,0,1,1,2,7,2,12,21,13,3,4,20
2764,122866,2021,Japan,Thailand,0,1,4,5,25/05/2021,0,0,0,0,5,4,7,16,0,0,1,1,8,0,13,21,5,1,0,6
2765,113916,2021,Thailand,Italy,0,0,0,0,20/06/2021,0,0,9,9,0,0,0,0,0,0,0,0,4,1,7,12,11,1,1,13
2766,113916,2021,Thailand,Canada,0,0,3,3,19/06/2021,0,0,2,2,0,0,0,0,0,0,0,0,0,0,4,4,4,0,0,4
2767,113916,2021,Thailand,Belgium,0,0,3,3,18/06/2021,0,0,0,0,1,1,2,4,0,0,0,0,2,0,3,5,2,2,1,5
2768,113916,2021,Brazil,Thailand,0,0,3,3,14/06/2021,0,0,1,1,1,3,12,16,0,2,0,2,2,1,11,14,1,1,0,2
2769,113916,2021,Thailand,Poland,0,0,5,5,13/06/2021,0,0,3,3,2,1,10,13,0,3,1,4,3,0,8,11,7,0,3,10
2770,113916,2021,Thailand,Germany,0,0,0,0,12/06/2021,0,0,0,0,0,0,0,0,0,0,0,0,0,0,2,2,0,0,0,0
2771,113916,2021,Thailand,Dominican Republic,0,0,0,0,08/06/2021,0,0,1,1,0,0,0,0,0,0,0,0,0,0,0,0,4,8,0,12
2772,113916,2021,Russia,Thailand,0,0,0,0,07/06/2021,0,0,5,5,0,0,0,0,0,0,0,0,2,0,1,3,10,1,1,12
2773,113916,2021,Türkiye,Thailand,0,0,0,0,06/06/2021,0,0,1,1,0,0,0,0,0,0,0,0,0,0,0,0,4,2,1,7
2774,113916,2021,Thailand,USA,0,0,0,0,02/06/2021,0,0,0,0,0,0,0,0,0,0,0,0,0,0,0,0,1,0,0,1
2775,113916,2021,Serbia,Thailand,0,0,0,0,01/06/2021,0,0,2,2,0,0,0,0,0,0,0,0,0,0,0,0,8,1,1,10
2776,113916,2021,Thailand,Netherlands,0,0,0,0,31/05/2021,0,0,0,0,0,0,0,0,0,0,0,0,0,0,0,0,6,5,1,12
2777,113916,2021,China,Thailand,0,0,5,5,27/05/2021,0,0,2,2,2,1,5,8,1,2,0,3,1,0,6,7,4,2,0,6
2778,113916,2021,Thailand,Korea,0,0,2,2,26/05/2021,0,0,0,0,1,0,0,1,0,0,1,1,3,0,4,7,1,0,1,2
2779,113916,2021,Japan,Thailand,0,0,2,2,25/05/2021,0,0,0,0,1,0,2,3,0,0,0,0,0,1,6,7,0,1,0,1
2780,113358,2021,Thailand,Italy,0,0,1,1,20/06/2021,0,0,1,1,0,1,1,2,0,0,1,1,0,0,0,0,1,0,0,1
2781,113358,2021,Thailand,Canada,0,0,0,0,19/06/2021,0,0,0,0,0,0,0,0,0,0,0,0,0,0,0,0,0,0,0,0
2782,113358,2021,Thailand,Belgium,0,0,0,0,18/06/2021,0,0,0,0,0,0,0,0,0,0,0,0,0,0,0,0,0,0,0,0
2783,113358,2021,Thailand,Poland,0,0,0,0,13/06/2021,0,0,0,0,0,0,0,0,0,0,0,0,0,0,0,0,0,0,0,0
2784,113358,2021,Thailand,Germany,0,0,6,6,12/06/2021,0,0,1,1,0,2,2,4,0,0,3,3,0,0,2,2,1,1,0,2
2785,113358,2021,Thailand,Dominican Republic,0,1,3,4,08/06/2021,0,0,0,0,3,0,5,8,0,2,1,3,0,0,0,0,3,1,0,4
2786,113358,2021,Russia,Thailand,1,0,9,10,07/06/2021,0,0,2,2,2,2,5,9,1,1,0,2,1,1,1,3,2,0,0,2
2787,113358,2021,Türkiye,Thailand,0,0,6,6,06/06/2021,0,0,0,0,1,2,1,4,0,1,1,2,0,0,0,0,2,0,0,2
2788,113358,2021,Serbia,Thailand,0,0,0,0,01/06/2021,0,0,0,0,0,0,0,0,0,0,0,0,0,0,0,0,0,0,0,0
2789,113358,2021,Thailand,Netherlands,0,0,0,0,31/05/2021,0,0,0,0,0,0,0,0,0,0,0,0,0,0,0,0,0,0,0,0
2790,113358,2021,China,Thailand,0,0,2,2,27/05/2021,0,0,0,0,2,0,0,2,0,1,1,2,0,0,0,0,0,0,1,1
2791,113358,2021,Thailand,Korea,4,0,8,12,26/05/2021,0,0,2,2,3,1,5,9,0,1,0,1,0,0,0,0,1,3,0,4
2792,113358,2021,Japan,Thailand,0,0,0,0,25/05/2021,0,0,0,0,0,0,0,0,0,0,0,0,0,0,0,0,0,0,0,0
2793,118998,2021,Thailand,Canada,0,0,0,0,19/06/2021,0,0,2,2,0,0,0,0,0,0,0,0,0,0,0,0,3,1,0,4
2794,118998,2021,Thailand,Belgium,0,0,0,0,18/06/2021,0,0,4,4,0,0,0,0,0,0,0,0,0,0,0,0,8,8,1,17
2795,118998,2021,Brazil,Thailand,0,0,0,0,14/06/2021,0,0,0,0,0,0,0,0,0,0,0,0,0,0,0,0,0,0,0,0
2796,118998,2021,Thailand,Poland,0,0,0,0,13/06/2021,0,0,0,0,0,0,0,0,0,0,0,0,0,0,0,0,4,1,2,7
2797,118998,2021,Thailand,Germany,0,0,0,0,12/06/2021,0,0,4,4,0,0,0,0,0,0,0,0,0,0,0,0,8,0,1,9
2798,118998,2021,Thailand,Dominican Republic,0,0,0,0,08/06/2021,0,0,0,0,0,0,0,0,0,0,0,0,0,0,0,0,2,0,0,2
2799,118998,2021,Russia,Thailand,0,0,1,1,07/06/2021,0,0,1,1,1,0,1,2,0,0,1,1,0,0,4,4,2,0,0,2
2800,118998,2021,Türkiye,Thailand,0,0,1,1,06/06/2021,0,0,1,1,0,0,3,3,0,0,0,0,1,2,6,9,3,0,1,4
2801,118998,2021,Thailand,USA,0,0,2,2,02/06/2021,0,0,1,1,1,2,3,6,0,0,0,0,0,0,4,4,2,2,0,4
2802,118998,2021,Serbia,Thailand,1,0,2,3,01/06/2021,0,0,2,2,0,2,2,4,0,1,0,1,1,0,2,3,5,0,0,5
2803,118998,2021,Thailand,Netherlands,0,0,4,4,31/05/2021,0,0,0,0,2,1,5,8,0,0,0,0,6,0,4,10,0,0,0,0
2804,118998,2021,China,Thailand,0,0,0,0,27/05/2021,0,0,1,1,0,0,0,0,0,0,0,0,0,0,0,0,4,1,4,9
2805,118998,2021,Thailand,Korea,0,0,0,0,26/05/2021,0,0,1,1,0,0,0,0,0,0,0,0,2,0,2,4,4,4,1,9
2806,118998,2021,Japan,Thailand,0,0,0,0,25/05/2021,0,0,1,1,0,0,0,0,0,0,0,0,1,0,7,8,6,2,2,10
2807,113917,2021,Thailand,Italy,1,1,16,18,20/06/2021,22,2,129,153,2,0,3,5,0,1,2,3,0,0,0,0,21,3,3,27
2808,113917,2021,Thailand,Canada,1,1,7,9,19/06/2021,8,0,68,76,0,0,1,1,0,2,3,5,0,0,0,0,4,0,1,5
2809,113917,2021,Thailand,Belgium,1,0,14,15,18/06/2021,16,0,84,100,0,0,5,5,0,0,1,1,0,0,0,0,8,4,0,12
2810,113917,2021,Brazil,Thailand,0,1,2,3,14/06/2021,8,2,71,81,0,0,3,3,0,0,1,1,0,0,0,0,4,2,0,6
2811,113917,2021,Thailand,Poland,1,1,7,9,13/06/2021,24,0,49,73,1,0,2,3,0,2,2,4,0,1,0,1,7,1,3,11
2812,113917,2021,Thailand,Germany,0,1,19,20,12/06/2021,12,2,105,119,2,0,0,2,1,2,3,6,0,0,0,0,14,4,0,18
2813,113917,2021,Thailand,Dominican Republic,0,0,1,1,08/06/2021,12,0,36,48,0,0,3,3,0,1,2,3,0,0,0,0,2,2,0,4
2814,113917,2021,Russia,Thailand,1,0,9,10,07/06/2021,20,0,60,80,1,0,2,3,0,4,3,7,0,0,0,0,12,0,2,14
2815,113917,2021,Türkiye,Thailand,0,0,4,4,06/06/2021,3,0,31,34,0,0,1,1,1,1,0,2,0,0,0,0,7,2,0,9
2816,113917,2021,Thailand,USA,0,0,4,4,02/06/2021,0,0,49,49,0,0,0,0,0,0,0,0,0,0,0,0,0,2,0,2
2817,113917,2021,Serbia,Thailand,0,0,9,9,01/06/2021,10,0,97,107,0,2,1,3,0,1,2,3,0,0,1,1,9,2,0,11
2818,113917,2021,Thailand,Netherlands,0,0,7,7,31/05/2021,6,0,0,6,0,1,2,3,1,0,1,2,0,0,0,0,1,7,0,8
2819,113917,2021,China,Thailand,0,1,8,9,27/05/2021,15,1,63,79,2,2,1,5,0,0,1,1,0,0,1,1,6,2,0,8
2820,113917,2021,Thailand,Korea,0,0,11,11,26/05/2021,21,1,93,115,2,0,1,3,0,2,0,2,0,0,1,1,9,2,2,13
2821,113917,2021,Japan,Thailand,1,1,6,8,25/05/2021,9,4,72,85,0,1,2,3,0,0,0,0,0,0,0,0,7,0,3,10
2822,152206,2021,Thailand,Italy,0,0,0,0,20/06/2021,0,0,0,0,0,0,0,0,0,0,0,0,0,0,0,0,0,0,0,0
2823,152206,2021,Thailand,Canada,0,0,0,0,19/06/2021,0,0,0,0,0,0,0,0,0,0,0,0,0,0,0,0,0,0,0,0
2824,152206,2021,Thailand,Belgium,0,0,0,0,18/06/2021,0,0,0,0,0,0,0,0,0,0,0,0,0,0,0,0,0,0,0,0
2825,152206,2021,Brazil,Thailand,0,0,0,0,14/06/2021,0,0,1,1,0,2,1,3,0,0,0,0,0,0,0,0,0,0,0,0
2826,152206,2021,Thailand,Poland,0,1,0,1,13/06/2021,0,0,0,0,0,1,1,2,0,0,0,0,0,0,0,0,0,0,0,0
2827,152206,2021,Thailand,Germany,0,0,0,0,12/06/2021,0,0,0,0,0,0,0,0,0,0,0,0,0,0,0,0,0,0,0,0
2828,152206,2021,Thailand,Dominican Republic,0,0,3,3,08/06/2021,0,0,0,0,1,2,1,4,0,0,0,0,0,0,2,2,1,1,0,2
2829,152206,2021,Russia,Thailand,0,1,1,2,07/06/2021,0,0,0,0,1,1,0,2,0,0,0,0,0,0,1,1,0,0,0,0
2830,152206,2021,Türkiye,Thailand,0,0,2,2,06/06/2021,0,0,0,0,1,4,4,9,0,0,0,0,1,0,2,3,1,0,2,3
2831,152206,2021,Thailand,USA,0,0,1,1,02/06/2021,0,0,0,0,1,1,0,2,0,0,0,0,0,0,0,0,0,0,0,0
2832,152206,2021,Serbia,Thailand,0,0,3,3,01/06/2021,0,0,0,0,3,1,4,8,0,0,0,0,2,0,2,4,1,1,0,2
2833,152206,2021,Thailand,Netherlands,0,0,0,0,31/05/2021,0,0,0,0,1,2,1,4,0,0,0,0,0,0,0,0,0,0,0,0
2834,152206,2021,China,Thailand,0,0,0,0,27/05/2021,0,0,0,0,0,3,0,3,0,0,0,0,0,0,0,0,0,0,0,0
2835,152206,2021,Japan,Thailand,0,0,0,0,25/05/2021,0,0,0,0,0,1,0,1,0,1,0,1,0,0,0,0,0,0,0,0
2836,114283,2021,Thailand,Italy,1,2,16,19,20/06/2021,0,0,2,2,8,7,24,39,0,6,6,12,6,2,19,27,12,1,1,14
2837,114283,2021,Thailand,Canada,2,0,19,21,19/06/2021,0,0,1,1,13,1,6,20,1,4,6,11,5,0,1,6,11,1,2,14
2838,114283,2021,Thailand,Belgium,0,0,16,16,18/06/2021,0,0,2,2,16,2,13,31,0,2,1,3,7,3,10,20,11,6,2,19
2839,114283,2021,Brazil,Thailand,0,1,3,4,14/06/2021,0,1,0,1,6,2,12,20,0,0,1,1,5,2,8,15,1,2,0,3
2840,114283,2021,Thailand,Poland,1,1,8,10,13/06/2021,0,0,5,5,6,3,11,20,0,2,4,6,5,1,7,13,5,2,1,8
2841,114283,2021,Thailand,Germany,0,2,11,13,12/06/2021,0,0,5,5,9,5,18,32,1,4,4,9,6,0,12,18,7,3,2,12
2842,114283,2021,Thailand,Dominican Republic,0,1,6,7,08/06/2021,0,1,1,2,3,5,11,19,0,2,0,2,7,1,7,15,6,2,0,8
2843,114283,2021,Russia,Thailand,0,1,10,11,07/06/2021,0,0,3,3,6,3,10,19,2,5,4,11,3,0,9,12,3,3,1,7
2844,114283,2021,Türkiye,Thailand,0,1,8,9,06/06/2021,1,0,1,2,4,0,14,18,0,4,2,6,3,3,9,15,7,5,1,13
2845,114283,2021,Thailand,USA,0,0,5,5,02/06/2021,0,0,1,1,3,3,7,13,1,0,0,1,4,2,9,15,4,1,0,5
2846,114283,2021,Serbia,Thailand,0,0,6,6,01/06/2021,0,0,1,1,1,5,9,15,0,0,0,0,1,4,5,10,5,2,3,10
2847,114283,2021,Thailand,Netherlands,0,1,8,9,31/05/2021,0,0,0,0,5,1,7,13,0,0,1,1,7,1,9,17,9,3,1,13
2848,114283,2021,China,Thailand,0,1,7,8,27/05/2021,0,0,0,0,8,4,4,16,0,5,2,7,6,1,11,18,3,1,1,5
2849,114283,2021,Thailand,Korea,0,2,10,12,26/05/2021,0,0,2,2,5,2,13,20,0,2,2,4,6,0,11,17,8,3,0,11
2850,114283,2021,Japan,Thailand,1,0,8,9,25/05/2021,0,0,0,0,7,2,8,17,0,1,3,4,7,1,7,15,3,0,2,5
2851,167829,2021,Brazil,Thailand,0,0,0,0,14/06/2021,0,0,9,9,0,0,0,0,0,0,0,0,0,0,0,0,2,0,0,2
2852,167829,2021,Russia,Thailand,0,0,2,2,07/06/2021,4,0,24,28,0,0,2,2,0,1,0,1,0,0,0,0,0,0,0,0
2853,167829,2021,Thailand,Korea,0,0,0,0,26/05/2021,0,0,0,0,0,0,0,0,0,0,0,0,0,0,0,0,0,0,0,0
2854,119003,2021,Thailand,Italy,1,1,10,12,20/06/2021,,,,,2,2,4,8,0,0,1,1,0,1,0,1,4,0,1,5
2855,119003,2021,Thailand,Canada,0,1,10,11,19/06/2021,,,,,5,0,5,10,0,1,2,3,0,0,1,1,2,0,0,2
2856,119003,2021,Thailand,Belgium,0,0,8,8,18/06/2021,,,,,10,1,5,16,1,0,1,2,0,0,0,0,1,3,0,4
2857,119003,2021,Brazil,Thailand,0,0,6,6,14/06/2021,,,,,2,0,5,7,1,1,0,2,0,0,0,0,0,1,0,1
2858,119003,2021,Thailand,Poland,0,1,7,8,13/06/2021,,,,,9,0,2,11,0,4,5,9,0,0,0,0,5,0,0,5
2859,119003,2021,Thailand,Germany,0,1,7,8,12/06/2021,,,,,4,2,4,10,0,1,2,3,0,0,0,0,3,0,0,3
2860,119003,2021,Thailand,Dominican Republic,0,0,5,5,08/06/2021,,,,,6,1,2,9,0,1,1,2,0,0,0,0,2,0,0,2
2861,119003,2021,Russia,Thailand,0,1,4,5,07/06/2021,,,,,7,0,2,9,0,1,0,1,0,0,0,0,1,0,0,1
2862,119003,2021,Türkiye,Thailand,0,0,5,5,06/06/2021,,,,,1,0,1,2,1,0,1,2,0,1,1,2,4,0,0,4
2863,119003,2021,Thailand,USA,0,2,6,8,02/06/2021,,,,,4,2,4,10,0,1,0,1,0,0,0,0,0,1,0,1
2864,119003,2021,Serbia,Thailand,0,0,6,6,01/06/2021,,,,,3,1,3,7,0,0,2,2,1,0,1,2,1,0,0,1
2865,119003,2021,Thailand,Netherlands,0,1,2,3,31/05/2021,,,,,1,4,1,6,0,0,0,0,0,0,0,0,0,0,0,0
2866,119003,2021,China,Thailand,0,0,8,8,27/05/2021,,,,,4,3,2,9,0,2,2,4,0,0,0,0,0,2,0,2
2867,119003,2021,Thailand,Korea,0,0,6,6,26/05/2021,,,,,4,0,4,8,1,2,2,5,0,0,0,0,0,0,0,0
2868,119003,2021,Japan,Thailand,0,1,8,9,25/05/2021,,,,,5,1,4,10,0,3,1,4,0,0,0,0,1,0,1,2
2869,147188,2021,Thailand,Italy,0,0,0,0,20/06/2021,0,0,0,0,0,0,0,0,0,0,0,0,0,0,0,0,0,0,0,0
2870,147188,2021,Thailand,Belgium,0,0,3,3,18/06/2021,1,0,24,25,0,0,0,0,0,0,0,0,0,0,0,0,1,1,0,2
2871,147188,2021,Thailand,Dominican Republic,0,0,8,8,08/06/2021,10,1,48,59,1,0,4,5,0,1,0,1,0,0,1,1,4,1,0,5
2872,152207,2021,Thailand,Italy,0,0,2,2,20/06/2021,0,0,0,0,0,0,0,0,0,0,0,0,0,0,0,0,0,0,0,0
2873,152207,2021,Thailand,Canada,0,0,0,0,19/06/2021,0,0,0,0,0,0,0,0,0,0,0,0,0,0,0,0,0,0,0,0
2874,152207,2021,Thailand,Belgium,1,0,2,3,18/06/2021,0,0,0,0,0,2,0,2,0,0,0,0,0,0,0,0,0,0,0,0
2875,152207,2021,Brazil,Thailand,0,0,1,1,14/06/2021,0,0,0,0,0,1,0,1,0,0,0,0,0,0,0,0,0,0,0,0
2876,152207,2021,Thailand,Poland,0,0,1,1,13/06/2021,0,0,0,0,2,0,1,3,0,1,0,1,0,0,3,3,0,1,0,1
2877,152207,2021,Thailand,Germany,0,0,0,0,12/06/2021,0,0,0,0,0,0,0,0,0,0,0,0,0,0,0,0,0,0,0,0
2878,152207,2021,Thailand,Dominican Republic,0,0,3,3,08/06/2021,0,0,2,2,0,1,5,6,0,0,0,0,0,0,3,3,0,0,0,0
2879,152207,2021,Russia,Thailand,1,0,2,3,07/06/2021,0,0,0,0,1,1,9,11,0,0,0,0,1,1,0,2,2,1,0,3
2880,152207,2021,Türkiye,Thailand,0,0,2,2,06/06/2021,0,0,1,1,0,0,5,5,0,1,0,1,1,0,5,6,0,0,0,0
2881,152207,2021,Thailand,USA,0,0,1,1,02/06/2021,0,0,1,1,1,1,3,5,0,0,0,0,0,0,2,2,0,0,0,0
2882,152207,2021,Serbia,Thailand,0,1,3,4,01/06/2021,0,0,0,0,0,2,5,7,0,1,0,1,3,0,5,8,1,0,0,1
2883,152207,2021,Thailand,Netherlands,0,0,1,1,31/05/2021,0,0,0,0,0,0,1,1,0,0,0,0,1,0,4,5,2,1,0,3
2884,152207,2021,China,Thailand,0,0,0,0,27/05/2021,0,0,0,0,1,0,2,3,0,0,0,0,0,0,0,0,0,0,0,0
2885,152207,2021,Thailand,Korea,0,1,2,3,26/05/2021,0,0,0,0,0,0,1,1,0,0,0,0,1,1,2,4,1,1,0,2
2886,142178,2021,Thailand,Italy,0,2,2,4,20/06/2021,0,0,0,0,3,2,4,9,0,1,5,6,0,0,1,1,2,0,0,2
2887,142178,2021,Thailand,Canada,0,0,0,0,19/06/2021,0,0,0,0,0,0,0,0,0,0,0,0,0,0,0,0,0,0,0,0
2888,142178,2021,Thailand,Belgium,0,0,0,0,18/06/2021,0,0,1,1,0,0,0,0,0,0,0,0,0,0,0,0,0,0,0,0
2889,142178,2021,Brazil,Thailand,0,0,2,2,14/06/2021,0,0,0,0,1,0,1,2,0,0,0,0,0,0,0,0,0,0,0,0
2890,142178,2021,Thailand,Poland,0,0,0,0,13/06/2021,0,0,0,0,0,0,0,0,0,0,0,0,0,0,0,0,0,0,0,0
2891,142178,2021,Thailand,Germany,0,0,0,0,12/06/2021,0,0,0,0,0,0,0,0,0,0,0,0,0,0,0,0,0,0,0,0
2892,142178,2021,Thailand,Dominican Republic,0,0,0,0,08/06/2021,0,0,0,0,0,0,0,0,0,0,0,0,0,0,0,0,0,0,0,0
2893,142178,2021,Russia,Thailand,0,0,0,0,07/06/2021,0,0,0,0,0,0,0,0,0,0,0,0,0,0,0,0,0,0,0,0
2894,142178,2021,Türkiye,Thailand,0,0,1,1,06/06/2021,0,0,0,0,0,0,2,2,0,0,0,0,0,0,0,0,0,0,0,0
2895,142178,2021,Thailand,USA,0,0,4,4,02/06/2021,0,0,1,1,1,1,2,4,0,0,0,0,0,0,0,0,0,1,0,1
2896,142178,2021,Serbia,Thailand,1,0,2,3,01/06/2021,0,0,0,0,0,2,3,5,0,2,0,2,0,0,1,1,1,0,0,1
2897,142178,2021,Thailand,Netherlands,0,0,5,5,31/05/2021,0,0,0,0,2,1,9,12,1,1,0,2,0,1,0,1,0,0,0,0
2898,142178,2021,China,Thailand,0,0,1,1,27/05/2021,0,0,0,0,0,0,0,0,0,0,0,0,0,0,0,0,1,0,0,1
2899,142178,2021,Thailand,Korea,0,0,0,0,26/05/2021,0,0,0,0,0,0,0,0,0,0,0,0,0,0,0,0,0,0,0,0
2900,142178,2021,Japan,Thailand,0,0,0,0,25/05/2021,0,0,0,0,0,0,0,0,0,0,0,0,0,0,0,0,0,0,0,0
2901,158840,2021,Japan,Türkiye,0,0,0,0,25/06/2021,0,0,5,5,0,0,0,0,0,0,0,0,1,0,1,2,5,1,1,7
2902,158840,2021,USA,Türkiye,0,0,0,0,24/06/2021,0,0,9,9,0,0,0,0,0,0,0,0,9,3,4,16,12,4,0,16
2903,158840,2021,Brazil,Türkiye,0,0,0,0,20/06/2021,0,0,5,5,0,0,0,0,0,0,0,0,1,2,5,8,5,1,1,7
2904,158840,2021,Korea,Türkiye,0,0,0,0,19/06/2021,1,0,4,5,0,0,0,0,0,0,0,0,8,2,12,22,10,2,0,12
2905,158840,2021,Türkiye,Netherlands,0,0,0,0,18/06/2021,0,0,8,8,0,0,0,0,0,0,0,0,6,1,3,10,19,3,1,23
2906,158840,2021,USA,Türkiye,0,0,0,0,14/06/2021,0,0,8,8,0,0,0,0,0,0,0,0,9,1,11,21,14,4,1,19
2907,158840,2021,Türkiye,Belgium,0,0,0,0,13/06/2021,0,0,5,5,0,0,0,0,0,0,0,0,7,0,1,8,10,1,0,11
2908,158840,2021,Japan,Türkiye,0,0,0,0,12/06/2021,0,0,9,9,0,0,0,0,0,0,0,0,4,2,10,16,19,2,3,24
2909,158840,2021,Türkiye,Russia,0,0,0,0,08/06/2021,0,0,8,8,0,0,0,0,0,0,0,0,11,3,5,19,18,7,1,26
2910,158840,2021,Türkiye,Dominican Republic,0,0,0,0,07/06/2021,0,0,8,8,0,0,0,0,0,0,0,0,4,1,1,6,3,2,0,5
2911,158840,2021,Türkiye,Thailand,0,0,0,0,06/06/2021,0,0,8,8,0,0,0,0,0,0,0,0,4,0,11,15,23,3,0,26
2912,158840,2021,China,Türkiye,0,0,0,0,02/06/2021,0,0,0,0,0,0,0,0,0,0,0,0,0,0,0,0,0,0,0,0
2913,158840,2021,Türkiye,Germany,0,0,0,0,01/06/2021,0,0,9,9,0,0,0,0,0,0,0,0,5,2,4,11,15,1,2,18
2914,158840,2021,Canada,Türkiye,0,0,0,0,31/05/2021,0,0,15,15,0,0,0,0,0,0,0,0,6,1,7,14,24,7,4,35
2915,158840,2021,Poland,Türkiye,0,0,0,0,27/05/2021,0,0,4,4,0,0,0,0,0,0,0,0,1,1,5,7,6,1,1,8
2916,158840,2021,Türkiye,Italy,0,0,0,0,26/05/2021,0,0,1,1,0,0,0,0,0,0,0,0,5,0,3,8,7,4,0,11
2917,158840,2021,Türkiye,Serbia,0,0,0,0,25/05/2021,0,0,3,3,0,0,0,0,0,0,0,0,11,2,8,21,25,5,3,33
2918,143590,2021,Japan,Türkiye,0,0,16,16,25/06/2021,18,0,54,72,1,0,1,2,0,3,1,4,0,0,0,0,7,3,0,10
2919,143590,2021,USA,Türkiye,1,2,7,10,24/06/2021,10,0,83,93,3,0,1,4,0,2,2,4,0,0,1,1,15,0,1,16
2920,143590,2021,Brazil,Türkiye,0,0,5,5,20/06/2021,9,0,33,42,1,0,0,1,1,1,2,4,0,0,0,0,8,2,2,12
2921,143590,2021,Korea,Türkiye,1,2,18,21,19/06/2021,22,1,78,101,4,0,5,9,2,4,1,7,0,0,0,0,7,1,0,8
2922,143590,2021,Türkiye,Netherlands,0,3,11,14,18/06/2021,8,1,83,92,1,0,4,5,0,1,4,5,0,0,0,0,7,2,0,9
2923,143590,2021,USA,Türkiye,0,2,7,9,14/06/2021,9,1,78,88,0,0,1,1,0,4,1,5,0,0,0,0,11,2,2,15
2924,143590,2021,Türkiye,Belgium,0,1,3,4,13/06/2021,12,1,73,86,2,0,3,5,1,1,1,3,0,0,0,0,8,2,0,10
2925,143590,2021,Japan,Türkiye,0,4,8,12,12/06/2021,36,2,75,113,1,0,1,2,1,2,5,8,0,0,1,1,7,0,1,8
2926,143590,2021,Türkiye,Russia,2,3,10,15,08/06/2021,32,0,71,103,2,0,3,5,3,3,3,9,0,0,0,0,9,3,0,12
2927,143590,2021,Türkiye,Dominican Republic,0,0,3,3,07/06/2021,5,0,32,37,0,0,1,1,1,0,0,1,0,0,0,0,3,3,0,6
2928,143590,2021,Türkiye,Thailand,2,2,14,18,06/06/2021,42,0,59,101,3,0,0,3,0,2,1,3,0,0,0,0,5,1,0,6
2929,143590,2021,China,Türkiye,0,0,0,0,02/06/2021,2,0,3,5,0,0,0,0,0,0,0,0,0,0,0,0,0,0,0,0
2930,143590,2021,Türkiye,Germany,1,1,5,7,01/06/2021,14,0,32,46,0,0,0,0,0,4,1,5,0,0,0,0,3,3,0,6
2931,143590,2021,Canada,Türkiye,2,1,13,16,31/05/2021,20,2,65,87,1,0,1,2,0,2,1,3,0,0,0,0,14,1,1,16
2932,143590,2021,Poland,Türkiye,0,0,2,2,27/05/2021,8,0,15,23,1,0,0,1,0,0,0,0,0,0,0,0,0,0,0,0
2933,143590,2021,Türkiye,Italy,1,4,9,14,26/05/2021,16,0,52,68,0,0,0,0,0,1,0,1,0,0,0,0,2,2,0,4
2934,143590,2021,Türkiye,Serbia,0,1,6,7,25/05/2021,8,1,46,55,0,0,2,2,1,0,1,2,0,0,0,0,5,0,2,7
2935,152311,2021,Japan,Türkiye,0,2,6,8,25/06/2021,0,0,0,0,4,2,4,10,3,2,1,6,7,0,5,12,4,1,0,5
2936,152311,2021,USA,Türkiye,0,1,10,11,24/06/2021,0,0,0,0,3,3,5,11,0,3,2,5,3,1,8,12,4,0,0,4
2937,152311,2021,Brazil,Türkiye,0,0,12,12,20/06/2021,0,0,1,1,11,5,11,27,0,2,2,4,3,1,11,15,9,3,1,13
2938,152311,2021,Korea,Türkiye,0,0,0,0,19/06/2021,0,0,0,0,0,0,0,0,0,0,0,0,0,0,0,0,0,0,0,0
2939,152311,2021,Türkiye,Netherlands,0,0,0,0,18/06/2021,0,0,0,0,0,0,0,0,0,0,0,0,0,0,0,0,0,0,0,0
2940,152311,2021,USA,Türkiye,0,0,2,2,14/06/2021,0,0,1,1,1,3,3,7,0,1,0,1,3,1,5,9,0,0,0,0
2941,152311,2021,Türkiye,Belgium,0,0,0,0,13/06/2021,0,0,0,0,0,0,0,0,0,0,0,0,0,0,0,0,0,0,0,0
2942,152311,2021,Japan,Türkiye,1,0,4,5,12/06/2021,0,0,0,0,2,4,2,8,0,2,2,4,4,0,7,11,5,0,0,5
2943,152311,2021,Türkiye,Russia,2,0,19,21,08/06/2021,0,0,1,1,12,4,11,27,2,3,5,10,13,2,19,34,8,1,1,10
2944,152311,2021,Türkiye,Dominican Republic,2,2,4,8,07/06/2021,0,0,2,2,10,3,10,23,1,1,0,2,8,0,9,17,4,1,0,5
2945,152311,2021,Türkiye,Thailand,0,1,14,15,06/06/2021,0,0,1,1,10,4,7,21,3,0,2,5,10,0,16,26,17,1,1,19
2946,152311,2021,China,Türkiye,0,1,1,2,02/06/2021,0,0,0,0,1,0,0,1,0,0,0,0,0,0,3,3,2,1,1,4
2947,152311,2021,Türkiye,Germany,0,0,0,0,01/06/2021,0,0,0,0,0,0,0,0,0,0,0,0,0,0,0,0,0,0,0,0
2948,152311,2021,Canada,Türkiye,0,0,13,13,31/05/2021,0,0,0,0,10,3,17,30,2,4,5,11,6,0,28,34,12,4,0,16
2949,152311,2021,Poland,Türkiye,0,0,0,0,27/05/2021,0,0,0,0,2,1,0,3,0,0,0,0,0,0,3,3,1,0,0,1
2950,152311,2021,Türkiye,Italy,0,0,0,0,26/05/2021,0,0,0,0,0,0,0,0,0,0,0,0,0,0,0,0,0,0,0,0
2951,152311,2021,Türkiye,Serbia,1,1,3,5,25/05/2021,0,0,0,0,3,3,4,10,0,1,1,2,1,1,5,7,5,0,0,5
2952,137074,2021,Japan,Türkiye,0,0,0,0,25/06/2021,0,0,0,0,0,0,0,0,0,0,0,0,0,0,0,0,0,0,0,0
2953,137074,2021,USA,Türkiye,0,0,0,0,24/06/2021,0,0,0,0,0,0,0,0,0,0,0,0,0,0,0,0,0,0,0,0
2954,137074,2021,Brazil,Türkiye,0,0,0,0,20/06/2021,0,0,3,3,0,0,0,0,0,0,0,0,6,1,11,18,9,1,2,12
2955,137074,2021,Korea,Türkiye,0,0,2,2,19/06/2021,0,0,0,0,0,0,0,0,0,0,0,0,0,0,0,0,0,0,0,0
2956,137074,2021,Türkiye,Netherlands,0,0,2,2,18/06/2021,0,0,0,0,1,0,2,3,0,0,0,0,2,0,0,2,0,0,0,0
2957,137074,2021,USA,Türkiye,0,0,1,1,14/06/2021,0,0,0,0,1,0,1,2,0,1,0,1,1,0,3,4,0,0,1,1
2958,137074,2021,Türkiye,Belgium,0,0,0,0,13/06/2021,0,0,0,0,0,0,0,0,0,0,0,0,0,0,0,0,0,0,0,0
2959,137074,2021,Japan,Türkiye,1,2,4,7,12/06/2021,0,0,1,1,0,0,3,3,0,0,1,1,6,1,3,10,3,1,1,5
2960,137074,2021,Türkiye,Dominican Republic,0,0,0,0,07/06/2021,0,0,0,0,0,0,0,0,0,0,0,0,0,0,0,0,0,0,0,0
2961,137074,2021,Türkiye,Thailand,1,1,8,10,06/06/2021,0,0,0,0,4,1,2,7,0,0,0,0,5,0,2,7,5,0,0,5
2962,137074,2021,China,Türkiye,0,0,0,0,02/06/2021,0,0,0,0,0,0,0,0,0,0,0,0,0,0,0,0,0,0,0,0
2963,137074,2021,Türkiye,Germany,0,0,3,3,01/06/2021,0,0,0,0,0,1,1,2,0,0,0,0,0,0,2,2,2,1,0,3
2964,137074,2021,Canada,Türkiye,0,0,12,12,31/05/2021,0,0,0,0,0,1,1,2,0,1,0,1,2,0,3,5,1,0,0,1
2965,137074,2021,Poland,Türkiye,0,0,0,0,27/05/2021,0,0,0,0,0,0,0,0,0,0,0,0,0,0,0,0,1,0,0,1
2966,137074,2021,Türkiye,Italy,0,0,3,3,26/05/2021,0,0,0,0,0,0,0,0,0,0,0,0,0,0,0,0,0,0,0,0
2967,137074,2021,Türkiye,Serbia,0,0,3,3,25/05/2021,0,0,0,0,1,1,7,9,0,0,0,0,1,1,8,10,8,0,1,9
2968,137086,2021,Japan,Türkiye,0,2,16,18,25/06/2021,0,0,3,3,2,1,1,4,0,3,6,9,0,0,0,0,3,1,0,4
2969,137086,2021,USA,Türkiye,0,3,10,13,24/06/2021,0,0,2,2,4,1,4,9,1,4,2,7,1,0,1,2,1,0,0,1
2970,137086,2021,Brazil,Türkiye,0,0,0,0,20/06/2021,0,0,0,0,0,0,0,0,0,0,0,0,0,0,0,0,0,0,0,0
2971,137086,2021,Korea,Türkiye,0,1,4,5,19/06/2021,0,0,1,1,2,1,2,5,2,2,2,6,0,0,0,0,0,0,0,0
2972,137086,2021,Türkiye,Netherlands,0,0,0,0,18/06/2021,0,0,0,0,0,0,0,0,0,0,0,0,0,0,0,0,0,0,0,0
2973,137086,2021,USA,Türkiye,1,1,7,9,14/06/2021,0,0,0,0,1,1,1,3,1,3,2,6,0,0,0,0,1,0,0,1
2974,137086,2021,Japan,Türkiye,0,0,0,0,12/06/2021,0,0,0,0,0,0,0,0,0,0,0,0,0,0,0,0,0,0,0,0
2975,137086,2021,Türkiye,Russia,1,1,1,3,08/06/2021,0,0,0,0,0,0,0,0,0,0,0,0,0,0,0,0,0,0,0,0
2976,137086,2021,Türkiye,Dominican Republic,0,1,8,9,07/06/2021,0,0,0,0,1,3,1,5,1,2,2,5,0,0,0,0,0,2,0,2
2977,137086,2021,Türkiye,Thailand,1,1,3,5,06/06/2021,0,0,0,0,0,2,0,2,1,5,2,8,0,0,0,0,0,0,0,0
2978,137086,2021,China,Türkiye,1,1,8,10,02/06/2021,0,0,2,2,3,0,4,7,3,8,9,20,0,0,0,0,1,0,1,2
2979,137086,2021,Türkiye,Germany,0,1,3,4,01/06/2021,0,0,0,0,1,1,0,2,1,0,6,7,0,0,0,0,2,0,1,3
2980,137086,2021,Canada,Türkiye,0,1,7,8,31/05/2021,0,0,4,4,6,4,3,13,2,4,4,10,0,0,0,0,0,0,0,0
2981,137086,2021,Poland,Türkiye,0,1,14,15,27/05/2021,0,0,2,2,8,0,6,14,2,6,1,9,0,1,0,1,1,0,0,1
2982,137086,2021,Türkiye,Italy,0,0,0,0,26/05/2021,0,0,0,0,0,0,0,0,0,0,0,0,0,0,0,0,0,0,0,0
2983,137086,2021,Türkiye,Serbia,0,0,0,0,25/05/2021,0,0,0,0,0,0,0,0,0,0,0,0,0,0,0,0,0,0,0,0
2984,143585,2021,Japan,Türkiye,0,0,0,0,25/06/2021,0,0,0,0,0,0,0,0,0,0,0,0,0,0,0,0,0,0,0,0
2985,143585,2021,USA,Türkiye,1,2,8,11,24/06/2021,0,0,4,4,7,6,7,20,1,2,0,3,11,0,17,28,6,1,0,7
2986,143585,2021,Brazil,Türkiye,0,0,2,2,20/06/2021,0,0,0,0,1,3,6,10,0,2,3,5,2,0,5,7,1,0,0,1
2987,143585,2021,Korea,Türkiye,1,3,11,15,19/06/2021,0,0,0,0,9,6,12,27,0,2,1,3,11,0,16,27,5,4,0,9
2988,143585,2021,Türkiye,Netherlands,0,1,12,13,18/06/2021,0,0,2,2,14,4,11,29,2,0,1,3,6,1,9,16,6,2,0,8
2989,143585,2021,USA,Türkiye,2,2,5,9,14/06/2021,0,0,2,2,10,5,14,29,1,2,0,3,4,1,14,19,4,1,1,6
2990,143585,2021,Türkiye,Belgium,1,2,10,13,13/06/2021,0,0,1,1,16,5,12,33,0,3,0,3,8,1,10,19,6,0,1,7
2991,143585,2021,Japan,Türkiye,1,0,14,15,12/06/2021,0,0,4,4,15,3,10,28,1,1,0,2,9,1,16,26,7,6,1,14
2992,143585,2021,Türkiye,Russia,0,1,4,5,08/06/2021,0,0,0,0,3,1,3,7,0,0,0,0,2,0,3,5,4,1,0,5
2993,143585,2021,Türkiye,Dominican Republic,0,0,4,4,07/06/2021,0,0,0,0,2,2,7,11,0,2,1,3,3,1,5,9,1,2,0,3
2994,143585,2021,Türkiye,Thailand,3,2,9,14,06/06/2021,0,0,2,2,12,5,13,30,1,3,0,4,4,0,12,16,6,1,1,8
2995,143585,2021,China,Türkiye,0,0,11,11,02/06/2021,0,0,0,0,8,5,5,18,2,1,3,6,7,0,13,20,6,0,1,7
2996,143585,2021,Türkiye,Germany,0,0,8,8,01/06/2021,0,0,0,0,9,1,7,17,0,0,3,3,1,0,11,12,9,2,1,12
2997,143585,2021,Canada,Türkiye,0,1,14,15,31/05/2021,0,0,1,1,14,5,12,31,2,2,3,7,3,3,18,24,6,0,1,7
2998,143585,2021,Poland,Türkiye,0,2,14,16,27/05/2021,0,0,0,0,5,5,8,18,1,2,1,4,10,2,24,36,11,2,2,15
2999,143585,2021,Türkiye,Italy,1,1,8,10,26/05/2021,0,0,0,0,9,1,6,16,2,1,0,3,8,1,9,18,0,2,0,2
3000,143585,2021,Türkiye,Serbia,0,0,8,8,25/05/2021,0,0,0,0,6,4,6,16,0,2,0,2,5,5,17,27,10,0,1,11
3001,148070,2021,Japan,Türkiye,0,0,2,2,25/06/2021,0,0,0,0,0,0,0,0,0,0,0,0,0,0,0,0,0,0,0,0
3002,148070,2021,USA,Türkiye,0,0,4,4,24/06/2021,0,0,2,2,0,4,3,7,0,0,1,1,3,0,6,9,5,0,1,6
3003,148070,2021,Brazil,Türkiye,0,0,3,3,20/06/2021,0,0,1,1,1,0,3,4,0,1,0,1,4,1,11,16,1,0,1,2
3004,148070,2021,Korea,Türkiye,1,1,13,15,19/06/2021,0,0,1,1,9,1,6,16,2,1,2,5,7,3,17,27,11,1,1,13
3005,148070,2021,Türkiye,Netherlands,0,1,9,10,18/06/2021,0,0,0,0,0,1,9,10,2,1,1,4,10,2,18,30,10,0,2,12
3006,148070,2021,USA,Türkiye,1,2,13,16,14/06/2021,0,0,0,0,3,4,10,17,1,1,1,3,14,1,17,32,7,4,0,11
3007,148070,2021,Türkiye,Belgium,0,1,10,11,13/06/2021,0,0,1,1,8,2,5,15,0,1,1,2,7,1,11,19,13,1,0,14
3008,148070,2021,Japan,Türkiye,0,1,3,4,12/06/2021,0,0,1,1,3,3,8,14,0,2,1,3,5,1,15,21,3,2,4,9
3009,148070,2021,Türkiye,Russia,0,1,7,8,08/06/2021,0,0,3,3,3,2,13,18,1,2,2,5,8,1,14,23,3,3,1,7
3010,148070,2021,Türkiye,Dominican Republic,0,0,16,16,07/06/2021,0,0,1,1,5,2,9,16,0,2,2,4,14,1,20,35,3,5,0,8
3011,148070,2021,Türkiye,Thailand,0,0,0,0,06/06/2021,0,0,0,0,0,0,0,0,0,0,0,0,0,0,0,0,0,0,0,0
3012,148070,2021,China,Türkiye,2,1,13,16,02/06/2021,0,0,2,2,11,1,9,21,1,2,3,6,4,3,8,15,9,1,1,11
3013,148070,2021,Türkiye,Germany,1,0,14,15,01/06/2021,0,0,3,3,3,0,8,11,1,4,2,7,9,5,11,25,6,0,0,6
3014,148070,2021,Canada,Türkiye,1,0,5,6,31/05/2021,0,0,1,1,1,3,3,7,1,2,0,3,2,2,11,15,5,0,2,7
3015,148070,2021,Poland,Türkiye,0,0,13,13,27/05/2021,0,0,1,1,6,4,8,18,0,1,1,2,8,3,15,26,9,3,0,12
3016,148070,2021,Türkiye,Italy,0,0,10,10,26/05/2021,0,0,1,1,5,0,3,8,1,0,1,2,10,0,6,16,9,3,0,12
3017,148070,2021,Türkiye,Serbia,1,0,11,12,25/05/2021,0,0,1,1,3,5,9,17,2,0,0,2,8,0,19,27,7,0,1,8
3018,153618,2021,Japan,Türkiye,0,0,0,0,25/06/2021,0,0,0,0,0,0,0,0,0,0,0,0,0,0,0,0,0,0,0,0
3019,153618,2021,USA,Türkiye,0,0,1,1,24/06/2021,0,0,0,0,0,0,0,0,0,0,0,0,0,0,0,0,0,0,0,0
3020,153618,2021,Brazil,Türkiye,0,2,4,6,20/06/2021,16,0,56,72,1,0,2,3,1,1,3,5,0,0,0,0,1,1,0,2
3021,153618,2021,Korea,Türkiye,0,0,0,0,19/06/2021,1,0,3,4,0,0,0,0,0,0,0,0,0,0,1,1,1,0,0,1
3022,153618,2021,Türkiye,Netherlands,0,0,2,2,18/06/2021,0,0,2,2,0,0,0,0,0,0,0,0,0,0,0,0,0,0,0,0
3023,153618,2021,USA,Türkiye,0,0,0,0,14/06/2021,2,0,16,18,0,0,0,0,0,0,0,0,0,0,0,0,1,0,0,1
3024,153618,2021,Türkiye,Belgium,0,0,0,0,13/06/2021,0,0,0,0,0,0,0,0,0,0,0,0,0,0,0,0,0,0,0,0
3025,153618,2021,Japan,Türkiye,0,0,1,1,12/06/2021,0,0,1,1,0,0,0,0,0,0,0,0,0,0,0,0,0,0,0,0
3026,151195,2021,Japan,Türkiye,0,0,0,0,25/06/2021,0,0,0,0,0,0,0,0,0,0,0,0,0,0,0,0,0,0,0,0
3027,151195,2021,USA,Türkiye,0,0,0,0,24/06/2021,0,0,0,0,1,0,6,7,0,0,1,1,0,0,0,0,0,0,0,0
3028,151195,2021,Brazil,Türkiye,0,2,4,6,20/06/2021,0,0,0,0,6,2,15,23,0,1,1,2,0,0,0,0,8,0,2,10
3029,151195,2021,Korea,Türkiye,0,0,0,0,19/06/2021,0,0,0,0,1,0,2,3,0,0,0,0,0,0,0,0,0,0,0,0
3030,151195,2021,Türkiye,Netherlands,0,0,0,0,18/06/2021,0,0,0,0,0,0,0,0,0,0,0,0,0,0,0,0,0,0,0,0
3031,151195,2021,USA,Türkiye,0,0,6,6,14/06/2021,0,0,1,1,2,1,5,8,0,0,0,0,0,0,0,0,3,0,0,3
3032,151195,2021,Türkiye,Belgium,1,1,2,4,13/06/2021,0,0,0,0,0,0,0,0,0,0,0,0,0,0,0,0,0,0,0,0
3033,151195,2021,Japan,Türkiye,0,3,3,6,12/06/2021,0,0,0,0,9,4,15,28,0,3,5,8,0,0,0,0,5,0,0,5
3034,151195,2021,Türkiye,Russia,0,0,4,4,08/06/2021,0,1,0,1,5,3,5,13,0,0,1,1,0,0,0,0,2,0,0,2
3035,151195,2021,Türkiye,Dominican Republic,0,2,4,6,07/06/2021,0,0,0,0,9,5,15,29,1,2,0,3,0,0,0,0,0,2,0,2
3036,151195,2021,Türkiye,Thailand,2,2,11,15,06/06/2021,0,1,0,1,22,3,15,40,0,4,6,10,0,0,0,0,8,1,2,11
3037,151195,2021,China,Türkiye,0,0,0,0,02/06/2021,0,0,0,0,0,1,2,3,0,0,0,0,0,0,0,0,0,0,0,0
3038,151195,2021,Türkiye,Germany,0,0,0,0,01/06/2021,0,0,0,0,0,0,0,0,0,0,0,0,0,0,0,0,0,0,0,0
3039,151195,2021,Canada,Türkiye,0,1,6,7,31/05/2021,0,0,0,0,9,5,17,31,2,2,1,5,0,0,1,1,5,0,0,5
3040,151195,2021,Poland,Türkiye,0,0,0,0,27/05/2021,0,0,0,0,2,1,1,4,0,0,1,1,0,0,0,0,0,0,0,0
3041,151195,2021,Türkiye,Italy,0,0,0,0,26/05/2021,0,0,0,0,0,0,0,0,0,0,0,0,0,0,0,0,0,0,0,0
3042,151195,2021,Türkiye,Serbia,0,0,15,15,25/05/2021,1,0,0,1,16,8,17,41,1,1,3,5,0,0,0,0,3,0,0,3
3043,138782,2021,Japan,Türkiye,1,2,9,12,25/06/2021,0,0,1,1,9,2,4,15,3,3,7,13,0,0,0,0,3,0,0,3
3044,138782,2021,USA,Türkiye,1,0,8,9,24/06/2021,0,0,0,0,9,2,7,18,1,3,6,10,0,0,0,0,2,1,0,3
3045,138782,2021,Brazil,Türkiye,3,0,12,15,20/06/2021,0,0,5,5,7,1,8,16,2,13,7,22,0,0,0,0,4,3,1,8
3046,138782,2021,Korea,Türkiye,2,1,12,15,19/06/2021,0,0,3,3,11,1,4,16,3,1,1,5,0,0,1,1,4,4,0,8
3047,138782,2021,Türkiye,Netherlands,2,2,10,14,18/06/2021,0,0,0,0,6,5,2,13,5,1,4,10,0,0,0,0,5,3,1,9
3048,138782,2021,USA,Türkiye,1,1,8,10,14/06/2021,0,0,1,1,7,1,6,14,0,4,4,8,0,0,0,0,2,1,1,4
3049,138782,2021,Türkiye,Belgium,0,2,8,10,13/06/2021,0,0,2,2,8,3,3,14,1,1,3,5,0,0,0,0,4,2,0,6
3050,138782,2021,Japan,Türkiye,0,1,8,9,12/06/2021,0,0,3,3,12,0,8,20,1,7,11,19,0,0,0,0,2,1,0,3
3051,138782,2021,Türkiye,Russia,2,1,10,13,08/06/2021,0,0,5,5,7,2,7,16,8,4,4,16,2,0,1,3,6,1,0,7
3052,138782,2021,Türkiye,Dominican Republic,2,1,9,12,07/06/2021,0,0,0,0,6,5,4,15,2,2,0,4,0,0,1,1,1,0,0,1
3053,138782,2021,Türkiye,Thailand,1,1,3,5,06/06/2021,0,0,2,2,5,2,2,9,5,0,4,9,0,0,0,0,0,0,0,0
3054,138782,2021,China,Türkiye,1,1,7,9,02/06/2021,0,0,4,4,7,1,3,11,5,2,8,15,0,0,1,1,2,0,0,2
3055,138782,2021,Türkiye,Germany,0,1,5,6,01/06/2021,0,0,1,1,10,1,5,16,1,1,3,5,0,0,0,0,1,0,0,1
3056,138782,2021,Canada,Türkiye,0,0,8,8,31/05/2021,0,1,0,1,2,3,6,11,2,7,8,17,1,0,1,2,4,0,0,4
3057,138782,2021,Poland,Türkiye,2,0,11,13,27/05/2021,0,0,0,0,16,2,7,25,2,2,3,7,0,0,0,0,4,2,1,7
3058,138782,2021,Türkiye,Italy,1,2,8,11,26/05/2021,0,0,0,0,11,0,4,15,0,4,1,5,0,0,0,0,0,0,0,0
3059,138782,2021,Türkiye,Serbia,0,2,10,12,25/05/2021,0,0,5,5,10,7,6,23,5,7,15,27,1,0,0,1,0,0,2,2
3060,152312,2021,Brazil,Türkiye,0,0,0,0,20/06/2021,0,0,0,0,0,0,0,0,0,0,0,0,0,0,0,0,0,0,0,0
3061,152312,2021,Türkiye,Netherlands,0,0,0,0,18/06/2021,0,0,0,0,0,0,0,0,0,0,0,0,0,0,0,0,0,0,0,0
3062,152312,2021,USA,Türkiye,0,0,0,0,14/06/2021,0,0,0,0,0,0,0,0,0,0,0,0,0,0,0,0,0,0,0,0
3063,152312,2021,Japan,Türkiye,0,0,0,0,12/06/2021,0,0,0,0,0,0,0,0,0,0,0,0,0,0,0,0,0,0,0,0
3064,152263,2021,Korea,Türkiye,1,0,9,10,19/06/2021,0,0,2,2,8,1,0,9,2,4,3,9,0,0,0,0,1,2,0,3
3065,152263,2021,Türkiye,Netherlands,1,0,9,10,18/06/2021,0,0,1,1,8,1,6,15,2,6,3,11,0,0,0,0,4,1,0,5
3066,152263,2021,USA,Türkiye,0,1,5,6,14/06/2021,0,0,0,0,4,2,2,8,0,2,1,3,0,0,0,0,0,1,0,1
3067,152263,2021,Türkiye,Belgium,1,2,11,14,13/06/2021,0,0,5,5,4,3,1,8,1,1,5,7,0,1,0,1,0,1,0,1
3068,152263,2021,Japan,Türkiye,1,1,13,15,12/06/2021,0,0,1,1,9,2,7,18,3,5,15,23,0,0,0,0,2,3,1,6
3069,152263,2021,Türkiye,Russia,0,4,3,7,08/06/2021,0,0,0,0,6,2,4,12,4,5,4,13,0,0,0,0,3,0,0,3
3070,152263,2021,Türkiye,Dominican Republic,0,1,2,3,07/06/2021,0,0,0,0,4,0,0,4,0,0,0,0,0,0,0,0,0,0,0,0
3071,137087,2021,Japan,Türkiye,0,0,0,0,25/06/2021,0,0,0,0,0,0,0,0,0,0,0,0,0,0,0,0,0,0,0,0
3072,137087,2021,USA,Türkiye,0,0,0,0,24/06/2021,0,0,0,0,1,0,1,2,0,1,0,1,0,0,0,0,0,0,0,0
3073,137087,2021,Brazil,Türkiye,0,1,9,10,20/06/2021,0,0,3,3,2,3,1,6,0,7,8,15,0,0,0,0,0,2,0,2
3074,137087,2021,Korea,Türkiye,0,0,0,0,19/06/2021,0,0,0,0,0,0,0,0,0,0,0,0,0,0,0,0,0,0,0,0
3075,137087,2021,Türkiye,Belgium,0,0,0,0,13/06/2021,0,0,0,0,0,0,0,0,0,0,0,0,0,0,0,0,0,0,0,0
3076,137087,2021,Türkiye,Russia,0,0,4,4,08/06/2021,0,0,0,0,1,1,1,3,0,2,0,2,0,0,0,0,0,0,0,0
3077,137087,2021,Türkiye,Dominican Republic,0,0,7,7,07/06/2021,0,0,0,0,0,0,3,3,1,0,0,1,0,0,0,0,0,1,0,1
3078,137087,2021,Türkiye,Thailand,0,0,0,0,06/06/2021,0,0,0,0,0,0,0,0,0,0,0,0,0,0,0,0,0,0,0,0
3079,137087,2021,China,Türkiye,0,0,0,0,02/06/2021,0,0,0,0,0,0,0,0,0,0,0,0,0,0,0,0,0,0,0,0
3080,137087,2021,Türkiye,Germany,0,1,3,4,01/06/2021,0,0,0,0,0,3,2,5,0,1,1,2,0,0,0,0,0,0,0,0
3081,137087,2021,Canada,Türkiye,0,1,8,9,31/05/2021,0,0,0,0,1,0,1,2,2,3,3,8,0,0,0,0,3,1,0,4
3082,137087,2021,Poland,Türkiye,0,0,0,0,27/05/2021,0,0,0,0,0,0,0,0,0,0,0,0,0,0,0,0,0,0,0,0
3083,137087,2021,Türkiye,Italy,0,2,6,8,26/05/2021,0,0,0,0,11,0,2,13,0,1,0,1,0,0,0,0,0,0,0,0
3084,137087,2021,Türkiye,Serbia,2,0,14,16,25/05/2021,0,0,0,0,5,1,2,8,1,4,6,11,0,0,1,1,4,0,0,4
3085,163094,2021,Japan,Türkiye,0,0,0,0,25/06/2021,0,0,0,0,0,0,0,0,0,0,0,0,0,0,0,0,0,0,0,0
3086,163094,2021,USA,Türkiye,0,0,0,0,24/06/2021,0,0,0,0,0,0,0,0,0,0,0,0,0,0,0,0,0,0,0,0
3087,163094,2021,Korea,Türkiye,0,0,0,0,19/06/2021,0,0,0,0,0,0,0,0,0,0,0,0,0,0,0,0,0,0,0,0
3088,163094,2021,Türkiye,Netherlands,0,0,0,0,18/06/2021,0,0,0,0,0,0,0,0,0,0,0,0,0,0,0,0,0,0,0,0
3089,163094,2021,Türkiye,Belgium,0,0,0,0,13/06/2021,0,0,0,0,0,0,0,0,0,0,0,0,0,0,0,0,0,0,0,0
3090,163094,2021,Japan,Türkiye,0,0,0,0,12/06/2021,0,0,0,0,0,0,0,0,0,0,0,0,0,0,0,0,0,0,0,0
3091,163089,2021,Japan,Türkiye,0,1,9,10,25/06/2021,0,0,1,1,9,2,5,16,0,3,3,6,19,1,14,34,12,1,0,13
3092,163089,2021,USA,Türkiye,0,0,0,0,24/06/2021,0,0,0,0,0,0,0,0,0,0,0,0,0,0,0,0,0,0,0,0
3093,163089,2021,Brazil,Türkiye,0,0,8,8,20/06/2021,0,0,2,2,10,2,6,18,0,1,2,3,7,1,19,27,5,2,3,10
3094,163089,2021,USA,Türkiye,0,0,0,0,14/06/2021,0,0,0,0,0,0,0,0,0,0,0,0,1,0,0,1,0,1,0,1
3095,163089,2021,Türkiye,Belgium,0,0,0,0,13/06/2021,0,0,0,0,0,0,0,0,0,0,0,0,0,0,0,0,0,0,0,0
3096,163982,2021,Japan,Türkiye,1,1,6,8,25/06/2021,0,0,0,0,24,4,9,37,4,3,2,9,0,0,0,0,4,0,2,6
3097,163982,2021,USA,Türkiye,0,3,4,7,24/06/2021,0,0,0,0,14,3,19,36,3,1,9,13,0,0,0,0,7,3,1,11
3098,163982,2021,Brazil,Türkiye,1,1,8,10,20/06/2021,0,1,1,2,11,5,15,31,0,3,1,4,0,0,0,0,7,0,3,10
3099,163982,2021,Korea,Türkiye,0,3,8,11,19/06/2021,0,1,0,1,22,7,17,46,0,4,1,5,0,0,0,0,7,5,0,12
3100,163982,2021,Türkiye,Netherlands,1,0,9,10,18/06/2021,0,0,1,1,20,4,15,39,0,1,2,3,0,0,0,0,4,3,0,7
3101,163982,2021,USA,Türkiye,0,1,7,8,14/06/2021,0,0,2,2,15,4,18,37,3,2,5,10,0,0,0,0,7,0,1,8
3102,163982,2021,Türkiye,Belgium,2,2,14,18,13/06/2021,0,0,1,1,13,7,10,30,1,1,1,3,1,0,0,1,8,0,0,8
3103,163982,2021,Japan,Türkiye,1,2,5,8,12/06/2021,0,0,0,0,1,3,8,12,0,1,0,1,0,0,0,0,5,1,1,7
3104,163982,2021,Türkiye,Russia,3,2,19,24,08/06/2021,0,0,0,0,22,7,17,46,0,0,0,0,0,0,0,0,14,1,1,16
3105,163982,2021,Türkiye,Dominican Republic,1,1,6,8,07/06/2021,0,0,1,1,8,8,14,30,1,5,0,6,0,0,0,0,2,0,0,2
3106,163982,2021,Türkiye,Thailand,0,0,0,0,06/06/2021,0,0,1,1,5,2,2,9,0,1,0,1,0,0,0,0,0,0,0,0
3107,163982,2021,China,Türkiye,1,3,5,9,02/06/2021,0,0,1,1,16,7,19,42,0,3,2,5,0,0,0,0,5,1,2,8
3108,163982,2021,Türkiye,Germany,2,2,11,15,01/06/2021,0,0,2,2,17,4,16,37,2,4,5,11,0,0,0,0,6,3,0,9
3109,163982,2021,Canada,Türkiye,0,1,7,8,31/05/2021,0,0,0,0,19,4,18,41,2,1,2,5,0,0,0,0,8,0,0,8
3110,163982,2021,Poland,Türkiye,2,2,21,25,27/05/2021,0,0,2,2,23,8,19,50,1,4,0,5,0,0,0,0,6,3,1,10
3111,163982,2021,Türkiye,Italy,2,3,12,17,26/05/2021,0,0,0,0,7,2,9,18,2,4,3,9,0,0,0,0,7,1,1,9
3112,163982,2021,Türkiye,Serbia,1,1,6,8,25/05/2021,1,0,0,1,13,6,13,32,2,0,5,7,0,0,0,0,3,1,0,4
3113,132835,2021,Brazil,USA,0,2,1,3,25/06/2021,3,0,10,13,0,0,0,0,0,0,0,0,0,0,0,0,3,1,0,4
3114,132835,2021,USA,Türkiye,0,0,0,0,24/06/2021,0,0,0,0,0,0,0,0,0,0,0,0,0,0,0,0,0,0,0,0
3115,132835,2021,China,USA,1,1,7,9,20/06/2021,8,2,63,73,2,1,1,4,0,2,0,2,0,0,0,0,3,4,1,8
3116,132835,2021,USA,Russia,0,0,0,0,19/06/2021,0,0,0,0,0,0,0,0,0,0,0,0,0,0,0,0,0,0,0,0
3117,132835,2021,Poland,USA,4,5,6,15,18/06/2021,14,0,77,91,1,0,1,2,1,3,1,5,0,0,1,1,8,0,1,9
3118,132835,2021,USA,Türkiye,0,1,7,8,14/06/2021,2,1,12,15,0,0,0,0,0,0,0,0,0,0,0,0,3,0,0,3
3119,132835,2021,USA,Japan,0,3,8,11,13/06/2021,17,1,51,69,0,0,1,1,2,0,3,5,0,0,0,0,10,6,0,16
3120,132835,2021,USA,Belgium,0,0,0,0,12/06/2021,0,0,0,0,0,0,0,0,0,0,0,0,0,0,0,0,0,0,0,0
3121,132835,2021,Italy,USA,0,0,0,0,08/06/2021,0,0,0,0,0,0,0,0,0,0,0,0,0,0,0,0,0,0,0,0
3122,132835,2021,Korea,USA,3,0,11,14,07/06/2021,26,1,40,67,1,0,2,3,1,3,7,11,0,0,0,0,9,1,0,10
3123,132835,2021,Germany,USA,3,3,12,18,06/06/2021,6,1,61,68,1,0,0,1,0,0,2,2,0,0,0,0,5,1,0,6
3124,132835,2021,Thailand,USA,1,2,12,15,02/06/2021,27,1,52,80,1,0,4,5,2,1,1,4,0,0,0,0,1,1,0,2
3125,132835,2021,USA,Netherlands,2,4,7,13,01/06/2021,34,2,58,94,3,0,2,5,0,1,1,2,0,0,0,0,11,3,1,15
3126,132835,2021,Serbia,USA,0,0,0,0,31/05/2021,0,0,0,0,0,0,0,0,0,0,0,0,0,0,0,0,0,0,0,0
3127,132835,2021,Dominican Republic,USA,0,0,0,0,25/05/2021,0,0,0,0,0,0,0,0,0,0,0,0,0,0,0,0,0,0,0,0
3128,143517,2021,Brazil,USA,0,0,15,15,25/06/2021,33,2,85,120,2,0,4,6,4,3,3,10,0,0,0,0,10,3,1,14
3129,143517,2021,USA,Türkiye,1,1,19,21,24/06/2021,13,1,77,91,1,0,2,3,3,3,3,9,0,0,0,0,7,1,0,8
3130,143517,2021,China,USA,0,0,0,0,20/06/2021,0,0,0,0,0,0,0,0,0,0,0,0,0,0,0,0,0,0,0,0
3131,143517,2021,USA,Russia,1,0,15,16,19/06/2021,39,2,62,103,1,0,3,4,0,2,5,7,0,0,0,0,6,1,3,10
3132,143517,2021,Poland,USA,0,0,0,0,18/06/2021,0,0,0,0,0,0,0,0,0,0,0,0,0,0,0,0,0,0,0,0
3133,143517,2021,USA,Türkiye,1,0,15,16,14/06/2021,22,0,61,83,0,0,1,1,1,1,1,3,0,0,0,0,12,1,0,13
3134,143517,2021,USA,Japan,1,0,6,7,13/06/2021,8,0,20,28,0,0,0,0,0,0,0,0,0,0,0,0,3,0,0,3
3135,143517,2021,USA,Belgium,1,1,11,13,12/06/2021,19,1,69,89,1,0,0,1,0,2,4,6,1,1,0,2,8,2,0,10
3136,143517,2021,Italy,USA,1,0,19,20,08/06/2021,16,0,95,111,1,1,3,5,1,0,1,2,0,1,0,1,6,1,0,7
3137,143517,2021,Korea,USA,0,0,0,0,07/06/2021,0,0,0,0,0,0,0,0,0,0,0,0,0,0,0,0,0,0,0,0
3138,143517,2021,Serbia,USA,0,0,11,11,31/05/2021,29,1,52,82,2,0,1,3,1,1,5,7,0,0,0,0,6,0,1,7
3139,143517,2021,Brazil,USA,2,0,15,17,27/05/2021,45,0,91,136,0,0,1,1,0,6,5,11,0,0,2,2,11,1,2,14
3140,143517,2021,USA,Canada,0,0,0,0,26/05/2021,0,0,0,0,0,0,0,0,0,0,0,0,0,0,0,0,0,0,0,0
3141,146722,2021,Korea,USA,0,0,0,0,07/06/2021,0,0,0,0,0,0,0,0,0,0,0,0,0,0,0,0,0,0,0,0
3142,146722,2021,Germany,USA,0,0,0,0,06/06/2021,0,0,0,0,0,0,0,0,0,0,0,0,0,0,0,0,0,0,0,0
3143,146722,2021,Brazil,USA,0,0,0,0,27/05/2021,0,0,0,0,0,0,0,0,0,0,0,0,0,0,0,0,0,0,0,0
3144,146722,2021,USA,Canada,2,3,8,13,26/05/2021,0,0,0,0,8,4,13,25,1,0,0,1,11,0,23,34,3,0,0,3
3145,146722,2021,Dominican Republic,USA,0,3,6,9,25/05/2021,1,0,1,2,14,5,9,28,2,3,1,6,7,1,16,24,4,3,0,7
3146,135564,2021,Brazil,USA,0,0,0,0,25/06/2021,0,0,9,9,0,0,0,0,0,0,0,0,7,0,16,23,14,6,0,20
3147,135564,2021,USA,Türkiye,0,0,0,0,24/06/2021,0,0,7,7,0,0,0,0,0,0,0,0,5,1,12,18,14,3,4,21
3148,135564,2021,China,USA,0,0,0,0,20/06/2021,0,0,0,0,0,0,0,0,0,0,0,0,0,0,0,0,0,0,0,0
3149,135564,2021,USA,Russia,0,0,0,0,19/06/2021,0,0,0,0,0,0,0,0,0,0,0,0,0,0,0,0,0,0,0,0
3150,135564,2021,Poland,USA,0,0,0,0,18/06/2021,0,0,9,9,0,0,0,0,0,0,0,0,5,1,11,17,17,3,1,21
3151,135564,2021,USA,Türkiye,0,0,0,0,14/06/2021,0,0,11,11,0,0,0,0,0,0,0,0,9,1,10,20,13,4,1,18
3152,135564,2021,USA,Japan,0,0,0,0,13/06/2021,1,0,12,13,0,0,0,0,0,0,0,0,5,2,0,7,14,0,0,14
3153,135564,2021,USA,Belgium,0,0,0,0,12/06/2021,0,0,11,11,0,0,0,0,0,0,0,0,13,1,5,19,11,0,1,12
3154,135564,2021,Italy,USA,0,0,0,0,08/06/2021,0,0,5,5,0,0,0,0,0,0,0,0,8,2,19,29,20,6,0,26
3155,135564,2021,Korea,USA,0,0,0,0,07/06/2021,0,0,7,7,0,0,0,0,0,0,0,0,9,1,3,13,9,1,1,11
3156,135564,2021,Germany,USA,0,0,0,0,06/06/2021,0,0,4,4,0,0,0,0,0,0,0,0,7,2,15,24,14,2,0,16
3157,135564,2021,Thailand,USA,0,0,0,0,02/06/2021,0,0,0,0,0,0,0,0,0,0,0,0,0,0,0,0,0,0,0,0
3158,135564,2021,USA,Netherlands,0,0,0,0,01/06/2021,0,0,12,12,0,0,0,0,0,0,0,0,9,0,5,14,14,3,4,21
3159,135564,2021,Serbia,USA,0,0,0,0,31/05/2021,0,0,0,0,0,0,0,0,0,0,0,0,0,0,0,0,0,0,0,0
3160,135564,2021,Brazil,USA,0,0,0,0,27/05/2021,0,0,6,6,0,0,0,0,0,0,0,0,11,0,12,23,25,2,3,30
3161,135564,2021,USA,Canada,0,0,0,0,26/05/2021,0,0,6,6,0,0,0,0,0,0,0,0,3,0,3,6,17,0,0,17
3162,135564,2021,Dominican Republic,USA,0,0,0,0,25/05/2021,0,0,2,2,0,0,0,0,0,0,0,0,9,0,6,15,10,5,1,16
3163,145702,2021,China,USA,0,0,0,0,20/06/2021,0,0,0,0,0,0,0,0,0,0,0,0,0,0,0,0,0,0,0,0
3164,145702,2021,USA,Russia,0,0,0,0,19/06/2021,0,0,0,0,0,0,0,0,0,0,0,0,0,0,0,0,0,0,0,0
3165,145702,2021,Poland,USA,0,2,8,10,18/06/2021,0,1,0,1,3,2,4,9,3,3,2,8,0,0,0,0,2,0,1,3
3166,145702,2021,USA,Japan,0,0,0,0,13/06/2021,0,0,0,0,0,0,0,0,0,0,0,0,0,0,0,0,0,0,0,0
3167,145702,2021,Italy,USA,0,0,0,0,08/06/2021,0,0,0,0,0,0,0,0,0,0,0,0,0,0,0,0,0,0,0,0
3168,145702,2021,Korea,USA,0,0,0,0,07/06/2021,0,0,0,0,0,0,0,0,0,0,0,0,0,0,0,0,0,0,0,0
3169,145702,2021,Germany,USA,0,0,0,0,06/06/2021,0,0,0,0,0,0,0,0,0,0,0,0,0,0,0,0,0,0,0,0
3170,145702,2021,Thailand,USA,0,0,0,0,02/06/2021,0,0,0,0,0,0,0,0,0,0,0,0,0,0,0,0,0,0,0,0
3171,145702,2021,USA,Netherlands,2,1,8,11,01/06/2021,0,0,0,0,3,1,7,11,0,3,4,7,0,0,0,0,3,1,0,4
3172,145702,2021,Serbia,USA,0,0,0,0,31/05/2021,0,0,0,0,0,0,0,0,0,0,0,0,0,0,0,0,0,0,0,0
3173,145702,2021,Brazil,USA,0,0,0,0,27/05/2021,0,0,0,0,0,0,0,0,0,0,0,0,0,0,0,0,0,0,0,0
3174,145702,2021,USA,Canada,0,3,9,12,26/05/2021,0,0,0,0,5,0,6,11,2,1,2,5,0,0,0,0,1,0,0,1
3175,145702,2021,Dominican Republic,USA,0,1,9,10,25/05/2021,0,0,0,0,6,1,6,13,0,1,2,3,0,0,0,0,0,1,0,1
3176,132500,2021,Germany,USA,0,0,0,0,06/06/2021,0,0,0,0,0,0,0,0,0,0,0,0,0,0,0,0,0,0,0,0
3177,132500,2021,Thailand,USA,0,0,0,0,02/06/2021,0,0,0,0,0,0,0,0,0,0,0,0,0,0,0,0,0,0,0,0
3178,132500,2021,USA,Netherlands,0,0,0,0,01/06/2021,0,0,0,0,0,0,0,0,0,0,0,0,0,0,0,0,0,0,0,0
3179,132500,2021,Brazil,USA,0,0,0,0,27/05/2021,0,0,0,0,0,0,0,0,0,0,0,0,0,0,0,0,0,0,0,0
3180,132500,2021,USA,Canada,2,0,14,16,26/05/2021,3,0,92,95,2,0,1,3,2,2,0,4,0,0,0,0,1,0,0,1
3181,132500,2021,Dominican Republic,USA,1,0,10,11,25/05/2021,0,0,0,0,1,0,1,2,1,1,0,2,0,0,0,0,2,2,0,4
3182,160909,2021,China,USA,0,0,4,4,20/06/2021,0,0,0,0,0,1,1,2,1,0,2,3,0,0,0,0,0,2,0,2
3183,160909,2021,USA,Russia,0,0,0,0,19/06/2021,0,0,0,0,0,0,0,0,0,0,0,0,0,0,0,0,0,0,0,0
3184,160909,2021,USA,Türkiye,0,0,0,0,14/06/2021,0,0,0,0,0,0,0,0,0,0,0,0,0,0,0,0,0,0,0,0
3185,160909,2021,USA,Belgium,0,0,0,0,12/06/2021,0,0,0,0,0,0,0,0,0,0,0,0,0,0,0,0,0,0,0,0
3186,160909,2021,Italy,USA,0,0,0,0,08/06/2021,0,0,0,0,0,0,0,0,0,0,0,0,0,0,0,0,0,0,0,0
3187,160909,2021,Korea,USA,0,0,0,0,07/06/2021,0,0,0,0,0,0,0,0,0,0,0,0,0,0,0,0,0,0,0,0
3188,160909,2021,Germany,USA,0,0,0,0,06/06/2021,0,0,0,0,0,0,0,0,0,0,0,0,0,0,0,0,0,0,0,0
3189,160909,2021,Thailand,USA,1,2,8,11,02/06/2021,0,0,1,1,6,1,2,9,0,3,0,3,1,0,0,1,3,0,0,3
3190,160909,2021,USA,Netherlands,0,0,0,0,01/06/2021,0,0,0,0,0,0,0,0,0,0,0,0,0,0,0,0,0,0,0,0
3191,160909,2021,Brazil,USA,0,0,0,0,27/05/2021,0,0,0,0,0,0,0,0,0,0,0,0,0,0,0,0,0,0,0,0
3192,160909,2021,USA,Canada,0,0,11,11,26/05/2021,0,0,0,0,6,0,4,10,1,0,0,1,0,0,0,0,0,0,0,0
3193,160909,2021,Dominican Republic,USA,0,1,13,14,25/05/2021,0,0,0,0,3,0,3,6,4,3,2,9,0,0,0,0,0,1,0,1
3194,114051,2021,Brazil,USA,0,0,14,14,25/06/2021,0,0,8,8,10,3,16,29,1,3,1,5,7,0,7,14,10,2,1,13
3195,114051,2021,USA,Türkiye,0,0,4,4,24/06/2021,0,0,2,2,2,2,11,15,0,1,1,2,1,1,8,10,6,1,0,7
3196,114051,2021,China,USA,0,0,0,0,20/06/2021,0,0,0,0,0,0,0,0,0,0,0,0,0,0,0,0,0,0,0,0
3197,114051,2021,USA,Russia,4,0,11,15,19/06/2021,0,0,2,2,15,3,13,31,0,2,1,3,7,1,15,23,12,1,1,14
3198,114051,2021,Poland,USA,0,0,0,0,18/06/2021,0,0,0,0,0,0,0,0,0,0,0,0,0,0,0,0,0,0,0,0
3199,114051,2021,USA,Türkiye,0,2,16,18,14/06/2021,0,0,6,6,13,0,14,27,0,3,1,4,9,3,15,27,11,3,0,14
3200,114051,2021,USA,Japan,0,0,0,0,13/06/2021,0,0,0,0,0,0,0,0,0,0,0,0,0,0,0,0,0,0,0,0
3201,114051,2021,USA,Belgium,0,5,16,21,12/06/2021,0,0,3,3,10,4,7,21,0,2,2,4,5,1,12,18,13,1,0,14
3202,114051,2021,Italy,USA,0,0,0,0,08/06/2021,0,0,0,0,0,0,0,0,0,0,0,0,0,0,0,0,0,0,0,0
3203,114051,2021,Korea,USA,1,1,7,9,07/06/2021,0,0,1,1,6,2,4,12,0,1,1,2,3,0,2,5,3,0,0,3
3204,114051,2021,Germany,USA,2,1,14,17,06/06/2021,0,0,6,6,8,2,7,17,0,2,1,3,3,1,3,7,3,1,0,4
3205,114051,2021,Thailand,USA,0,0,0,0,02/06/2021,0,0,0,0,0,0,0,0,0,0,0,0,0,0,0,0,0,0,0,0
3206,114051,2021,USA,Netherlands,1,2,7,10,01/06/2021,0,0,2,2,8,2,21,31,1,1,2,4,7,0,5,12,14,2,0,16
3207,114051,2021,Serbia,USA,0,0,0,0,31/05/2021,0,0,0,0,0,0,0,0,0,0,0,0,0,0,0,0,0,0,0,0
3208,114051,2021,Brazil,USA,0,0,17,17,27/05/2021,0,0,5,5,15,3,20,38,1,3,1,5,5,0,8,13,14,4,0,18
3209,114051,2021,USA,Canada,0,0,0,0,26/05/2021,0,0,0,0,0,0,0,0,0,0,0,0,0,0,0,0,0,0,0,0
3210,114051,2021,Dominican Republic,USA,0,1,14,15,25/05/2021,1,1,2,4,14,1,13,28,1,4,0,5,5,0,5,10,2,2,0,4
3211,155307,2021,Brazil,USA,0,1,4,5,25/06/2021,0,0,0,0,12,5,8,25,0,0,2,2,0,0,0,0,5,0,0,5
3212,155307,2021,USA,Türkiye,2,0,4,6,24/06/2021,0,0,0,0,7,2,2,11,0,2,1,3,0,0,0,0,5,1,1,7
3213,155307,2021,China,USA,0,0,9,9,20/06/2021,0,0,2,2,9,3,7,19,2,1,0,3,0,0,0,0,1,5,0,6
3214,155307,2021,USA,Russia,3,2,13,18,19/06/2021,0,0,2,2,13,5,14,32,1,7,4,12,0,0,0,0,7,4,3,14
3215,155307,2021,Poland,USA,0,0,0,0,18/06/2021,0,0,0,0,0,0,0,0,0,0,0,0,0,0,0,0,0,0,0,0
3216,155307,2021,USA,Türkiye,0,0,0,0,14/06/2021,0,0,0,0,5,1,3,9,0,1,1,2,0,0,0,0,2,0,0,2
3217,155307,2021,USA,Japan,1,1,3,5,13/06/2021,0,0,2,2,9,2,15,26,0,3,7,10,0,0,0,0,5,1,2,8
3218,155307,2021,USA,Belgium,0,0,0,0,12/06/2021,0,0,0,0,0,0,0,0,0,0,0,0,0,0,0,0,0,0,0,0
3219,155307,2021,Italy,USA,2,1,15,18,08/06/2021,0,0,0,0,18,3,9,30,0,3,1,4,0,0,0,0,9,1,1,11
3220,155307,2021,Korea,USA,0,0,0,0,07/06/2021,0,0,0,0,0,0,0,0,0,0,0,0,0,0,0,0,0,0,0,0
3221,155307,2021,Germany,USA,0,1,6,7,06/06/2021,0,0,1,1,17,0,9,26,0,2,0,2,0,0,0,0,3,1,0,4
3222,155307,2021,Thailand,USA,0,0,0,0,02/06/2021,0,0,0,0,0,0,0,0,0,0,0,0,0,0,0,0,0,0,0,0
3223,155307,2021,USA,Netherlands,0,2,11,13,01/06/2021,0,0,0,0,9,4,12,25,2,2,5,9,0,0,0,0,12,1,0,13
3224,155307,2021,Serbia,USA,0,0,0,0,31/05/2021,0,0,0,0,0,0,0,0,0,0,0,0,0,0,0,0,0,0,0,0
3225,155307,2021,Brazil,USA,1,0,16,17,27/05/2021,0,1,1,2,15,7,15,37,0,3,5,8,0,0,0,0,9,2,2,13
3226,155307,2021,USA,Canada,0,1,13,14,26/05/2021,0,1,0,1,19,4,14,37,1,1,2,4,0,0,0,0,4,0,0,4
3227,155307,2021,Dominican Republic,USA,0,0,0,0,25/05/2021,0,0,0,0,0,0,0,0,0,0,0,0,0,0,0,0,0,0,0,0
3228,172978,2021,Brazil,USA,2,1,10,13,25/06/2021,0,0,1,1,12,8,11,31,2,5,2,9,0,0,0,0,8,3,1,12
3229,172978,2021,USA,Türkiye,0,2,2,4,24/06/2021,0,0,0,0,4,3,10,17,1,1,1,3,0,0,0,0,1,2,0,3
3230,172978,2021,China,USA,0,0,0,0,20/06/2021,0,0,0,0,0,0,0,0,0,0,0,0,0,0,0,0,0,0,0,0
3231,172978,2021,USA,Russia,0,0,0,0,19/06/2021,0,0,0,0,0,0,0,0,0,0,0,0,0,0,0,0,0,0,0,0
3232,172978,2021,Poland,USA,0,1,12,13,18/06/2021,0,0,1,1,14,1,15,30,3,4,3,10,0,0,0,0,6,2,2,10
3233,172978,2021,USA,Türkiye,0,1,5,6,14/06/2021,0,0,1,1,14,7,15,36,5,4,5,14,0,0,0,0,7,2,1,10
3234,172978,2021,USA,Japan,0,1,0,1,13/06/2021,0,0,1,1,7,0,4,11,0,0,3,3,0,0,0,0,0,0,0,0
3235,172978,2021,USA,Belgium,0,3,6,9,12/06/2021,0,0,3,3,18,3,16,37,3,2,5,10,0,0,0,0,7,3,0,10
3236,172978,2021,Italy,USA,0,0,0,0,08/06/2021,0,0,0,0,0,0,0,0,0,0,0,0,0,0,0,0,0,0,0,0
3237,172978,2021,Korea,USA,1,1,12,14,07/06/2021,0,0,1,1,7,3,11,21,1,3,2,6,0,0,0,0,7,1,0,8
3238,172978,2021,Germany,USA,0,0,0,0,06/06/2021,0,0,0,0,0,0,0,0,0,0,0,0,0,0,0,0,0,0,0,0
3239,172978,2021,Thailand,USA,0,3,4,7,02/06/2021,0,0,0,0,14,2,9,25,3,2,1,6,0,0,0,0,5,1,0,6
3240,172978,2021,USA,Netherlands,0,0,0,0,01/06/2021,0,0,0,0,0,0,0,0,0,0,0,0,0,0,0,0,0,0,0,0
3241,172978,2021,Serbia,USA,2,1,11,14,31/05/2021,0,0,5,5,15,1,12,28,0,2,3,5,0,0,0,0,9,3,2,14
3242,172978,2021,Brazil,USA,0,0,0,0,27/05/2021,0,0,0,0,0,0,0,0,0,0,0,0,0,0,0,0,0,0,0,0
3243,172978,2021,USA,Canada,0,0,0,0,26/05/2021,0,0,0,0,0,0,0,0,0,0,0,0,0,0,0,0,0,0,0,0
3244,172978,2021,Dominican Republic,USA,1,1,12,14,25/05/2021,3,0,1,4,13,3,17,33,1,4,3,8,0,0,0,0,6,2,0,8
3245,162942,2021,China,USA,0,0,0,0,20/06/2021,0,0,0,0,0,0,0,0,0,0,0,0,0,0,0,0,0,0,0,0
3246,162942,2021,USA,Russia,0,0,0,0,19/06/2021,0,0,0,0,0,0,0,0,0,0,0,0,0,0,0,0,0,0,0,0
3247,162942,2021,Poland,USA,0,0,0,0,18/06/2021,0,0,0,0,0,0,0,0,0,0,0,0,0,0,0,0,0,0,0,0
3248,162942,2021,USA,Japan,0,0,0,0,13/06/2021,0,0,0,0,0,0,0,0,0,0,0,0,0,0,0,0,0,0,0,0
3249,162942,2021,USA,Belgium,0,0,0,0,12/06/2021,0,0,0,0,0,0,0,0,0,0,0,0,0,0,0,0,0,0,0,0
3250,162942,2021,Italy,USA,0,0,0,0,08/06/2021,0,0,0,0,0,0,0,0,0,0,0,0,0,0,0,0,0,0,0,0
3251,162942,2021,Korea,USA,0,0,0,0,07/06/2021,0,0,0,0,0,0,0,0,0,0,0,0,0,0,0,0,0,0,0,0
3252,162942,2021,Germany,USA,0,0,0,0,06/06/2021,0,0,0,0,0,0,0,0,0,0,0,0,0,0,0,0,0,0,0,0
3253,162942,2021,Brazil,USA,2,1,18,21,27/05/2021,0,0,0,0,21,5,17,43,2,1,2,5,10,1,23,34,4,0,1,5
3254,162942,2021,USA,Canada,0,1,8,9,26/05/2021,0,0,4,4,8,2,13,23,3,0,0,3,4,0,2,6,2,0,0,2
3255,162942,2021,Dominican Republic,USA,0,0,0,0,25/05/2021,0,0,0,0,0,0,0,0,0,0,0,0,0,0,0,0,0,0,0,0
3256,119550,2021,Brazil,USA,1,1,21,23,25/06/2021,0,0,4,4,18,5,21,44,3,4,2,9,23,0,30,53,11,2,1,14
3257,119550,2021,USA,Türkiye,0,1,10,11,24/06/2021,0,0,3,3,7,2,14,23,1,5,3,9,11,1,12,24,11,1,2,14
3258,119550,2021,China,USA,0,1,8,9,20/06/2021,0,0,2,2,7,3,9,19,0,0,0,0,8,1,12,21,2,4,1,7
3259,119550,2021,USA,Russia,0,0,0,0,19/06/2021,0,0,0,0,0,0,0,0,0,0,0,0,0,0,0,0,0,0,0,0
3260,119550,2021,Poland,USA,1,0,16,17,18/06/2021,0,0,3,3,14,3,16,33,2,2,2,6,11,1,17,29,10,1,1,12
3261,119550,2021,USA,Türkiye,1,3,7,11,14/06/2021,0,0,6,6,12,3,11,26,1,1,6,8,7,1,11,19,6,1,1,8
3262,119550,2021,USA,Japan,1,1,13,15,13/06/2021,0,0,4,4,12,0,15,27,1,3,3,7,14,1,14,29,10,2,1,13
3263,119550,2021,USA,Belgium,0,0,0,0,12/06/2021,0,0,0,0,0,0,0,0,0,0,0,0,0,0,0,0,0,0,0,0
3264,119550,2021,Italy,USA,1,2,9,12,08/06/2021,0,0,2,2,16,2,15,33,2,0,2,4,6,3,20,29,7,4,1,12
3265,119550,2021,Korea,USA,0,1,8,9,07/06/2021,0,0,2,2,7,3,10,20,1,3,4,8,6,3,5,14,11,1,2,14
3266,119550,2021,Thailand,USA,4,1,17,22,02/06/2021,0,0,2,2,11,1,8,20,3,4,0,7,9,0,8,17,3,4,0,7
3267,119550,2021,USA,Netherlands,0,0,0,0,01/06/2021,0,0,0,0,0,0,0,0,0,0,0,0,0,0,0,0,0,0,0,0
3268,119550,2021,Serbia,USA,1,2,9,12,31/05/2021,0,0,2,2,9,4,9,22,1,0,1,2,5,2,15,22,3,0,1,4
3269,119550,2021,USA,Canada,0,0,0,0,26/05/2021,0,0,0,0,0,0,0,0,0,0,0,0,0,0,0,0,0,0,0,0
3270,142658,2021,USA,Türkiye,0,1,3,4,24/06/2021,0,0,0,0,0,0,0,0,0,0,0,0,0,0,0,0,0,0,0,0
3271,142658,2021,China,USA,0,0,0,0,20/06/2021,0,0,1,1,0,0,0,0,0,0,0,0,15,5,22,42,7,6,1,14
3272,142658,2021,USA,Russia,0,0,0,0,19/06/2021,0,0,3,3,0,0,0,0,0,0,0,0,8,2,20,30,11,6,3,20
3273,142658,2021,Poland,USA,0,1,15,16,18/06/2021,0,0,2,2,8,3,13,24,5,4,2,11,3,1,10,14,9,2,3,14
3274,142658,2021,USA,Türkiye,0,1,14,15,14/06/2021,0,0,1,1,0,0,0,0,0,0,0,0,0,0,0,0,2,1,1,4
3275,142658,2021,USA,Japan,0,1,3,4,13/06/2021,0,0,1,1,0,0,0,0,0,0,0,0,0,0,0,0,0,0,0,0
3276,142658,2021,USA,Belgium,0,1,6,7,12/06/2021,0,0,0,0,0,0,0,0,0,0,0,0,0,0,0,0,0,0,0,0
3277,142658,2021,Italy,USA,0,0,0,0,08/06/2021,0,0,0,0,0,0,0,0,0,0,0,0,0,0,0,0,0,0,0,0
3278,142658,2021,Korea,USA,0,0,2,2,07/06/2021,0,0,0,0,4,3,3,10,0,0,1,1,4,0,2,6,4,0,0,4
3279,142658,2021,Germany,USA,0,0,0,0,06/06/2021,0,0,0,0,0,0,0,0,0,0,0,0,0,0,0,0,0,0,0,0
3280,142658,2021,Thailand,USA,0,1,8,9,02/06/2021,0,0,0,0,9,4,12,25,2,0,2,4,6,0,4,10,5,4,0,9
3281,142658,2021,USA,Netherlands,0,0,0,0,01/06/2021,0,0,0,0,0,0,0,0,0,0,0,0,0,0,0,0,0,0,0,0
3282,142658,2021,Serbia,USA,0,1,12,13,31/05/2021,0,0,1,1,5,2,16,23,0,2,1,3,2,0,4,6,11,0,1,12
3283,142658,2021,Brazil,USA,0,0,0,0,27/05/2021,0,0,0,0,0,0,0,0,0,0,0,0,0,0,0,0,0,0,0,0
3284,142658,2021,Dominican Republic,USA,0,0,0,0,25/05/2021,0,0,0,0,0,0,0,0,0,0,0,0,0,0,0,0,0,0,0,0
3285,115495,2021,Brazil,USA,0,1,11,12,25/06/2021,0,0,0,0,5,2,5,12,2,7,1,10,0,0,0,0,4,0,1,5
3286,115495,2021,USA,Türkiye,0,0,7,7,24/06/2021,0,0,0,0,6,1,3,10,2,4,5,11,0,0,0,0,3,0,1,4
3287,115495,2021,China,USA,0,1,5,6,20/06/2021,0,0,0,0,7,2,2,11,0,1,0,1,0,0,1,1,0,0,0,0
3288,115495,2021,Poland,USA,0,0,11,11,18/06/2021,0,0,1,1,5,1,5,11,0,6,4,10,0,0,0,0,1,0,0,1
3289,115495,2021,USA,Türkiye,0,2,3,5,14/06/2021,0,0,0,0,9,1,3,13,1,5,3,9,0,0,0,0,5,1,3,9
3290,115495,2021,USA,Japan,0,0,0,0,13/06/2021,0,0,0,0,0,0,0,0,0,0,0,0,0,0,0,0,0,0,0,0
3291,115495,2021,USA,Belgium,0,2,5,7,12/06/2021,0,0,1,1,8,0,4,12,1,1,2,4,0,0,0,0,4,1,0,5
3292,115495,2021,Italy,USA,0,3,14,17,08/06/2021,0,0,1,1,7,2,4,13,4,8,10,22,0,0,0,0,5,2,0,7
3293,115495,2021,Germany,USA,0,1,4,5,06/06/2021,0,0,0,0,2,0,5,7,1,2,0,3,0,0,0,0,3,1,0,4
3294,115495,2021,USA,Netherlands,0,0,10,10,01/06/2021,0,0,0,0,8,3,3,14,1,4,2,7,0,0,0,0,2,1,0,3
3295,115495,2021,Serbia,USA,0,0,0,0,31/05/2021,0,0,0,0,0,0,0,0,0,0,0,0,0,0,0,0,0,0,0,0
3296,115495,2021,Brazil,USA,1,0,12,13,27/05/2021,0,1,0,1,7,2,6,15,2,8,7,17,1,1,1,3,2,0,2,4
3297,115495,2021,USA,Canada,0,0,0,0,26/05/2021,0,0,0,0,0,0,0,0,0,0,0,0,0,0,0,0,0,0,0,0
3298,115495,2021,Dominican Republic,USA,0,0,0,0,25/05/2021,0,0,0,0,0,0,0,0,0,0,0,0,0,0,0,0,0,0,0,0
3299,155415,2021,USA,Türkiye,0,0,0,0,14/06/2021,0,0,0,0,0,0,0,0,0,0,0,0,0,0,0,0,0,0,0,0
3300,155415,2021,Thailand,USA,0,0,0,0,02/06/2021,0,0,4,4,0,0,0,0,0,0,0,0,9,0,7,16,5,4,0,9
3301,155415,2021,USA,Netherlands,0,0,0,0,01/06/2021,0,0,0,0,0,0,0,0,0,0,0,0,0,0,0,0,0,0,0,0
3302,155415,2021,Serbia,USA,0,0,0,0,31/05/2021,0,0,4,4,0,0,0,0,0,0,0,0,5,1,13,19,22,0,1,23
3303,155415,2021,Brazil,USA,0,0,0,0,27/05/2021,0,0,0,0,0,0,0,0,0,0,0,0,0,0,0,0,0,0,0,0
3304,155415,2021,USA,Canada,0,0,0,0,26/05/2021,0,0,0,0,0,0,0,0,0,0,0,0,0,0,0,0,0,0,0,0
3305,155415,2021,Dominican Republic,USA,0,0,0,0,25/05/2021,0,0,0,0,0,0,0,0,0,0,0,0,0,0,0,0,0,0,0,0
3306,140052,2021,Brazil,USA,0,2,11,13,25/06/2021,0,0,0,0,7,2,5,14,1,5,5,11,0,0,0,0,3,2,0,5
3307,140052,2021,USA,Türkiye,1,0,10,11,24/06/2021,0,0,1,1,6,0,4,10,0,4,3,7,0,0,0,0,2,2,0,4
3308,140052,2021,China,USA,0,1,2,3,20/06/2021,0,0,0,0,2,0,0,2,1,1,0,2,0,0,0,0,0,0,0,0
3309,140052,2021,USA,Russia,1,1,13,15,19/06/2021,0,0,1,1,13,1,6,20,4,5,9,18,0,0,0,0,0,1,2,3
3310,140052,2021,Poland,USA,0,0,0,0,18/06/2021,0,0,0,0,0,0,0,0,0,0,0,0,0,0,0,0,0,0,0,0
3311,140052,2021,USA,Türkiye,2,1,15,18,14/06/2021,0,0,0,0,8,0,2,10,2,6,5,13,0,0,0,0,1,0,0,1
3312,140052,2021,USA,Japan,0,0,6,6,13/06/2021,0,0,0,0,7,0,6,13,1,4,4,9,0,0,0,0,0,2,0,2
3313,140052,2021,USA,Belgium,0,0,0,0,12/06/2021,0,0,0,0,0,0,0,0,0,0,0,0,0,0,0,0,0,0,0,0
3314,140052,2021,Italy,USA,2,2,10,14,08/06/2021,0,0,0,0,6,1,5,12,1,6,7,14,0,0,0,0,2,0,1,3
3315,140052,2021,Korea,USA,5,1,9,15,07/06/2021,0,0,3,3,7,0,3,10,3,4,5,12,0,0,1,1,4,0,0,4
3316,140052,2021,Thailand,USA,1,1,7,9,02/06/2021,0,0,0,0,6,0,4,10,1,3,2,6,0,0,1,1,0,1,0,1
3317,140052,2021,USA,Netherlands,0,0,0,0,01/06/2021,0,0,0,0,0,0,0,0,0,0,0,0,0,0,0,0,0,0,0,0
3318,140052,2021,Serbia,USA,1,3,10,14,31/05/2021,0,0,0,0,6,1,5,12,4,4,5,13,0,0,0,0,4,1,0,5
3319,140052,2021,Brazil,USA,0,2,10,12,27/05/2021,0,0,0,0,9,1,5,15,1,5,9,15,0,0,0,0,3,0,0,3
3320,140052,2021,USA,Canada,0,0,0,0,26/05/2021,0,0,0,0,0,0,0,0,0,0,0,0,0,0,0,0,0,0,0,0
3321,140052,2021,Dominican Republic,USA,0,0,0,0,25/05/2021,0,0,0,0,0,0,0,0,0,0,0,0,0,0,0,0,0,0,0,0
3322,141933,2021,Brazil,USA,0,0,2,2,25/06/2021,0,0,0,0,0,0,0,0,0,0,0,0,0,0,0,0,0,0,0,0
3323,141933,2021,USA,Türkiye,0,0,5,5,24/06/2021,0,0,1,1,7,3,5,15,0,0,0,0,1,0,2,3,4,1,0,5
3324,141933,2021,China,USA,0,1,7,8,20/06/2021,0,0,3,3,9,4,12,25,0,2,0,2,3,1,1,5,5,2,1,8
3325,141933,2021,USA,Russia,2,1,15,18,19/06/2021,0,0,9,9,11,3,17,31,3,3,3,9,13,0,10,23,10,2,4,16
3326,141933,2021,Poland,USA,0,0,0,0,18/06/2021,0,0,0,0,0,0,0,0,0,0,0,0,0,0,0,0,0,0,0,0
3327,141933,2021,USA,Türkiye,0,0,0,0,14/06/2021,0,0,0,0,0,0,0,0,0,0,0,0,0,0,0,0,0,0,0,0
3328,141933,2021,USA,Japan,2,3,11,16,13/06/2021,0,1,0,1,11,3,14,28,1,2,5,8,14,1,13,28,15,1,0,16
3329,141933,2021,USA,Belgium,1,1,9,11,12/06/2021,0,0,1,1,12,2,16,30,1,2,3,6,3,1,7,11,16,3,0,19
3330,141933,2021,Italy,USA,1,3,9,13,08/06/2021,0,0,7,7,9,6,17,32,1,3,2,6,5,0,4,9,14,1,1,16
3331,141933,2021,Germany,USA,3,2,10,15,06/06/2021,0,0,4,4,12,6,8,26,2,0,1,3,5,0,8,13,4,2,0,6
3332,141933,2021,Thailand,USA,0,0,0,0,02/06/2021,0,0,0,0,0,0,0,0,0,0,0,0,0,0,0,0,0,0,0,0
3333,141933,2021,USA,Netherlands,2,0,14,16,01/06/2021,0,0,4,4,10,5,13,28,1,2,0,3,9,0,10,19,15,0,1,16
3334,141933,2021,Serbia,USA,0,0,0,0,31/05/2021,0,0,0,0,0,0,0,0,0,0,0,0,0,0,0,0,0,0,0,0
3335,166638,2021,Brazil,USA,0,0,0,0,25/06/2021,0,0,0,0,0,0,0,0,0,0,0,0,0,0,0,0,0,0,0,0
3336,166638,2021,USA,Türkiye,0,0,0,0,24/06/2021,0,0,0,0,0,0,0,0,0,0,0,0,0,0,0,0,0,0,0,0
3337,166638,2021,USA,Russia,2,5,10,17,19/06/2021,0,0,0,0,7,0,1,8,2,7,6,15,0,0,1,1,0,0,1,1
3338,166638,2021,Poland,USA,0,0,0,0,18/06/2021,0,0,0,0,0,0,0,0,0,0,0,0,0,0,0,0,0,0,0,0
3339,166638,2021,USA,Türkiye,0,0,0,0,14/06/2021,0,0,0,0,0,0,0,0,0,0,0,0,0,0,0,0,0,0,0,0
3340,166638,2021,USA,Japan,0,2,5,7,13/06/2021,0,0,0,0,3,1,5,9,4,3,11,18,0,0,0,0,2,0,1,3
3341,166638,2021,USA,Belgium,0,2,4,6,12/06/2021,0,1,0,1,4,0,3,7,2,2,4,8,0,0,0,0,1,0,0,1
3342,166638,2021,Korea,USA,0,1,9,10,07/06/2021,0,0,0,0,5,1,1,7,4,1,7,12,0,0,0,0,1,0,1,2
3343,166638,2021,Germany,USA,0,2,9,11,06/06/2021,0,0,1,1,5,0,2,7,1,3,4,8,0,0,0,0,0,1,0,1
3344,166638,2021,Thailand,USA,0,0,0,0,02/06/2021,0,0,0,0,0,0,0,0,0,0,0,0,0,0,0,0,0,0,0,0
3345,166638,2021,Serbia,USA,1,5,2,8,31/05/2021,0,0,0,0,6,0,8,14,2,7,6,15,0,0,0,0,2,1,0,3
3346,160209,2022,Belgium,Japan,0,0,0,0,03/07/2022,0,0,2,2,0,0,0,0,0,0,0,0,0,0,0,0,0,0,0,0
3347,160209,2022,Belgium,Netherlands,0,0,0,0,01/07/2022,0,0,0,0,0,0,0,0,0,1,0,1,0,0,0,0,0,0,0,0
3348,160209,2022,Germany,Belgium,0,0,0,0,30/06/2022,0,0,1,1,0,0,0,0,0,0,0,0,0,0,0,0,0,0,0,0
3349,160209,2022,Belgium,USA,0,0,1,1,30/06/2022,1,0,11,12,0,0,0,0,0,1,0,1,0,0,0,0,1,0,0,1
3350,160209,2022,Türkiye,Belgium,0,0,1,1,05/06/2022,7,1,14,22,0,0,1,1,0,2,2,4,0,0,0,0,2,0,1,3
3351,160209,2022,Thailand,Belgium,0,0,0,0,04/06/2022,0,0,2,2,0,0,0,0,0,0,2,2,0,0,0,0,0,0,0,0
3352,160209,2022,Belgium,Italy,0,0,3,3,02/06/2022,1,0,14,15,0,0,1,1,0,0,0,0,0,0,0,0,1,0,0,1
3353,160209,2022,Belgium,Serbia,0,0,0,0,01/06/2022,1,0,0,1,0,0,0,0,0,1,0,1,0,0,0,0,0,0,0,0
3354,152042,2022,Belgium,Japan,0,3,14,17,03/07/2022,0,0,7,7,29,3,35,67,0,2,1,3,8,0,7,15,11,1,0,12
3355,152042,2022,Belgium,Netherlands,2,2,12,16,01/07/2022,0,1,4,5,28,11,47,86,1,3,0,4,16,1,19,36,6,1,0,7
3356,152042,2022,Germany,Belgium,0,1,13,14,30/06/2022,0,0,6,6,33,6,43,82,1,2,1,4,2,0,9,11,8,2,0,10
3357,152042,2022,Belgium,USA,1,0,11,12,30/06/2022,0,0,3,3,16,5,16,37,1,4,0,5,5,0,8,13,2,3,0,5
3358,152042,2022,Bulgaria,Belgium,0,3,21,24,19/06/2022,0,0,2,2,23,11,50,84,3,4,5,12,7,1,27,35,12,3,1,16
3359,152042,2022,Belgium,Poland,0,2,14,16,18/06/2022,1,0,2,3,33,8,43,84,0,0,6,6,4,1,9,14,7,0,1,8
3360,152042,2022,Canada,Belgium,1,0,11,12,16/06/2022,0,0,1,1,24,4,31,59,4,1,2,7,1,0,7,8,7,5,0,12
3361,152042,2022,China,Belgium,1,0,4,5,15/06/2022,0,0,1,1,5,4,2,11,0,0,0,0,0,0,0,0,0,1,0,1
3362,152042,2022,Türkiye,Belgium,1,1,12,14,05/06/2022,0,0,2,2,18,9,32,59,1,1,2,4,6,0,20,26,11,2,2,15
3363,152042,2022,Thailand,Belgium,0,1,21,22,04/06/2022,0,0,3,3,22,10,34,66,1,3,5,9,4,0,15,19,14,4,1,19
3364,152042,2022,Belgium,Italy,0,4,10,14,02/06/2022,0,0,1,1,24,6,25,55,2,4,1,7,2,1,23,26,7,4,1,12
3365,152042,2022,Belgium,Serbia,3,2,10,15,01/06/2022,0,0,2,2,27,6,42,75,1,3,4,8,5,1,18,24,4,1,1,6
3366,135880,2022,Belgium,Japan,0,0,16,16,03/07/2022,0,0,2,2,6,2,3,11,2,9,4,15,0,0,0,0,2,0,0,2
3367,135880,2022,Belgium,Netherlands,0,1,11,12,01/07/2022,0,0,1,1,0,0,5,5,2,3,3,8,0,0,0,0,0,1,0,1
3368,135880,2022,Germany,Belgium,0,2,8,10,30/06/2022,0,0,1,1,5,1,4,10,1,5,1,7,0,0,0,0,3,1,0,4
3369,135880,2022,Belgium,USA,0,0,0,0,30/06/2022,0,0,0,0,0,0,0,0,0,0,0,0,0,0,0,0,0,0,0,0
3370,135880,2022,Bulgaria,Belgium,0,1,8,9,19/06/2022,0,0,6,6,5,3,4,12,3,1,7,11,0,0,0,0,1,0,0,1
3371,135880,2022,Belgium,Poland,0,1,15,16,18/06/2022,0,0,2,2,6,0,5,11,2,4,4,10,0,0,1,1,3,1,0,4
3372,135880,2022,Canada,Belgium,1,0,18,19,16/06/2022,0,0,2,2,1,1,4,6,0,3,5,8,0,0,0,0,3,0,0,3
3373,135880,2022,China,Belgium,0,0,0,0,15/06/2022,0,0,0,0,0,0,0,0,0,0,0,0,0,0,0,0,0,0,0,0
3374,135880,2022,Türkiye,Belgium,2,0,10,12,05/06/2022,1,0,2,3,5,0,6,11,2,6,9,17,0,0,0,0,2,0,2,4
3375,135880,2022,Thailand,Belgium,0,1,10,11,04/06/2022,0,0,2,2,10,0,1,11,0,8,7,15,0,0,0,0,2,1,0,3
3376,135880,2022,Belgium,Italy,0,1,9,10,02/06/2022,0,0,3,3,4,2,4,10,4,3,8,15,0,0,0,0,2,2,1,5
3377,135880,2022,Belgium,Serbia,0,0,4,4,01/06/2022,0,0,2,2,1,0,2,3,1,3,4,8,0,0,0,0,0,1,0,1
3378,156326,2022,Belgium,Japan,0,0,6,6,03/07/2022,0,0,1,1,3,5,10,18,0,2,1,3,12,0,12,24,5,1,1,7
3379,156326,2022,Belgium,Netherlands,0,2,12,14,01/07/2022,0,0,3,3,12,4,16,32,1,1,2,4,14,3,25,42,16,1,1,18
3380,156326,2022,Germany,Belgium,0,2,15,17,30/06/2022,0,0,4,4,8,2,8,18,0,1,0,1,9,2,16,27,12,1,0,13
3381,156326,2022,Belgium,USA,2,0,8,10,30/06/2022,0,0,0,0,4,4,14,22,0,3,0,3,7,0,17,24,2,0,0,2
3382,156326,2022,Bulgaria,Belgium,1,1,13,15,19/06/2022,1,0,3,4,5,8,10,23,0,2,2,4,7,0,29,36,10,4,3,17
3383,156326,2022,Belgium,Poland,0,1,12,13,18/06/2022,0,0,3,3,3,5,4,12,0,4,0,4,4,2,17,23,15,4,0,19
3384,156326,2022,Canada,Belgium,1,1,9,11,16/06/2022,0,0,1,1,5,2,10,17,1,3,4,8,4,1,13,18,6,3,0,9
3385,156326,2022,China,Belgium,0,1,11,12,15/06/2022,0,0,2,2,7,3,9,19,0,1,2,3,5,1,10,16,4,3,1,8
3386,181274,2022,,,-,-,-,-,-,-,-,-,-,-,-,-,-,-,-,-,-,-,-,-,-,-,-,-,-
3387,151117,2022,Belgium,Japan,0,0,0,0,03/07/2022,0,0,0,0,0,0,0,0,0,0,0,0,0,0,0,0,0,0,0,0
3388,151117,2022,Belgium,Netherlands,0,0,0,0,01/07/2022,0,0,0,0,0,0,0,0,0,0,0,0,0,0,0,0,0,0,0,0
3389,151117,2022,Germany,Belgium,0,0,0,0,30/06/2022,0,0,0,0,0,0,0,0,0,0,0,0,0,0,0,0,0,0,0,0
3390,151117,2022,Belgium,USA,0,0,0,0,30/06/2022,0,0,0,0,0,0,0,0,0,0,0,0,0,0,0,0,0,0,0,0
3391,151117,2022,Bulgaria,Belgium,0,0,4,4,19/06/2022,0,0,0,0,0,0,3,3,0,1,2,3,2,0,6,8,7,4,0,11
3392,151117,2022,Belgium,Poland,1,0,19,20,18/06/2022,0,0,6,6,5,3,17,25,1,5,4,10,2,0,14,16,11,0,0,11
3393,151117,2022,Canada,Belgium,2,1,16,19,16/06/2022,0,0,3,3,12,2,8,22,2,4,1,7,4,1,24,29,11,7,0,18
3394,151117,2022,China,Belgium,1,2,5,8,15/06/2022,0,0,1,1,10,5,13,28,0,0,1,1,7,1,36,44,8,0,0,8
3395,151117,2022,Türkiye,Belgium,0,1,9,10,05/06/2022,0,0,3,3,8,9,14,31,1,0,3,4,8,1,17,26,15,3,5,23
3396,151117,2022,Thailand,Belgium,0,0,12,12,04/06/2022,0,1,2,3,12,3,29,44,1,3,5,9,11,1,22,34,24,3,1,28
3397,151117,2022,Belgium,Italy,0,1,14,15,02/06/2022,0,0,0,0,8,7,17,32,1,2,1,4,10,2,20,32,6,5,1,12
3398,151117,2022,Belgium,Serbia,1,1,14,16,01/06/2022,0,0,3,3,8,6,21,35,0,4,4,8,5,1,24,30,10,3,5,18
3399,146631,2022,,,-,-,-,-,-,-,-,-,-,-,-,-,-,-,-,-,-,-,-,-,-,-,-,-,-
3400,181275,2022,Belgium,Japan,0,0,0,0,03/07/2022,0,0,0,0,0,0,0,0,0,0,0,0,0,0,0,0,1,0,0,1
3401,181275,2022,Belgium,Netherlands,0,0,0,0,01/07/2022,0,0,7,7,0,0,0,0,0,0,0,0,0,0,1,1,10,4,0,14
3402,181275,2022,Germany,Belgium,0,0,0,0,30/06/2022,0,0,2,2,0,0,0,0,0,0,0,0,0,0,3,3,5,1,0,6
3403,181275,2022,Belgium,USA,0,0,0,0,30/06/2022,0,0,4,4,0,0,0,0,0,0,0,0,0,0,0,0,3,4,0,7
3404,181275,2022,Bulgaria,Belgium,0,0,0,0,19/06/2022,0,0,6,6,0,0,0,0,0,0,0,0,0,0,2,2,12,3,4,19
3405,181275,2022,Belgium,Poland,0,0,0,0,18/06/2022,0,1,4,5,0,0,0,0,0,0,0,0,0,0,0,0,13,3,0,16
3406,181275,2022,Türkiye,Belgium,0,0,0,0,05/06/2022,0,0,0,0,0,0,0,0,0,0,0,0,0,0,0,0,0,0,0,0
3407,181275,2022,Thailand,Belgium,0,0,0,0,04/06/2022,0,0,0,0,0,0,0,0,0,0,0,0,1,0,2,3,2,0,0,2
3408,181275,2022,Belgium,Italy,0,0,0,0,02/06/2022,0,0,0,0,0,0,0,0,0,0,0,0,0,0,0,0,0,0,0,0
3409,181275,2022,Belgium,Serbia,0,0,0,0,01/06/2022,0,0,3,3,0,0,0,0,0,0,0,0,1,1,5,7,5,4,1,10
3410,177099,2022,Belgium,Japan,0,0,0,0,03/07/2022,0,0,0,0,0,0,0,0,0,0,0,0,0,0,0,0,0,0,0,0
3411,177099,2022,Belgium,Netherlands,0,0,0,0,01/07/2022,0,0,0,0,0,0,0,0,0,0,0,0,0,0,0,0,0,0,0,0
3412,177099,2022,Germany,Belgium,0,0,0,0,30/06/2022,0,0,0,0,0,0,0,0,0,0,0,0,0,0,0,0,0,0,0,0
3413,177099,2022,Belgium,USA,0,2,2,4,30/06/2022,0,0,0,0,5,4,6,15,0,2,1,3,0,0,0,0,4,0,1,5
3414,177099,2022,Bulgaria,Belgium,1,0,4,5,19/06/2022,0,0,2,2,4,3,2,9,0,0,2,2,0,0,0,0,5,1,0,6
3415,177099,2022,Belgium,Poland,0,0,0,0,18/06/2022,0,0,0,0,0,0,0,0,0,0,0,0,0,0,0,0,0,0,0,0
3416,177099,2022,Canada,Belgium,0,1,0,1,16/06/2022,0,0,0,0,2,3,0,5,2,1,1,4,1,0,0,1,1,0,0,1
3417,177099,2022,China,Belgium,0,1,5,6,15/06/2022,0,0,2,2,11,4,8,23,0,0,1,1,0,0,0,0,5,2,0,7
3418,177099,2022,Türkiye,Belgium,0,2,7,9,05/06/2022,0,0,1,1,12,3,10,25,1,1,1,3,0,0,0,0,3,4,1,8
3419,177099,2022,Thailand,Belgium,0,0,0,0,04/06/2022,0,0,0,0,0,0,0,0,0,0,0,0,0,0,0,0,0,0,0,0
3420,177099,2022,Belgium,Italy,2,1,13,16,02/06/2022,1,1,1,3,9,4,10,23,0,1,2,3,0,0,0,0,4,2,3,9
3421,177099,2022,Belgium,Serbia,0,0,0,0,01/06/2022,0,0,0,0,0,0,0,0,0,0,0,0,0,0,0,0,0,0,0,0
3422,166072,2022,Bulgaria,Belgium,0,0,0,0,19/06/2022,0,0,0,0,0,0,0,0,0,0,0,0,0,0,0,0,0,0,0,0
3423,166072,2022,Belgium,Poland,0,0,0,0,18/06/2022,0,0,0,0,0,0,0,0,0,0,0,0,0,0,0,0,0,0,0,0
3424,166072,2022,Canada,Belgium,0,0,0,0,16/06/2022,0,0,0,0,0,0,0,0,0,0,0,0,0,0,0,0,0,0,0,0
3425,166072,2022,China,Belgium,0,1,6,7,15/06/2022,0,0,1,1,4,1,5,10,0,3,4,7,0,0,0,0,3,4,0,7
3426,166072,2022,Türkiye,Belgium,0,0,2,2,05/06/2022,0,0,1,1,1,0,1,2,0,0,0,0,0,1,0,1,0,0,1,1
3427,166072,2022,Thailand,Belgium,0,0,0,0,04/06/2022,0,0,0,0,0,0,0,0,0,0,0,0,0,0,0,0,0,0,0,0
3428,166072,2022,Belgium,Italy,0,0,0,0,02/06/2022,0,0,0,0,0,0,0,0,0,0,0,0,0,0,0,0,0,0,0,0
3429,166072,2022,Belgium,Serbia,0,0,0,0,01/06/2022,0,0,0,0,0,0,0,0,0,0,0,0,0,0,0,0,0,0,0,0
3430,160479,2022,Belgium,Japan,0,0,1,1,03/07/2022,0,0,8,8,0,1,0,1,1,0,0,1,0,0,0,0,0,0,0,0
3431,160479,2022,Belgium,Netherlands,0,0,1,1,01/07/2022,0,0,13,13,0,0,1,1,0,0,0,0,0,0,0,0,0,2,0,2
3432,160479,2022,Germany,Belgium,0,1,2,3,30/06/2022,1,0,39,40,1,0,1,2,0,1,0,1,0,0,0,0,2,1,0,3
3433,160479,2022,Belgium,USA,0,0,0,0,30/06/2022,0,0,0,0,0,0,0,0,0,0,0,0,0,0,0,0,0,0,0,0
3434,160479,2022,Bulgaria,Belgium,1,2,6,9,19/06/2022,10,1,47,58,1,0,1,2,1,1,6,8,0,0,0,0,6,2,2,10
3435,160479,2022,Belgium,Poland,0,0,9,9,18/06/2022,13,0,66,79,1,0,0,1,0,4,3,7,0,0,0,0,9,2,1,12
3436,160479,2022,Canada,Belgium,0,0,4,4,16/06/2022,2,0,26,28,1,0,0,1,0,1,1,2,0,0,0,0,1,1,0,2
3437,160479,2022,China,Belgium,0,0,6,6,15/06/2022,11,2,45,58,1,0,0,1,0,0,0,0,0,0,0,0,10,0,1,11
3438,160479,2022,Türkiye,Belgium,0,0,0,0,05/06/2022,0,0,0,0,0,0,0,0,0,0,0,0,0,0,0,0,0,0,0,0
3439,160479,2022,Thailand,Belgium,0,0,0,0,04/06/2022,0,1,1,2,1,0,0,1,0,0,0,0,0,0,0,0,0,0,0,0
3440,160479,2022,Belgium,Italy,0,0,0,0,02/06/2022,0,0,0,0,0,0,0,0,0,0,0,0,0,0,0,0,0,0,0,0
3441,160479,2022,Belgium,Serbia,0,0,0,0,01/06/2022,2,0,2,4,1,0,0,1,0,0,0,0,0,0,0,0,0,0,0,0
3442,156325,2022,Belgium,Japan,0,3,10,13,03/07/2022,0,0,2,2,7,2,16,25,4,7,3,14,0,0,0,0,3,0,0,3
3443,156325,2022,Belgium,Netherlands,1,2,8,11,01/07/2022,0,0,2,2,8,1,8,17,4,3,6,13,0,0,0,0,2,0,0,2
3444,156325,2022,Germany,Belgium,2,2,10,14,30/06/2022,0,0,3,3,6,1,6,13,3,2,1,6,0,0,1,1,3,0,0,3
3445,156325,2022,Belgium,USA,1,3,6,10,30/06/2022,0,0,1,1,4,3,7,14,2,1,1,4,1,0,0,1,2,1,0,3
3446,156325,2022,Bulgaria,Belgium,1,5,10,16,19/06/2022,0,0,0,0,8,0,8,16,1,2,5,8,0,0,0,0,5,0,0,5
3447,156325,2022,Belgium,Poland,1,2,10,13,18/06/2022,1,0,0,1,6,4,7,17,5,6,7,18,0,0,0,0,7,3,0,10
3448,156325,2022,Canada,Belgium,0,2,9,11,16/06/2022,2,0,6,8,5,3,4,12,3,3,1,7,0,0,0,0,1,0,1,2
3449,156325,2022,China,Belgium,0,0,0,0,15/06/2022,0,0,0,0,0,0,0,0,0,0,0,0,0,0,0,0,0,0,0,0
3450,156325,2022,Türkiye,Belgium,0,0,0,0,05/06/2022,0,0,0,0,0,0,0,0,0,0,0,0,0,0,0,0,0,0,0,0
3451,156325,2022,Thailand,Belgium,1,2,11,14,04/06/2022,0,0,1,1,9,3,4,16,4,4,9,17,0,0,0,0,4,2,0,6
3452,156325,2022,Belgium,Italy,0,0,0,0,02/06/2022,0,0,0,0,0,0,0,0,0,0,0,0,0,0,0,0,0,0,0,0
3453,156325,2022,Belgium,Serbia,1,1,11,13,01/06/2022,0,0,3,3,10,0,14,24,6,1,3,10,0,0,1,1,1,1,1,3
3454,189124,2022,,,-,-,-,-,-,-,-,-,-,-,-,-,-,-,-,-,-,-,-,-,-,-,-,-,-
3455,160208,2022,Belgium,Japan,2,2,10,14,03/07/2022,9,0,117,126,1,0,1,2,0,1,2,3,0,0,0,0,11,0,0,11
3456,160208,2022,Belgium,Netherlands,0,2,16,18,01/07/2022,5,0,127,132,1,0,1,2,0,0,1,1,0,0,1,1,14,5,0,19
3457,160208,2022,Germany,Belgium,0,0,10,10,30/06/2022,6,1,82,89,0,0,4,4,0,2,0,2,0,0,1,1,2,1,0,3
3458,160208,2022,Belgium,USA,0,0,8,8,30/06/2022,0,1,81,82,1,0,0,1,1,0,0,1,0,0,1,1,7,2,0,9
3459,160208,2022,Bulgaria,Belgium,2,1,10,13,19/06/2022,19,1,70,90,2,0,0,2,0,0,2,2,0,0,0,0,11,1,0,12
3460,160208,2022,Belgium,Poland,0,0,4,4,18/06/2022,8,0,47,55,0,0,2,2,0,1,0,1,0,0,0,0,5,3,0,8
3461,160208,2022,Canada,Belgium,0,2,12,14,16/06/2022,4,2,57,63,0,0,1,1,1,0,0,1,0,0,0,0,9,3,3,15
3462,160208,2022,China,Belgium,0,0,3,3,15/06/2022,6,1,21,28,0,0,0,0,0,2,0,2,0,0,0,0,0,2,1,3
3463,160208,2022,Türkiye,Belgium,1,2,14,17,05/06/2022,38,1,56,95,0,0,0,0,0,1,1,2,0,0,0,0,5,1,3,9
3464,160208,2022,Thailand,Belgium,1,2,19,22,04/06/2022,43,2,93,138,2,0,2,4,0,2,2,4,0,0,1,1,11,2,4,17
3465,160208,2022,Belgium,Italy,1,2,11,14,02/06/2022,7,1,95,103,0,0,1,1,0,3,2,5,0,0,0,0,8,0,1,9
3466,160208,2022,Belgium,Serbia,0,1,12,13,01/06/2022,27,1,106,134,0,0,1,1,0,1,4,5,0,0,0,0,5,2,2,9
3467,152046,2022,,,-,-,-,-,-,-,-,-,-,-,-,-,-,-,-,-,-,-,-,-,-,-,-,-,-
3468,168160,2022,Belgium,Japan,0,0,0,0,03/07/2022,0,0,5,5,0,0,0,0,0,0,1,1,9,0,7,16,15,2,0,17
3469,168160,2022,Belgium,Netherlands,0,0,0,0,01/07/2022,0,0,7,7,0,0,0,0,0,0,0,0,4,0,4,8,14,1,0,15
3470,168160,2022,Germany,Belgium,0,0,0,0,30/06/2022,0,0,9,9,0,0,0,0,0,0,0,0,14,2,26,42,14,3,1,18
3471,168160,2022,Belgium,USA,0,0,0,0,30/06/2022,0,0,4,4,0,0,0,0,0,0,0,0,9,2,16,27,5,1,0,6
3472,168160,2022,Bulgaria,Belgium,0,0,0,0,19/06/2022,0,1,6,7,0,0,0,0,0,0,0,0,3,0,14,17,7,1,1,9
3473,168160,2022,Belgium,Poland,0,0,0,0,18/06/2022,0,0,11,11,0,0,0,0,0,0,0,0,5,3,29,37,13,3,1,17
3474,168160,2022,Canada,Belgium,0,0,0,0,16/06/2022,0,0,12,12,0,0,0,0,0,0,0,0,6,2,19,27,7,9,1,17
3475,168160,2022,China,Belgium,0,0,0,0,15/06/2022,0,0,10,10,0,0,0,0,0,0,0,0,4,0,5,9,13,6,1,20
3476,168160,2022,Türkiye,Belgium,0,0,0,0,05/06/2022,0,0,9,9,0,0,0,0,0,0,0,0,5,1,21,27,12,1,1,14
3477,168160,2022,Thailand,Belgium,0,0,0,0,04/06/2022,1,0,12,13,0,0,0,0,0,0,0,0,9,1,27,37,11,7,2,20
3478,168160,2022,Belgium,Italy,0,0,0,0,02/06/2022,0,0,5,5,0,0,0,0,0,0,0,0,6,1,17,24,9,4,2,15
3479,168160,2022,Belgium,Serbia,0,0,0,0,01/06/2022,0,0,3,3,0,0,0,0,0,0,0,0,3,0,11,14,7,1,0,8
3480,152040,2022,Belgium,Japan,0,0,8,8,03/07/2022,0,0,0,0,6,0,12,18,2,3,0,5,0,0,0,0,4,2,0,6
3481,152040,2022,Belgium,Netherlands,0,0,12,12,01/07/2022,0,0,3,3,11,3,9,23,1,2,3,6,0,0,0,0,11,2,0,13
3482,152040,2022,Germany,Belgium,1,2,13,16,30/06/2022,0,0,1,1,8,0,15,23,0,2,0,2,0,0,0,0,11,4,0,15
3483,152040,2022,Belgium,USA,0,1,8,9,30/06/2022,0,0,0,0,6,0,7,13,1,2,0,3,0,0,1,1,2,0,0,2
3484,152040,2022,Bulgaria,Belgium,1,1,6,8,19/06/2022,0,0,1,1,9,3,14,26,3,8,8,19,0,0,0,0,9,1,2,12
3485,152040,2022,Belgium,Poland,1,1,2,4,18/06/2022,0,0,0,0,4,0,3,7,0,3,5,8,0,0,0,0,1,0,0,1
3486,152040,2022,Türkiye,Belgium,0,2,11,13,05/06/2022,1,1,1,3,6,1,7,14,1,2,4,7,1,0,0,1,6,0,1,7
3487,152040,2022,Thailand,Belgium,3,1,15,19,04/06/2022,1,0,2,3,11,3,8,22,2,1,6,9,0,0,0,0,6,1,4,11
3488,152040,2022,Belgium,Italy,1,0,12,13,02/06/2022,0,0,0,0,7,3,9,19,2,8,4,14,0,0,1,1,1,1,0,2
3489,152040,2022,Belgium,Serbia,0,1,8,9,01/06/2022,0,0,0,0,3,1,14,18,0,5,4,9,0,0,0,0,3,0,0,3
3490,170706,2022,,,-,-,-,-,-,-,-,-,-,-,-,-,-,-,-,-,-,-,-,-,-,-,-,-,-
3491,152057,2022,Belgium,Japan,3,1,13,17,03/07/2022,0,0,1,1,7,0,9,16,2,2,2,6,17,3,11,31,9,3,0,12
3492,152057,2022,Belgium,Netherlands,0,1,3,4,01/07/2022,0,1,0,1,0,0,0,0,0,0,0,0,0,0,0,0,1,1,0,2
3493,152057,2022,Germany,Belgium,1,0,1,2,30/06/2022,0,0,0,0,0,0,0,0,0,0,0,0,0,0,0,0,0,0,0,0
3494,152057,2022,Belgium,USA,0,0,4,4,30/06/2022,0,0,1,1,0,0,1,1,0,0,0,0,1,0,0,1,1,0,0,1
3495,152057,2022,Bulgaria,Belgium,1,1,2,4,19/06/2022,0,0,0,0,0,0,1,1,0,0,0,0,0,0,0,0,2,0,0,2
3496,152057,2022,Belgium,Poland,2,0,5,7,18/06/2022,0,0,0,0,0,0,0,0,0,0,0,0,0,0,0,0,0,1,0,1
3497,152057,2022,Türkiye,Belgium,0,1,4,5,05/06/2022,0,0,0,0,0,0,0,0,0,0,0,0,0,0,0,0,2,2,1,5
3498,152057,2022,Thailand,Belgium,1,1,4,6,04/06/2022,0,0,1,1,0,1,1,2,0,1,2,3,0,0,2,2,5,2,1,8
3499,152057,2022,Belgium,Italy,0,1,1,2,02/06/2022,0,0,1,1,0,0,0,0,0,0,0,0,0,1,0,1,0,0,0,0
3500,152057,2022,Belgium,Serbia,0,2,9,11,01/06/2022,0,0,0,0,4,1,6,11,1,1,2,4,3,0,5,8,0,1,0,1
3501,170698,2022,Belgium,Japan,0,0,1,1,03/07/2022,0,0,0,0,0,0,0,0,0,0,0,0,0,0,0,0,0,0,0,0
3502,170698,2022,Belgium,Netherlands,0,0,3,3,01/07/2022,0,0,0,0,0,0,1,1,0,0,0,0,0,0,1,1,0,0,0,0
3503,170698,2022,Germany,Belgium,0,0,0,0,30/06/2022,0,0,0,0,0,0,0,0,0,0,0,0,0,0,0,0,0,0,0,0
3504,170698,2022,Belgium,USA,0,0,0,0,30/06/2022,0,0,0,0,0,0,0,0,0,0,0,0,0,0,0,0,0,0,0,0
3505,170698,2022,Bulgaria,Belgium,0,0,0,0,19/06/2022,0,0,0,0,0,0,0,0,0,0,0,0,0,0,0,0,0,0,0,0
3506,170698,2022,Belgium,Poland,0,0,0,0,18/06/2022,0,0,0,0,0,0,0,0,0,0,0,0,0,0,0,0,0,0,0,0
3507,170698,2022,Canada,Belgium,0,0,0,0,16/06/2022,0,0,0,0,0,0,0,0,0,0,1,1,0,0,0,0,0,0,0,0
3508,170698,2022,China,Belgium,0,1,8,9,15/06/2022,0,0,0,0,6,2,3,11,0,1,2,3,0,0,1,1,1,2,0,3
3509,170698,2022,Türkiye,Belgium,0,0,0,0,05/06/2022,0,0,0,0,0,0,0,0,0,0,0,0,0,0,0,0,0,0,0,0
3510,170698,2022,Thailand,Belgium,0,0,0,0,04/06/2022,0,0,0,0,0,0,0,0,0,0,0,0,0,0,0,0,0,0,0,0
3511,170698,2022,Belgium,Italy,0,0,1,1,02/06/2022,0,0,0,0,0,0,0,0,0,0,0,0,0,0,0,0,0,0,0,0
3512,170698,2022,Belgium,Serbia,0,0,0,0,01/06/2022,0,0,0,0,0,0,0,0,0,0,0,0,0,0,0,0,0,0,0,0
3513,152088,2022,,,-,-,-,-,-,-,-,-,-,-,-,-,-,-,-,-,-,-,-,-,-,-,-,-,-
3514,186026,2022,,,-,-,-,-,-,-,-,-,-,-,-,-,-,-,-,-,-,-,-,-,-,-,-,-,-
3515,168161,2022,,,-,-,-,-,-,-,-,-,-,-,-,-,-,-,-,-,-,-,-,-,-,-,-,-,-
3516,181681,2022,,,-,-,-,-,-,-,-,-,-,-,-,-,-,-,-,-,-,-,-,-,-,-,-,-,-
3517,123728,2022,,,-,-,-,-,-,-,-,-,-,-,-,-,-,-,-,-,-,-,-,-,-,-,-,-,-
3518,140418,2022,,,-,-,-,-,-,-,-,-,-,-,-,-,-,-,-,-,-,-,-,-,-,-,-,-,-
3519,152119,2022,Brazil,Serbia,0,0,9,9,19/06/2022,0,0,0,0,2,1,4,7,3,2,6,11,0,0,0,0,2,0,0,2
3520,152119,2022,Italy,Brazil,2,2,10,14,18/06/2022,0,0,0,0,1,2,3,6,2,3,0,5,1,0,0,1,2,0,0,2
3521,152119,2022,Netherlands,Brazil,0,0,7,7,17/06/2022,0,0,2,2,2,2,2,6,3,1,5,9,0,0,0,0,1,0,0,1
3522,152119,2022,Brazil,Türkiye,3,1,13,17,16/06/2022,0,0,3,3,4,0,5,9,2,0,0,2,0,0,0,0,1,1,1,3
3523,152119,2022,USA,Brazil,0,0,0,0,05/06/2022,0,0,0,0,0,0,0,0,0,0,0,0,0,0,0,0,0,0,0,0
3524,152119,2022,Dominican Republic,Brazil,0,0,0,0,03/06/2022,0,0,0,0,0,0,0,0,0,0,0,0,0,0,0,0,0,0,0,0
3525,152119,2022,Brazil,Poland,0,1,8,9,02/06/2022,0,0,1,1,6,1,2,9,2,2,2,6,0,0,0,0,4,0,0,4
3526,152119,2022,Germany,Brazil,0,0,8,8,31/05/2022,0,0,2,2,7,1,2,10,4,4,5,13,0,0,0,0,7,1,0,8
3527,173848,2022,Italy,Brazil,0,0,6,6,17/07/2022,0,0,1,1,1,0,4,5,0,2,3,5,0,0,0,0,0,0,0,0
3528,173848,2022,Serbia,Brazil,0,1,6,7,16/07/2022,0,0,2,2,3,1,2,6,3,3,2,8,1,0,1,2,1,0,0,1
3529,173848,2022,Brazil,Japan,1,2,11,14,13/07/2022,0,0,1,1,1,1,4,6,3,3,5,11,0,0,0,0,2,0,2,4
3530,173848,2022,Brazil,Thailand,0,0,12,12,02/07/2022,0,0,0,0,10,1,6,17,2,4,2,8,0,0,0,0,3,2,1,6
3531,173848,2022,Brazil,Bulgaria,0,1,9,10,01/07/2022,0,0,2,2,8,1,0,9,3,2,1,6,0,0,0,0,3,0,0,3
3532,173848,2022,Korea,Brazil,1,0,8,9,30/06/2022,2,0,0,2,7,0,3,10,2,4,4,10,0,0,0,0,5,0,0,5
3533,173848,2022,China,Brazil,0,1,7,8,28/06/2022,1,0,1,2,5,2,3,10,1,6,5,12,0,0,0,0,3,0,1,4
3534,173848,2022,Brazil,Serbia,0,0,0,0,19/06/2022,0,0,0,0,0,0,0,0,0,0,0,0,0,0,0,0,0,0,0,0
3535,173848,2022,Italy,Brazil,0,0,0,0,18/06/2022,0,0,0,0,0,0,0,0,0,0,0,0,0,0,0,0,0,0,0,0
3536,173848,2022,Netherlands,Brazil,0,1,0,1,17/06/2022,0,0,1,1,0,0,0,0,0,1,2,3,0,0,0,0,0,0,0,0
3537,173848,2022,Brazil,Türkiye,0,0,0,0,16/06/2022,0,0,0,0,0,0,0,0,0,0,0,0,0,0,0,0,0,0,0,0
3538,144866,2022,Italy,Brazil,1,1,10,12,17/07/2022,0,0,1,1,6,0,2,8,1,6,4,11,0,0,0,0,0,1,1,2
3539,144866,2022,Serbia,Brazil,0,1,17,18,16/07/2022,0,0,3,3,7,2,2,11,6,10,10,26,0,0,0,0,2,1,1,4
3540,144866,2022,Brazil,Japan,0,1,13,14,13/07/2022,0,0,4,4,6,1,9,16,4,6,13,23,0,0,0,0,3,0,2,5
3541,144866,2022,Brazil,Thailand,0,1,15,16,02/07/2022,0,0,0,0,12,2,5,19,4,8,2,14,0,0,0,0,1,0,0,1
3542,144866,2022,Brazil,Bulgaria,1,1,16,18,01/07/2022,0,0,2,2,5,0,4,9,2,4,4,10,0,0,0,0,1,0,1,2
3543,144866,2022,Korea,Brazil,3,0,12,15,30/06/2022,1,0,0,1,1,0,3,4,2,1,0,3,0,0,0,0,0,0,0,0
3544,144866,2022,China,Brazil,1,2,13,16,28/06/2022,0,1,1,2,9,3,3,15,4,4,2,10,0,0,0,0,0,0,3,3
3545,144866,2022,Brazil,Serbia,1,1,11,13,19/06/2022,0,0,2,2,6,0,2,8,6,4,5,15,0,0,0,0,1,2,2,5
3546,144866,2022,Italy,Brazil,1,1,11,13,18/06/2022,0,0,1,1,6,3,2,11,2,6,4,12,1,0,1,2,2,0,0,2
3547,144866,2022,Netherlands,Brazil,1,0,7,8,17/06/2022,0,0,3,3,4,2,1,7,2,1,6,9,0,0,0,0,0,0,0,0
3548,144866,2022,Brazil,Türkiye,0,1,11,12,16/06/2022,0,1,2,3,8,1,3,12,6,5,4,15,0,0,0,0,0,1,1,2
3549,144866,2022,USA,Brazil,0,1,8,9,05/06/2022,0,0,2,2,3,1,4,8,5,5,5,15,0,0,0,0,3,0,0,3
3550,144866,2022,Dominican Republic,Brazil,0,1,11,12,03/06/2022,0,0,1,1,5,3,7,15,6,7,8,21,0,0,0,0,3,0,0,3
3551,144866,2022,Brazil,Poland,3,2,7,12,02/06/2022,0,0,2,2,5,1,2,8,7,8,4,19,0,0,0,0,2,1,0,3
3552,144866,2022,Germany,Brazil,1,1,21,23,31/05/2022,0,0,4,4,9,3,4,16,6,3,6,15,0,0,0,0,5,0,1,6
3553,115970,2022,Italy,Brazil,0,0,5,5,17/07/2022,0,0,0,0,1,1,1,3,0,0,0,0,4,1,7,12,1,1,1,3
3554,115970,2022,Serbia,Brazil,0,0,0,0,16/07/2022,0,0,0,0,0,0,0,0,0,0,0,0,0,0,0,0,0,0,0,0
3555,115970,2022,Brazil,Japan,0,0,0,0,13/07/2022,0,0,0,0,0,0,0,0,0,0,0,0,0,0,0,0,0,0,0,0
3556,115970,2022,Brazil,Thailand,0,0,0,0,02/07/2022,0,0,0,0,0,0,0,0,0,0,0,0,0,0,0,0,0,0,0,0
3557,115970,2022,Brazil,Bulgaria,0,3,3,6,01/07/2022,0,0,1,1,5,5,7,17,2,3,2,7,4,1,21,26,7,2,0,9
3558,115970,2022,Korea,Brazil,0,0,3,3,30/06/2022,1,0,0,1,7,1,4,12,1,1,2,4,2,1,3,6,3,1,0,4
3559,115970,2022,China,Brazil,0,0,11,11,28/06/2022,0,0,5,5,8,6,5,19,1,1,1,3,4,1,19,24,7,2,5,14
3560,115970,2022,Brazil,Serbia,0,0,7,7,19/06/2022,0,0,0,0,9,3,14,26,5,3,7,15,13,0,13,26,8,1,1,10
3561,115970,2022,Italy,Brazil,2,0,2,4,18/06/2022,0,0,0,0,2,3,2,7,0,0,0,0,1,0,2,3,1,0,0,1
3562,115970,2022,Netherlands,Brazil,0,1,12,13,17/06/2022,0,0,1,1,12,3,10,25,1,0,1,2,9,0,10,19,4,4,3,11
3563,115970,2022,Brazil,Türkiye,1,1,3,5,16/06/2022,0,0,0,0,6,2,5,13,1,0,0,1,4,1,16,21,1,0,1,2
3564,115970,2022,USA,Brazil,0,1,10,11,05/06/2022,0,0,0,0,6,1,13,20,1,3,2,6,10,0,5,15,3,3,1,7
3565,115970,2022,Dominican Republic,Brazil,0,0,14,14,03/06/2022,0,0,0,0,8,0,10,18,0,0,1,1,7,3,1,11,5,2,0,7
3566,115970,2022,Brazil,Poland,0,0,12,12,02/06/2022,0,0,0,0,5,4,10,19,0,1,3,4,11,1,16,28,7,2,0,9
3567,115970,2022,Germany,Brazil,1,2,20,23,31/05/2022,0,0,2,2,11,3,16,30,1,4,3,8,6,1,3,10,9,5,0,14
3568,152135,2022,Italy,Brazil,0,0,0,0,17/07/2022,0,0,2,2,0,0,0,0,0,0,0,0,13,1,18,32,10,3,6,19
3569,152135,2022,Serbia,Brazil,0,0,0,0,16/07/2022,0,0,6,6,0,0,0,0,0,0,0,0,4,1,6,11,5,1,4,10
3570,152135,2022,Brazil,Japan,0,0,0,0,13/07/2022,0,0,0,0,0,0,0,0,0,0,0,0,0,0,0,0,0,0,0,0
3571,152135,2022,Brazil,Thailand,0,0,0,0,02/07/2022,0,0,0,0,0,0,0,0,0,0,0,0,0,0,0,0,0,0,0,0
3572,152135,2022,Brazil,Bulgaria,0,0,0,0,01/07/2022,0,0,0,0,0,0,0,0,0,0,0,0,0,0,0,0,0,0,1,1
3573,152135,2022,Korea,Brazil,0,0,0,0,30/06/2022,1,0,0,1,0,0,0,0,0,0,0,0,1,0,3,4,1,0,0,1
3574,152135,2022,China,Brazil,0,0,0,0,28/06/2022,0,0,0,0,0,0,0,0,0,0,0,0,0,0,0,0,0,0,0,0
3575,152135,2022,Brazil,Serbia,0,0,0,0,19/06/2022,0,0,7,7,0,0,0,0,0,0,0,0,10,0,4,14,15,1,1,17
3576,152135,2022,Italy,Brazil,0,0,0,0,18/06/2022,0,0,5,5,0,0,0,0,0,0,0,0,11,0,16,27,6,5,1,12
3577,152135,2022,Netherlands,Brazil,0,0,0,0,17/06/2022,0,0,5,5,0,0,0,0,0,0,0,0,2,2,12,16,13,1,2,16
3578,152135,2022,Brazil,Türkiye,0,0,0,0,16/06/2022,0,0,12,12,0,0,0,0,0,0,0,0,9,1,8,18,12,7,0,19
3579,152135,2022,USA,Brazil,0,0,0,0,05/06/2022,0,0,3,3,0,0,0,0,0,0,0,0,4,0,4,8,5,0,1,6
3580,152135,2022,Dominican Republic,Brazil,0,0,0,0,03/06/2022,0,0,7,7,0,0,0,0,0,0,0,0,17,1,1,19,21,5,1,27
3581,152135,2022,Brazil,Poland,0,0,0,0,02/06/2022,0,0,10,10,0,0,0,0,0,0,0,0,12,0,5,17,9,4,0,13
3582,152135,2022,Germany,Brazil,0,0,0,0,31/05/2022,0,0,18,18,0,0,0,0,0,0,0,0,10,2,5,17,25,4,2,31
3583,136897,2022,Italy,Brazil,0,0,2,2,17/07/2022,0,0,0,0,0,0,0,0,0,0,0,0,0,0,0,0,0,1,0,1
3584,136897,2022,Serbia,Brazil,0,2,0,2,16/07/2022,0,0,0,0,0,0,0,0,0,0,0,0,0,0,0,0,0,0,0,0
3585,136897,2022,Brazil,Japan,1,0,10,11,13/07/2022,0,0,1,1,0,0,0,0,0,0,0,0,0,0,0,0,1,0,0,1
3586,136897,2022,Brazil,Thailand,0,0,1,1,02/07/2022,0,0,0,0,0,0,0,0,0,0,0,0,0,0,0,0,0,0,0,0
3587,136897,2022,Brazil,Bulgaria,0,0,0,0,01/07/2022,0,0,0,0,0,0,0,0,0,0,0,0,0,0,0,0,0,0,0,0
3588,136897,2022,Korea,Brazil,0,0,6,6,30/06/2022,0,0,0,0,2,0,3,5,0,0,0,0,1,0,3,4,2,1,1,4
3589,136897,2022,China,Brazil,0,0,3,3,28/06/2022,0,0,0,0,0,0,0,0,0,0,0,0,0,0,0,0,0,1,0,1
3590,136897,2022,Brazil,Serbia,0,0,0,0,19/06/2022,0,0,0,0,0,0,4,4,0,0,1,1,0,0,0,0,0,0,0,0
3591,136897,2022,Italy,Brazil,0,0,2,2,18/06/2022,0,0,0,0,1,1,3,5,0,0,0,0,0,0,0,0,1,0,0,1
3592,136897,2022,Netherlands,Brazil,0,0,2,2,17/06/2022,0,0,0,0,0,0,0,0,0,0,0,0,0,0,0,0,0,0,0,0
3593,136897,2022,Brazil,Türkiye,0,0,2,2,16/06/2022,0,0,0,0,0,0,0,0,0,0,0,0,0,0,0,0,0,0,0,0
3594,151187,2022,Italy,Brazil,0,0,7,7,17/07/2022,13,0,55,68,1,0,0,1,1,0,1,2,0,0,0,0,1,2,1,4
3595,151187,2022,Serbia,Brazil,0,0,12,12,16/07/2022,24,0,69,93,1,0,2,3,0,4,3,7,0,0,0,0,7,4,4,15
3596,151187,2022,Brazil,Japan,0,0,13,13,13/07/2022,31,3,68,102,2,0,1,3,2,4,5,11,0,0,0,0,8,3,1,12
3597,151187,2022,Brazil,Thailand,0,0,8,8,02/07/2022,5,2,73,80,0,0,0,0,0,0,1,1,0,0,0,0,2,0,0,2
3598,151187,2022,Brazil,Bulgaria,0,1,11,12,01/07/2022,4,0,65,69,2,0,0,2,2,3,2,7,0,1,0,1,4,0,1,5
3599,151187,2022,Korea,Brazil,0,0,4,4,30/06/2022,31,0,0,31,0,1,0,1,1,0,0,1,0,0,0,0,2,0,1,3
3600,151187,2022,China,Brazil,0,3,17,20,28/06/2022,36,1,76,113,1,0,4,5,0,1,1,2,0,0,0,0,4,2,2,8
3601,151187,2022,Brazil,Serbia,0,2,9,11,19/06/2022,20,0,65,85,0,0,1,1,0,3,5,8,0,0,0,0,2,2,0,4
3602,151187,2022,Italy,Brazil,0,1,6,7,18/06/2022,26,1,54,81,0,1,0,1,1,2,1,4,0,0,1,1,1,2,0,3
3603,151187,2022,Netherlands,Brazil,0,0,14,14,17/06/2022,17,0,47,64,0,0,1,1,0,2,1,3,0,0,0,0,3,2,1,6
3604,151187,2022,Brazil,Türkiye,0,1,20,21,16/06/2022,35,0,64,99,0,0,1,1,1,2,1,4,0,0,0,0,4,1,1,6
3605,151187,2022,USA,Brazil,0,1,11,12,05/06/2022,13,0,49,62,1,1,1,3,0,1,1,2,0,0,0,0,8,1,1,10
3606,151187,2022,Dominican Republic,Brazil,1,1,8,10,03/06/2022,26,1,61,88,0,0,2,2,0,3,1,4,0,0,0,0,8,1,0,9
3607,151187,2022,Brazil,Poland,1,1,13,15,02/06/2022,12,0,52,64,0,1,0,1,0,1,0,1,0,0,0,0,7,1,0,8
3608,151187,2022,Germany,Brazil,0,1,13,14,31/05/2022,23,0,95,118,1,0,0,1,0,0,0,0,0,0,1,1,17,1,0,18
3609,119575,2022,Italy,Brazil,0,1,4,5,17/07/2022,2,0,19,21,0,0,0,0,0,0,0,0,0,0,0,0,2,0,0,2
3610,119575,2022,Serbia,Brazil,0,0,5,5,16/07/2022,3,0,10,13,0,0,0,0,0,0,0,0,0,0,0,0,1,1,0,2
3611,119575,2022,Brazil,Japan,0,0,5,5,13/07/2022,5,0,9,14,0,0,1,1,0,0,0,0,0,0,0,0,0,1,0,1
3612,119575,2022,Brazil,Thailand,0,1,7,8,02/07/2022,5,0,45,50,0,0,0,0,0,1,3,4,0,0,0,0,2,0,1,3
3613,119575,2022,Brazil,Bulgaria,0,0,3,3,01/07/2022,1,0,4,5,0,0,0,0,0,0,0,0,0,0,0,0,1,0,0,1
3614,119575,2022,Korea,Brazil,0,0,6,6,30/06/2022,35,1,0,36,0,0,0,0,0,0,2,2,0,0,0,0,0,1,0,1
3615,119575,2022,China,Brazil,0,0,5,5,28/06/2022,5,0,12,17,0,0,0,0,0,0,1,1,0,0,0,0,2,0,0,2
3616,119575,2022,Brazil,Serbia,0,0,2,2,19/06/2022,2,0,4,6,0,0,0,0,0,0,0,0,0,0,0,0,0,0,0,0
3617,119575,2022,Italy,Brazil,0,0,1,1,18/06/2022,5,0,9,14,0,0,0,0,0,0,0,0,0,0,0,0,1,1,0,2
3618,119575,2022,Netherlands,Brazil,0,0,0,0,17/06/2022,4,0,10,14,0,0,0,0,0,0,0,0,0,0,0,0,2,0,0,2
3619,119575,2022,Brazil,Türkiye,0,0,1,1,16/06/2022,6,0,7,13,0,0,0,0,0,0,0,0,0,0,0,0,2,1,0,3
3620,119575,2022,USA,Brazil,1,0,3,4,05/06/2022,2,0,9,11,0,0,0,0,0,0,0,0,0,0,0,0,0,0,0,0
3621,119575,2022,Dominican Republic,Brazil,0,0,3,3,03/06/2022,2,0,7,9,0,0,0,0,0,0,0,0,0,0,0,0,0,0,0,0
3622,119575,2022,Brazil,Poland,0,0,0,0,02/06/2022,0,0,3,3,0,0,0,0,0,0,0,0,0,0,0,0,0,0,0,0
3623,119575,2022,Germany,Brazil,0,0,1,1,31/05/2022,1,0,9,10,0,0,1,1,0,0,0,0,0,0,0,0,0,0,0,0
3624,136896,2022,Italy,Brazil,1,0,11,12,17/07/2022,0,0,2,2,9,7,10,26,1,0,2,3,3,0,3,6,9,2,1,12
3625,136896,2022,Serbia,Brazil,0,0,17,17,16/07/2022,0,0,3,3,15,5,10,30,0,1,6,7,4,0,8,12,7,6,3,16
3626,136896,2022,Brazil,Japan,0,1,18,19,13/07/2022,0,0,4,4,22,5,20,47,1,2,3,6,11,1,23,35,12,2,2,16
3627,136896,2022,Brazil,Thailand,0,1,21,22,02/07/2022,0,0,1,1,14,4,16,34,0,7,1,8,13,0,23,36,8,6,4,18
3628,136896,2022,Brazil,Bulgaria,0,1,8,9,01/07/2022,0,0,0,0,12,4,11,27,0,2,1,3,3,2,12,17,6,1,0,7
3629,136896,2022,Korea,Brazil,0,0,3,3,30/06/2022,2,0,0,2,0,1,1,2,0,4,3,7,3,0,4,7,3,1,2,6
3630,136896,2022,China,Brazil,1,0,21,22,28/06/2022,0,0,2,2,25,9,21,55,2,3,2,7,13,1,32,46,9,2,3,14
3631,136896,2022,Brazil,Serbia,0,1,23,24,19/06/2022,0,0,1,1,14,7,14,35,0,0,3,3,4,0,2,6,7,1,1,9
3632,136896,2022,Italy,Brazil,0,2,8,10,18/06/2022,0,0,1,1,8,6,10,24,0,2,2,4,10,1,10,21,4,0,1,5
3633,136896,2022,Netherlands,Brazil,0,1,11,12,17/06/2022,0,0,1,1,13,4,12,29,0,1,1,2,10,1,2,13,10,2,0,12
3634,136896,2022,Brazil,Türkiye,2,1,17,20,16/06/2022,0,0,1,1,16,11,9,36,2,1,4,7,8,0,7,15,7,1,0,8
3635,152128,2022,USA,Brazil,0,0,3,3,05/06/2022,0,0,0,0,1,1,0,2,0,0,0,0,2,2,3,7,0,0,1,1
3636,152128,2022,Dominican Republic,Brazil,0,0,7,7,03/06/2022,0,0,0,0,0,0,0,0,0,0,0,0,0,0,0,0,2,0,0,2
3637,152128,2022,Brazil,Poland,1,0,9,10,02/06/2022,0,0,2,2,1,0,0,1,0,0,0,0,0,0,0,0,1,0,0,1
3638,152128,2022,Germany,Brazil,0,0,4,4,31/05/2022,0,0,0,0,0,0,0,0,0,0,0,0,0,0,0,0,0,1,0,1
3639,173849,2022,Italy,Brazil,0,0,1,1,17/07/2022,0,0,1,1,6,1,4,11,0,1,1,2,0,0,0,0,1,0,0,1
3640,173849,2022,Serbia,Brazil,0,0,0,0,16/07/2022,0,0,0,0,0,0,0,0,0,0,0,0,0,0,0,0,0,0,0,0
3641,173849,2022,Brazil,Japan,0,0,0,0,13/07/2022,0,0,0,0,0,0,0,0,0,0,0,0,0,0,0,0,0,0,0,0
3642,173849,2022,Brazil,Serbia,0,0,0,0,19/06/2022,0,0,0,0,0,0,0,0,0,0,0,0,0,0,0,0,0,0,0,0
3643,173849,2022,Italy,Brazil,0,0,1,1,18/06/2022,0,1,1,2,2,2,0,4,0,0,0,0,0,0,0,0,0,0,1,1
3644,173849,2022,Netherlands,Brazil,0,0,2,2,17/06/2022,0,0,0,0,1,1,2,4,0,0,0,0,0,0,0,0,0,0,0,0
3645,173849,2022,Brazil,Türkiye,0,1,2,3,16/06/2022,0,0,0,0,1,2,9,12,0,0,2,2,0,0,0,0,0,0,0,0
3646,173849,2022,USA,Brazil,0,0,4,4,05/06/2022,0,0,0,0,7,3,4,14,0,0,1,1,0,0,0,0,1,0,0,1
3647,173849,2022,Dominican Republic,Brazil,1,0,6,7,03/06/2022,0,0,0,0,3,4,2,9,0,0,0,0,3,1,2,6,2,1,0,3
3648,173849,2022,Brazil,Poland,0,0,0,0,02/06/2022,0,0,0,0,0,0,0,0,0,0,0,0,0,0,0,0,0,0,0,0
3649,173849,2022,Germany,Brazil,0,1,0,1,31/05/2022,0,0,0,0,2,0,2,4,0,0,0,0,0,0,0,0,0,0,0,0
3650,144843,2022,,,-,-,-,-,-,-,-,-,-,-,-,-,-,-,-,-,-,-,-,-,-,-,-,-,-
3651,164674,2022,Italy,Brazil,0,0,0,0,17/07/2022,0,0,0,0,0,0,0,0,0,0,0,0,0,0,0,0,1,0,0,1
3652,164674,2022,Serbia,Brazil,0,0,0,0,16/07/2022,0,0,7,7,0,0,0,0,0,0,0,0,3,2,6,11,4,7,2,13
3653,164674,2022,Brazil,Japan,0,0,0,0,13/07/2022,0,0,8,8,0,0,0,0,0,0,0,0,4,1,12,17,17,7,3,27
3654,164674,2022,Brazil,Thailand,0,0,0,0,02/07/2022,0,0,4,4,0,0,0,0,0,0,0,0,7,3,9,19,13,3,1,17
3655,164674,2022,Brazil,Bulgaria,0,0,0,0,01/07/2022,0,0,3,3,0,0,0,0,0,0,0,0,1,0,6,7,8,1,0,9
3656,164674,2022,Korea,Brazil,0,0,0,0,30/06/2022,3,1,0,4,0,0,0,0,0,0,0,0,1,1,6,8,7,3,0,10
3657,164674,2022,China,Brazil,0,0,0,0,28/06/2022,2,0,11,13,0,0,0,0,0,0,0,0,4,0,12,16,17,2,2,21
3658,164674,2022,Brazil,Serbia,0,0,0,0,19/06/2022,0,0,0,0,0,0,0,0,0,0,0,0,0,0,0,0,0,0,0,0
3659,164674,2022,Italy,Brazil,0,0,0,0,18/06/2022,0,0,0,0,0,0,0,0,0,0,0,0,0,0,0,0,0,0,0,0
3660,164674,2022,Netherlands,Brazil,0,0,0,0,17/06/2022,0,0,0,0,0,0,0,0,0,0,0,0,0,0,0,0,0,0,0,0
3661,164674,2022,Brazil,Türkiye,0,0,0,0,16/06/2022,0,0,0,0,0,0,0,0,0,0,0,0,0,0,0,0,0,0,0,0
3662,164674,2022,USA,Brazil,0,0,0,0,05/06/2022,0,0,7,7,0,0,0,0,0,0,0,0,7,1,2,10,4,1,0,5
3663,164674,2022,Dominican Republic,Brazil,0,0,0,0,03/06/2022,0,0,0,0,0,0,0,0,0,0,0,0,0,0,0,0,0,0,0,0
3664,164674,2022,Brazil,Poland,0,0,0,0,02/06/2022,0,0,0,0,0,0,0,0,0,0,0,0,0,0,0,0,0,0,0,0
3665,164674,2022,Germany,Brazil,0,0,0,0,31/05/2022,0,0,0,0,0,0,0,0,0,0,0,0,0,0,0,0,0,0,0,0
3666,152130,2022,Italy,Brazil,0,0,2,2,17/07/2022,0,0,0,0,1,0,0,1,0,0,0,0,0,0,1,1,0,0,0,0
3667,152130,2022,Serbia,Brazil,0,0,0,0,16/07/2022,0,0,0,0,0,0,0,0,0,0,0,0,0,0,0,0,0,0,0,0
3668,152130,2022,Brazil,Japan,0,0,0,0,13/07/2022,0,0,0,0,0,0,0,0,0,0,0,0,0,0,0,0,0,0,0,0
3669,152130,2022,Brazil,Thailand,0,0,0,0,02/07/2022,0,0,0,0,0,0,0,0,0,0,0,0,0,0,0,0,0,0,0,0
3670,152130,2022,Brazil,Bulgaria,0,0,0,0,01/07/2022,0,0,0,0,0,0,0,0,0,0,0,0,0,0,0,0,0,0,0,0
3671,152130,2022,Korea,Brazil,0,1,2,3,30/06/2022,0,0,0,0,3,0,2,5,1,1,1,3,0,0,0,0,1,1,0,2
3672,152130,2022,China,Brazil,0,0,0,0,28/06/2022,0,0,0,0,0,0,0,0,0,0,0,0,0,0,0,0,0,0,0,0
3673,152130,2022,Brazil,Serbia,0,0,0,0,19/06/2022,0,0,0,0,0,0,0,0,0,0,0,0,0,0,0,0,0,0,0,0
3674,152130,2022,Italy,Brazil,0,0,4,4,18/06/2022,0,0,0,0,0,1,1,2,0,1,1,2,0,0,0,0,0,0,0,0
3675,152130,2022,Netherlands,Brazil,0,0,0,0,17/06/2022,0,0,0,0,0,1,0,1,0,0,0,0,0,0,0,0,0,0,0,0
3676,152130,2022,Brazil,Türkiye,0,0,0,0,16/06/2022,0,0,0,0,0,0,0,0,0,0,0,0,0,0,0,0,0,0,0,0
3677,152130,2022,USA,Brazil,1,0,4,5,05/06/2022,0,0,0,0,1,1,3,5,1,3,4,8,0,0,0,0,0,1,0,1
3678,152130,2022,Dominican Republic,Brazil,1,0,6,7,03/06/2022,0,0,0,0,4,0,5,9,2,4,3,9,0,0,0,0,1,0,0,1
3679,152130,2022,Brazil,Poland,0,0,0,0,02/06/2022,0,0,0,0,0,0,0,0,0,0,0,0,0,0,0,0,0,0,0,0
3680,152130,2022,Germany,Brazil,0,0,0,0,31/05/2022,0,0,0,0,0,0,0,0,0,0,0,0,0,0,0,0,0,0,0,0
3681,171260,2022,Italy,Brazil,1,0,7,8,17/07/2022,0,0,0,0,12,4,11,27,1,6,1,8,0,0,0,0,2,5,0,7
3682,171260,2022,Serbia,Brazil,1,0,11,12,16/07/2022,0,0,1,1,17,5,16,38,1,0,2,3,0,0,0,0,9,1,2,12
3683,171260,2022,Brazil,Japan,0,3,5,8,13/07/2022,0,0,1,1,16,4,16,36,4,3,1,8,0,0,1,1,4,4,2,10
3684,171260,2022,Brazil,Thailand,0,1,12,13,02/07/2022,0,0,0,0,9,4,14,27,2,5,1,8,0,0,0,0,9,1,0,10
3685,171260,2022,Brazil,Bulgaria,1,1,7,9,01/07/2022,1,0,1,2,5,3,9,17,2,2,4,8,0,0,0,0,3,2,1,6
3686,171260,2022,Korea,Brazil,0,0,0,0,30/06/2022,0,0,0,0,0,0,0,0,0,0,0,0,0,0,0,0,0,0,0,0
3687,171260,2022,China,Brazil,0,4,8,12,28/06/2022,0,0,4,4,22,5,24,51,3,4,4,11,0,0,0,0,8,3,6,17
3688,171260,2022,Brazil,Serbia,0,0,7,7,19/06/2022,0,0,1,1,9,4,11,24,5,2,6,13,1,0,1,2,10,0,1,11
3689,171260,2022,Italy,Brazil,0,2,5,7,18/06/2022,0,0,0,0,12,4,6,22,0,3,0,3,0,0,0,0,3,0,0,3
3690,171260,2022,Netherlands,Brazil,1,4,9,14,17/06/2022,0,0,0,0,8,2,9,19,4,1,0,5,0,0,0,0,5,0,0,5
3691,171260,2022,Brazil,Türkiye,0,0,6,6,16/06/2022,0,1,1,2,13,4,15,32,5,2,4,11,0,0,0,0,4,2,0,6
3692,171260,2022,USA,Brazil,0,0,3,3,05/06/2022,0,0,1,1,5,5,10,20,0,2,0,2,0,0,0,0,4,1,0,5
3693,171260,2022,Dominican Republic,Brazil,1,1,11,13,03/06/2022,0,0,4,4,18,5,12,35,1,1,2,4,0,0,0,0,9,2,0,11
3694,171260,2022,Brazil,Poland,0,0,0,0,02/06/2022,0,0,0,0,1,1,0,2,0,0,0,0,0,0,0,0,0,0,0,0
3695,171260,2022,Germany,Brazil,0,1,4,5,31/05/2022,0,0,2,2,9,1,13,23,1,0,0,1,0,0,0,0,4,0,0,4
3696,162999,2022,Italy,Brazil,0,1,7,8,17/07/2022,0,0,0,0,3,4,6,13,0,1,1,2,8,0,5,13,5,3,0,8
3697,162999,2022,Serbia,Brazil,1,1,13,15,16/07/2022,0,0,2,2,15,6,15,36,0,4,1,5,18,2,25,45,7,4,1,12
3698,162999,2022,Brazil,Japan,1,2,13,16,13/07/2022,0,0,0,0,14,4,12,30,2,1,1,4,5,3,22,30,12,3,1,16
3699,162999,2022,Brazil,Thailand,1,0,17,18,02/07/2022,0,0,0,0,15,6,19,40,1,1,1,3,4,1,20,25,11,2,2,15
3700,162999,2022,Brazil,Bulgaria,1,1,3,5,01/07/2022,0,0,0,0,3,1,1,5,0,0,0,0,0,0,3,3,1,0,0,1
3701,162999,2022,Korea,Brazil,0,0,7,7,30/06/2022,0,0,0,0,11,3,8,22,5,1,0,6,1,1,12,14,1,0,1,2
3702,162999,2022,China,Brazil,1,2,3,6,28/06/2022,0,0,1,1,2,1,1,4,0,0,1,1,1,1,11,13,3,0,3,6
3703,162999,2022,Brazil,Serbia,0,0,0,0,19/06/2022,0,0,0,0,0,0,0,0,0,0,0,0,0,0,0,0,0,0,0,0
3704,162999,2022,Italy,Brazil,0,3,6,9,18/06/2022,0,0,0,0,8,3,4,15,0,1,1,2,9,0,12,21,2,0,2,4
3705,162999,2022,Netherlands,Brazil,0,0,0,0,17/06/2022,0,0,0,0,0,0,0,0,0,0,0,0,0,0,0,0,0,0,0,0
3706,162999,2022,Brazil,Türkiye,0,2,4,6,16/06/2022,0,0,1,1,8,4,7,19,0,1,1,2,14,1,19,34,4,1,0,5
3707,162999,2022,USA,Brazil,0,0,5,5,05/06/2022,0,0,0,0,6,5,5,16,1,4,1,6,17,3,9,29,7,1,0,8
3708,162999,2022,Dominican Republic,Brazil,2,1,13,16,03/06/2022,0,0,1,1,10,4,15,29,1,3,0,4,18,0,5,23,14,4,0,18
3709,162999,2022,Brazil,Poland,0,0,8,8,02/06/2022,0,0,2,2,8,1,13,22,0,1,2,3,5,1,4,10,3,0,2,5
3710,162999,2022,Germany,Brazil,0,1,11,12,31/05/2022,0,0,0,0,18,8,22,48,1,4,2,7,37,2,21,60,10,3,0,13
3711,164673,2022,Brazil,Thailand,0,0,0,0,02/07/2022,0,0,0,0,0,0,0,0,0,0,0,0,0,0,0,0,0,0,0,0
3712,164673,2022,Brazil,Bulgaria,0,0,0,0,01/07/2022,0,0,0,0,0,0,0,0,0,0,0,0,0,0,0,0,0,0,0,0
3713,164673,2022,Korea,Brazil,0,0,1,1,30/06/2022,0,0,0,0,1,1,1,3,2,3,0,5,0,0,0,0,0,0,0,0
3714,164673,2022,China,Brazil,0,0,0,0,28/06/2022,0,0,0,0,0,0,0,0,0,0,0,0,0,0,0,0,0,0,0,0
3715,164673,2022,USA,Brazil,0,1,2,3,05/06/2022,0,0,2,2,1,0,3,4,0,3,3,6,0,0,0,0,0,0,0,0
3716,164673,2022,Dominican Republic,Brazil,0,0,0,0,03/06/2022,0,0,0,0,0,0,0,0,0,0,0,0,0,0,0,0,0,0,0,0
3717,164673,2022,Brazil,Poland,0,0,0,0,02/06/2022,0,0,0,0,0,0,0,0,0,0,0,0,0,0,0,0,0,0,0,0
3718,164673,2022,Germany,Brazil,0,0,0,0,31/05/2022,0,0,0,0,0,0,0,0,0,0,0,0,0,0,0,0,0,0,0,0
3719,163000,2022,,,-,-,-,-,-,-,-,-,-,-,-,-,-,-,-,-,-,-,-,-,-,-,-,-,-
3720,152125,2022,Brazil,Thailand,0,0,0,0,02/07/2022,0,0,0,0,0,0,0,0,0,0,0,0,0,0,0,0,0,0,0,0
3721,152125,2022,Brazil,Bulgaria,0,1,0,1,01/07/2022,0,0,0,0,0,0,1,1,0,0,0,0,0,0,0,0,0,0,0,0
3722,152125,2022,Korea,Brazil,0,2,14,16,30/06/2022,0,0,0,0,7,5,11,23,0,1,2,3,0,0,0,0,10,2,3,15
3723,152125,2022,China,Brazil,0,0,0,0,28/06/2022,0,0,0,0,0,0,2,2,0,0,0,0,0,0,0,0,0,0,0,0
3724,152131,2022,,,-,-,-,-,-,-,-,-,-,-,-,-,-,-,-,-,-,-,-,-,-,-,-,-,-
3725,138832,2022,,,-,-,-,-,-,-,-,-,-,-,-,-,-,-,-,-,-,-,-,-,-,-,-,-,-
3726,144865,2022,,,-,-,-,-,-,-,-,-,-,-,-,-,-,-,-,-,-,-,-,-,-,-,-,-,-
3727,141658,2022,Italy,Brazil,0,0,0,0,17/07/2022,0,0,0,0,1,1,3,5,0,1,1,2,0,0,0,0,0,0,0,0
3728,141658,2022,Serbia,Brazil,0,0,1,1,16/07/2022,0,0,0,0,1,3,2,6,0,1,0,1,0,0,0,0,1,1,0,2
3729,141658,2022,Brazil,Japan,0,0,1,1,13/07/2022,0,1,0,1,3,0,4,7,0,2,0,2,0,0,0,0,0,0,0,0
3730,141658,2022,USA,Brazil,0,0,1,1,05/06/2022,0,0,0,0,1,2,1,4,0,1,0,1,0,0,0,0,0,1,0,1
3731,141658,2022,Dominican Republic,Brazil,0,0,1,1,03/06/2022,0,0,0,0,0,0,3,3,0,0,0,0,0,0,0,0,0,0,1,1
3732,141658,2022,Brazil,Poland,0,1,7,8,02/06/2022,0,0,0,0,6,1,17,24,3,0,1,4,0,0,0,0,5,3,0,8
3733,141658,2022,Germany,Brazil,1,0,10,11,31/05/2022,0,0,1,1,7,4,15,26,0,1,0,1,0,0,0,0,2,3,0,5
3734,141661,2022,,,-,-,-,-,-,-,-,-,-,-,-,-,-,-,-,-,-,-,-,-,-,-,-,-,-
3735,142341,2022,Bulgaria,Türkiye,0,0,10,10,04/06/2022,0,0,1,1,8,7,13,28,0,2,1,3,3,0,15,18,5,0,0,5
3736,142341,2022,Serbia,Bulgaria,1,0,10,11,03/06/2022,0,0,1,1,7,8,12,27,1,2,1,4,2,1,13,16,6,3,0,9
3737,142341,2022,Bulgaria,Netherlands,1,1,16,18,02/06/2022,0,0,2,2,17,1,27,45,2,1,3,6,9,2,28,39,19,5,1,25
3738,142341,2022,Thailand,Bulgaria,0,0,6,6,31/05/2022,0,0,2,2,12,1,8,21,1,1,3,5,5,0,18,23,7,4,2,13
3739,124202,2022,Poland,Bulgaria,1,1,16,18,03/07/2022,0,0,4,4,10,1,7,18,4,4,1,9,0,0,0,0,1,1,0,2
3740,124202,2022,Italy,Bulgaria,3,0,13,16,02/07/2022,0,0,1,1,5,1,5,11,0,6,0,6,0,0,0,0,2,2,1,5
3741,124202,2022,Brazil,Bulgaria,1,0,10,11,01/07/2022,0,1,0,1,7,0,3,10,1,5,0,6,0,0,1,1,3,1,2,6
3742,124202,2022,Dominican Republic,Bulgaria,0,2,9,11,28/06/2022,2,0,0,2,6,0,2,8,4,3,0,7,0,0,0,0,1,0,1,2
3743,124202,2022,Bulgaria,Belgium,0,1,14,15,19/06/2022,0,0,7,7,5,2,13,20,9,6,6,21,0,0,0,0,8,1,1,10
3744,124202,2022,Bulgaria,Canada,0,1,11,12,18/06/2022,0,0,1,1,8,0,2,10,3,4,13,20,0,1,0,1,3,0,0,3
3745,124202,2022,Bulgaria,Japan,0,0,1,1,16/06/2022,1,0,1,2,1,1,2,4,1,2,0,3,0,0,1,1,1,0,0,1
3746,124202,2022,Bulgaria,USA,1,1,7,9,15/06/2022,0,0,0,0,3,0,7,10,1,3,0,4,0,2,0,2,1,0,0,1
3747,124202,2022,Bulgaria,Türkiye,0,0,1,1,04/06/2022,0,0,1,1,2,2,0,4,2,1,2,5,0,0,0,0,1,0,0,1
3748,124202,2022,Serbia,Bulgaria,1,0,6,7,03/06/2022,0,0,0,0,6,2,6,14,0,5,3,8,1,1,2,4,2,1,3,6
3749,124202,2022,Bulgaria,Netherlands,0,1,10,11,02/06/2022,0,0,2,2,10,4,5,19,4,6,12,22,0,0,1,1,4,1,1,6
3750,124202,2022,Thailand,Bulgaria,0,1,10,11,31/05/2022,0,0,1,1,9,2,4,15,1,5,3,9,0,0,0,0,1,3,0,4
3751,153422,2022,Poland,Bulgaria,0,0,0,0,03/07/2022,0,0,0,0,0,0,0,0,0,0,0,0,0,0,0,0,0,0,0,0
3752,153422,2022,Italy,Bulgaria,0,0,0,0,02/07/2022,0,0,0,0,0,0,0,0,0,0,0,0,0,0,0,0,0,0,0,0
3753,153422,2022,Brazil,Bulgaria,0,0,0,0,01/07/2022,0,0,0,0,0,0,0,0,0,0,0,0,0,0,0,0,0,0,0,0
3754,153422,2022,Dominican Republic,Bulgaria,0,0,0,0,28/06/2022,0,0,0,0,0,0,0,0,0,0,0,0,0,0,1,1,0,0,0,0
3755,122460,2022,,,-,-,-,-,-,-,-,-,-,-,-,-,-,-,-,-,-,-,-,-,-,-,-,-,-
3756,174474,2022,Poland,Bulgaria,0,1,10,11,03/07/2022,0,0,2,2,20,8,14,42,2,1,1,4,3,1,24,28,8,2,0,10
3757,174474,2022,Italy,Bulgaria,0,0,6,6,02/07/2022,0,1,0,1,9,6,7,22,0,3,1,4,2,2,24,28,1,2,1,4
3758,174474,2022,Brazil,Bulgaria,0,1,4,5,01/07/2022,0,0,0,0,5,6,5,16,1,2,0,3,4,1,19,24,3,1,1,5
3759,174474,2022,Dominican Republic,Bulgaria,1,1,9,11,28/06/2022,0,0,0,0,19,5,17,41,2,0,0,2,2,0,12,14,5,1,1,7
3760,174474,2022,Bulgaria,Belgium,0,3,15,18,19/06/2022,0,1,5,6,17,7,18,42,2,5,4,11,5,5,43,53,14,3,2,19
3761,174474,2022,Bulgaria,Canada,1,0,9,10,18/06/2022,1,0,4,5,13,4,8,25,1,1,0,2,3,2,13,18,9,1,0,10
3762,174474,2022,Bulgaria,Japan,0,2,7,9,16/06/2022,0,0,0,0,10,5,11,26,0,1,5,6,9,3,16,28,9,1,1,11
3763,174474,2022,Bulgaria,USA,1,4,2,7,15/06/2022,0,0,1,1,6,3,7,16,1,0,2,3,7,3,20,30,5,2,0,7
3764,142347,2022,Poland,Bulgaria,1,2,19,22,03/07/2022,0,0,2,2,7,3,12,22,0,3,0,3,1,0,20,21,11,0,0,11
3765,142347,2022,Italy,Bulgaria,0,2,7,9,02/07/2022,0,0,0,0,7,2,11,20,0,3,1,4,1,1,20,22,9,1,3,13
3766,142347,2022,Brazil,Bulgaria,1,0,8,9,01/07/2022,0,0,0,0,6,2,9,17,0,0,0,0,5,0,12,17,3,2,0,5
3767,142347,2022,Dominican Republic,Bulgaria,0,0,12,12,28/06/2022,0,0,0,0,10,4,11,25,0,0,1,1,4,0,16,20,4,0,0,4
3768,142347,2022,Bulgaria,Belgium,0,1,19,20,19/06/2022,0,0,5,5,13,11,27,51,0,3,3,6,2,2,17,21,12,3,1,16
3769,142347,2022,Bulgaria,Canada,1,2,11,14,18/06/2022,0,0,0,0,12,2,10,24,1,3,3,7,8,2,16,26,8,2,1,11
3770,142347,2022,Bulgaria,Japan,0,0,14,14,16/06/2022,0,0,4,4,4,4,14,22,0,2,2,4,2,1,15,18,9,4,0,13
3771,142347,2022,Bulgaria,USA,1,1,9,11,15/06/2022,0,0,3,3,11,5,14,30,2,4,0,6,1,1,6,8,6,2,0,8
3772,142347,2022,Bulgaria,Türkiye,0,0,9,9,04/06/2022,1,0,0,1,7,2,11,20,0,2,2,4,4,1,15,20,4,1,1,6
3773,142347,2022,Serbia,Bulgaria,0,3,5,8,03/06/2022,0,0,1,1,8,1,10,19,0,3,5,8,4,1,29,34,6,3,4,13
3774,142347,2022,Bulgaria,Netherlands,1,3,10,14,02/06/2022,1,0,5,6,16,3,21,40,2,6,3,11,4,0,19,23,10,6,2,18
3775,142347,2022,Thailand,Bulgaria,0,2,11,13,31/05/2022,0,0,2,2,3,5,11,19,1,6,4,11,1,1,11,13,5,4,1,10
3776,138283,2022,Poland,Bulgaria,0,2,14,16,03/07/2022,10,0,95,105,4,0,2,6,0,2,1,3,0,0,0,0,10,1,3,14
3777,138283,2022,Italy,Bulgaria,0,2,1,3,02/07/2022,3,1,34,38,0,0,1,1,0,0,0,0,0,0,0,0,1,1,0,2
3778,138283,2022,Brazil,Bulgaria,1,1,10,12,01/07/2022,11,1,67,79,0,0,2,2,0,4,1,5,0,0,0,0,3,1,0,4
3779,138283,2022,Dominican Republic,Bulgaria,0,1,11,12,28/06/2022,51,2,3,56,0,0,0,0,0,0,1,1,0,0,0,0,4,2,0,6
3780,138283,2022,Bulgaria,Belgium,0,4,20,24,19/06/2022,36,0,87,123,5,0,1,6,2,5,4,11,0,0,0,0,19,3,2,24
3781,138283,2022,Bulgaria,Canada,0,1,16,17,18/06/2022,8,0,70,78,3,0,2,5,0,5,1,6,0,0,0,0,8,1,1,10
3782,138283,2022,Bulgaria,Japan,0,0,7,7,16/06/2022,18,0,48,66,1,0,0,1,0,5,1,6,0,0,0,0,3,0,0,3
3783,138283,2022,Bulgaria,USA,2,0,8,10,15/06/2022,5,1,68,74,3,0,1,4,0,0,0,0,0,0,1,1,2,2,0,4
3784,138283,2022,Bulgaria,Türkiye,1,1,14,16,04/06/2022,33,3,37,73,1,0,1,2,1,1,1,3,0,0,1,1,7,3,5,15
3785,138283,2022,Serbia,Bulgaria,1,1,10,12,03/06/2022,12,0,68,80,1,0,4,5,0,6,3,9,0,0,0,0,2,1,1,4
3786,138283,2022,Bulgaria,Netherlands,0,2,8,10,02/06/2022,27,0,88,115,0,0,1,1,1,3,2,6,0,0,0,0,3,4,6,13
3787,138283,2022,Thailand,Bulgaria,0,1,8,9,31/05/2022,24,0,50,74,1,0,2,3,0,3,1,4,0,0,0,0,1,2,2,5
3788,142348,2022,Poland,Bulgaria,0,0,0,0,03/07/2022,0,0,0,0,0,0,0,0,0,0,0,0,0,0,0,0,0,0,0,0
3789,142348,2022,Italy,Bulgaria,0,1,3,4,02/07/2022,4,0,42,46,0,0,2,2,0,1,3,4,0,0,0,0,1,3,1,5
3790,142348,2022,Brazil,Bulgaria,0,0,1,1,01/07/2022,1,1,14,16,0,0,0,0,0,0,0,0,0,0,0,0,0,0,0,0
3791,142348,2022,Dominican Republic,Bulgaria,0,0,0,0,28/06/2022,0,0,0,0,0,0,0,0,0,0,0,0,0,0,0,0,0,0,0,0
3792,142348,2022,Bulgaria,Belgium,0,0,0,0,19/06/2022,0,0,2,2,0,0,0,0,0,0,0,0,0,0,0,0,0,0,0,0
3793,142348,2022,Bulgaria,Canada,0,0,0,0,18/06/2022,0,0,0,0,0,0,0,0,0,0,0,0,0,0,0,0,0,0,0,0
3794,142348,2022,Bulgaria,Japan,0,0,3,3,16/06/2022,8,0,16,24,1,0,0,1,0,0,1,1,0,0,0,0,3,0,0,3
3795,142348,2022,Bulgaria,USA,0,0,1,1,15/06/2022,1,0,3,4,0,0,0,0,0,0,0,0,0,0,0,0,0,0,0,0
3796,142348,2022,Bulgaria,Türkiye,0,0,0,0,04/06/2022,0,0,0,0,0,0,0,0,0,0,0,0,0,0,0,0,0,0,0,0
3797,142348,2022,Serbia,Bulgaria,0,0,2,2,03/06/2022,5,0,11,16,0,0,0,0,0,0,0,0,0,0,0,0,1,0,1,2
3798,142348,2022,Bulgaria,Netherlands,0,0,2,2,02/06/2022,4,1,16,21,0,0,1,1,0,0,1,1,0,0,0,0,1,0,0,1
3799,142348,2022,Thailand,Bulgaria,0,1,1,2,31/05/2022,2,0,2,4,0,0,0,0,0,1,0,1,0,0,0,0,0,0,0,0
3800,163261,2022,Poland,Bulgaria,0,0,0,0,03/07/2022,0,0,0,0,0,0,0,0,0,0,0,0,0,0,0,0,0,0,0,0
3801,163261,2022,Italy,Bulgaria,1,0,4,5,02/07/2022,0,0,0,0,1,0,0,1,0,2,0,2,0,0,0,0,0,0,0,0
3802,163261,2022,Brazil,Bulgaria,0,1,1,2,01/07/2022,0,0,0,0,0,0,0,0,0,0,0,0,0,0,0,0,0,0,0,0
3803,163261,2022,Dominican Republic,Bulgaria,0,0,0,0,28/06/2022,0,0,0,0,0,0,0,0,0,0,0,0,0,0,0,0,0,0,0,0
3804,163261,2022,Bulgaria,Belgium,0,1,0,1,19/06/2022,0,0,0,0,0,0,0,0,0,0,0,0,0,0,0,0,0,0,0,0
3805,163261,2022,Bulgaria,Canada,0,0,0,0,18/06/2022,0,0,0,0,0,0,0,0,0,0,0,0,0,0,0,0,0,0,0,0
3806,163261,2022,Bulgaria,Japan,0,2,6,8,16/06/2022,1,0,1,2,0,0,4,4,0,1,6,7,0,0,2,2,1,0,0,1
3807,163261,2022,Bulgaria,USA,0,0,2,2,15/06/2022,0,0,0,0,0,0,0,0,0,0,0,0,0,0,0,0,0,0,0,0
3808,163261,2022,Bulgaria,Türkiye,0,0,2,2,04/06/2022,0,0,0,0,0,0,0,0,1,0,0,1,0,0,0,0,0,0,0,0
3809,163261,2022,Serbia,Bulgaria,0,0,2,2,03/06/2022,0,0,0,0,0,0,0,0,0,0,1,1,0,0,0,0,0,0,0,0
3810,163261,2022,Bulgaria,Netherlands,0,1,0,1,02/06/2022,0,0,0,0,0,0,0,0,0,0,0,0,0,0,0,0,0,0,0,0
3811,163261,2022,Thailand,Bulgaria,0,2,2,4,31/05/2022,0,0,0,0,0,0,0,0,0,0,0,0,0,0,0,0,0,1,0,1
3812,142337,2022,Poland,Bulgaria,0,3,7,10,03/07/2022,0,0,0,0,8,1,3,12,1,7,3,11,0,0,0,0,3,1,0,4
3813,142337,2022,Italy,Bulgaria,0,0,3,3,02/07/2022,0,0,0,0,2,0,3,5,0,5,0,5,0,0,0,0,0,0,0,0
3814,142337,2022,Brazil,Bulgaria,0,2,6,8,01/07/2022,0,0,0,0,5,1,4,10,1,1,2,4,0,0,1,1,4,1,0,5
3815,142337,2022,Dominican Republic,Bulgaria,1,1,5,7,28/06/2022,0,0,0,0,4,0,6,10,3,3,1,7,0,0,1,1,3,0,0,3
3816,142337,2022,Bulgaria,Belgium,0,0,15,15,19/06/2022,0,0,1,1,9,1,4,14,2,0,2,4,0,0,0,0,12,0,0,12
3817,142337,2022,Bulgaria,Canada,0,1,10,11,18/06/2022,1,0,2,3,4,0,2,6,1,6,5,12,0,0,0,0,3,0,0,3
3818,142337,2022,Bulgaria,Japan,0,1,8,9,16/06/2022,0,0,0,0,5,0,4,9,1,4,3,8,0,0,2,2,3,0,0,3
3819,142337,2022,Bulgaria,USA,0,1,7,8,15/06/2022,0,0,0,0,1,1,2,4,1,6,1,8,0,0,0,0,1,0,0,1
3820,142337,2022,Bulgaria,Türkiye,0,2,2,4,04/06/2022,0,0,0,0,3,1,1,5,0,3,1,4,0,0,0,0,0,0,0,0
3821,142337,2022,Serbia,Bulgaria,0,0,0,0,03/06/2022,0,0,0,0,0,0,0,0,0,0,0,0,0,0,0,0,0,0,0,0
3822,142337,2022,Bulgaria,Netherlands,0,1,0,1,02/06/2022,0,0,0,0,2,0,2,4,1,0,1,2,0,0,0,0,0,0,0,0
3823,142337,2022,Thailand,Bulgaria,0,1,3,4,31/05/2022,0,0,1,1,4,1,0,5,0,1,4,5,0,0,0,0,1,0,0,1
3824,124201,2022,Bulgaria,Türkiye,0,1,6,7,04/06/2022,0,0,0,0,5,1,3,9,3,3,5,11,0,0,0,0,1,0,1,2
3825,124201,2022,Serbia,Bulgaria,0,0,9,9,03/06/2022,0,0,2,2,5,0,3,8,2,5,3,10,0,0,0,0,0,1,2,3
3826,124201,2022,Bulgaria,Netherlands,2,0,17,19,02/06/2022,0,0,1,1,8,3,7,18,1,6,5,12,0,0,0,0,2,1,2,5
3827,124201,2022,Thailand,Bulgaria,0,0,3,3,31/05/2022,0,0,0,0,3,0,2,5,0,1,1,2,0,0,0,0,0,0,0,0
3828,172904,2022,,,-,-,-,-,-,-,-,-,-,-,-,-,-,-,-,-,-,-,-,-,-,-,-,-,-
3829,174467,2022,,,-,-,-,-,-,-,-,-,-,-,-,-,-,-,-,-,-,-,-,-,-,-,-,-,-
3830,142351,2022,Poland,Bulgaria,0,0,0,0,03/07/2022,0,0,6,6,0,0,0,0,0,0,0,0,4,1,13,18,7,4,3,14
3831,142351,2022,Italy,Bulgaria,0,0,0,0,02/07/2022,0,0,6,6,0,0,0,0,0,0,0,0,2,0,7,9,4,1,1,6
3832,142351,2022,Brazil,Bulgaria,0,0,0,0,01/07/2022,0,0,1,1,0,0,0,0,0,0,0,0,1,2,7,10,7,2,3,12
3833,142351,2022,Dominican Republic,Bulgaria,0,0,0,0,28/06/2022,5,0,0,5,0,0,0,0,0,0,0,0,2,0,7,9,3,3,1,7
3834,142351,2022,Bulgaria,Belgium,0,0,0,0,19/06/2022,1,0,26,27,0,0,0,0,0,0,0,0,8,1,9,18,29,1,1,31
3835,142351,2022,Bulgaria,Canada,0,0,0,0,18/06/2022,0,0,11,11,0,0,0,0,0,0,0,0,6,2,9,17,15,3,1,19
3836,142351,2022,Bulgaria,Japan,0,0,0,0,16/06/2022,0,1,4,5,0,0,0,0,0,0,0,0,4,0,6,10,11,3,0,14
3837,142351,2022,Bulgaria,USA,0,0,0,0,15/06/2022,0,0,10,10,0,0,0,0,0,0,0,0,3,0,8,11,8,4,2,14
3838,142351,2022,Bulgaria,Türkiye,0,0,0,0,04/06/2022,1,0,8,9,0,0,0,0,0,0,0,0,4,2,5,11,6,1,1,8
3839,142351,2022,Serbia,Bulgaria,0,0,0,0,03/06/2022,0,3,7,10,0,0,0,0,0,0,0,0,3,1,7,11,10,4,7,21
3840,142351,2022,Bulgaria,Netherlands,0,0,0,0,02/06/2022,0,0,7,7,0,0,0,0,0,0,0,0,8,0,6,14,14,3,12,29
3841,142351,2022,Thailand,Bulgaria,0,0,0,0,31/05/2022,0,0,1,1,0,0,0,0,0,0,0,0,5,1,12,18,7,4,9,20
3842,122541,2022,,,-,-,-,-,-,-,-,-,-,-,-,-,-,-,-,-,-,-,-,-,-,-,-,-,-
3843,163141,2022,Poland,Bulgaria,0,0,0,0,03/07/2022,0,0,0,0,0,0,0,0,0,0,0,0,0,0,0,0,0,0,0,0
3844,163141,2022,Italy,Bulgaria,0,0,5,5,02/07/2022,0,0,0,0,2,0,14,16,1,1,0,2,0,0,0,0,1,0,4,5
3845,163141,2022,Brazil,Bulgaria,0,0,2,2,01/07/2022,0,0,0,0,4,3,6,13,0,1,0,1,0,0,0,0,0,0,0,0
3846,163141,2022,Dominican Republic,Bulgaria,3,1,16,20,28/06/2022,1,0,0,1,4,3,4,11,0,0,0,0,0,0,0,0,1,0,0,1
3847,163141,2022,Bulgaria,Belgium,0,0,0,0,19/06/2022,0,0,0,0,0,0,0,0,0,0,0,0,0,0,0,0,0,0,0,0
3848,163141,2022,Bulgaria,Canada,0,0,0,0,18/06/2022,0,0,0,0,0,0,0,0,0,0,0,0,0,0,0,0,0,0,0,0
3849,163141,2022,Bulgaria,Japan,0,0,2,2,16/06/2022,0,0,0,0,2,0,3,5,0,0,1,1,0,0,0,0,1,1,0,2
3850,163141,2022,Bulgaria,USA,0,0,0,0,15/06/2022,0,0,0,0,0,0,0,0,0,0,0,0,0,0,0,0,0,0,0,0
3851,163141,2022,Bulgaria,Türkiye,0,1,0,1,04/06/2022,0,0,0,0,1,0,1,2,0,0,0,0,0,0,0,0,0,2,0,2
3852,163141,2022,Serbia,Bulgaria,0,1,1,2,03/06/2022,0,0,0,0,2,0,7,9,0,1,1,2,0,0,0,0,0,0,0,0
3853,163141,2022,Bulgaria,Netherlands,0,0,0,0,02/06/2022,0,0,0,0,0,0,0,0,0,0,0,0,0,0,0,0,0,0,0,0
3854,163141,2022,Thailand,Bulgaria,0,0,0,0,31/05/2022,0,0,0,0,0,0,0,0,0,0,0,0,0,0,0,0,0,0,0,0
3855,142333,2022,Poland,Bulgaria,0,1,18,19,03/07/2022,0,0,4,4,10,3,17,30,1,4,3,8,0,0,1,1,5,1,0,6
3856,142333,2022,Italy,Bulgaria,0,1,1,2,02/07/2022,0,0,1,1,7,1,7,15,0,0,0,0,0,0,0,0,0,1,0,1
3857,142333,2022,Brazil,Bulgaria,0,1,3,4,01/07/2022,0,0,0,0,2,5,7,14,2,2,0,4,0,0,0,0,3,0,0,3
3858,142333,2022,Dominican Republic,Bulgaria,0,0,0,0,28/06/2022,0,0,0,0,0,0,0,0,0,0,0,0,0,0,0,0,0,0,0,0
3859,142333,2022,Bulgaria,Belgium,1,2,14,17,19/06/2022,0,0,2,2,12,7,29,48,1,4,10,15,0,0,0,0,11,2,0,13
3860,142333,2022,Bulgaria,Canada,1,1,9,11,18/06/2022,0,0,1,1,10,3,19,32,1,3,3,7,0,0,1,1,3,1,0,4
3861,142333,2022,Bulgaria,Japan,0,0,7,7,16/06/2022,0,0,5,5,13,4,10,27,0,4,3,7,0,0,0,0,2,2,1,5
3862,142333,2022,Bulgaria,USA,1,0,12,13,15/06/2022,0,0,1,1,8,3,11,22,0,2,1,3,0,0,0,0,6,2,2,10
3863,142333,2022,Bulgaria,Türkiye,0,0,4,4,04/06/2022,0,0,0,0,2,5,7,14,0,0,4,4,0,0,0,0,4,0,0,4
3864,142333,2022,Serbia,Bulgaria,0,0,10,10,03/06/2022,0,0,0,0,8,4,15,27,1,3,1,5,1,0,0,1,7,2,0,9
3865,142333,2022,Bulgaria,Netherlands,2,0,15,17,02/06/2022,0,0,4,4,10,5,12,27,0,4,2,6,0,0,0,0,8,2,2,12
3866,142333,2022,Thailand,Bulgaria,0,0,7,7,31/05/2022,0,0,1,1,8,3,6,17,0,0,1,1,0,0,0,0,4,1,0,5
3867,163142,2022,Poland,Bulgaria,0,0,0,0,03/07/2022,0,0,0,0,0,0,0,0,0,0,0,0,0,0,0,0,0,0,0,0
3868,163142,2022,Italy,Bulgaria,0,0,0,0,02/07/2022,0,0,1,1,1,0,2,3,0,1,0,1,1,0,2,3,0,0,0,0
3869,163142,2022,Brazil,Bulgaria,1,1,5,7,01/07/2022,0,0,0,0,2,4,4,10,0,1,0,1,3,0,7,10,4,1,1,6
3870,163142,2022,Dominican Republic,Bulgaria,0,0,0,0,28/06/2022,0,0,0,0,0,0,0,0,0,0,0,0,0,0,0,0,0,0,0,0
3871,163142,2022,Bulgaria,Belgium,0,0,0,0,19/06/2022,0,0,0,0,0,0,0,0,0,0,0,0,0,0,0,0,0,0,0,0
3872,163142,2022,Bulgaria,Canada,0,0,0,0,18/06/2022,0,0,0,0,0,0,0,0,0,0,0,0,0,0,0,0,0,0,0,0
3873,163142,2022,Bulgaria,Japan,0,0,1,1,16/06/2022,0,0,0,0,3,1,2,6,0,0,0,0,0,0,0,0,0,1,0,1
3874,163142,2022,Bulgaria,USA,0,1,1,2,15/06/2022,0,0,0,0,5,1,1,7,0,0,1,1,1,1,12,14,1,1,0,2
3875,163142,2022,Bulgaria,Türkiye,0,1,2,3,04/06/2022,0,0,0,0,2,0,6,8,1,0,0,1,1,0,13,14,3,0,0,3
3876,163142,2022,Serbia,Bulgaria,0,0,1,1,03/06/2022,0,0,0,0,2,0,0,2,0,1,1,2,0,0,2,2,0,1,0,1
3877,163142,2022,Bulgaria,Netherlands,0,1,1,2,02/06/2022,0,0,0,0,1,2,2,5,0,0,0,0,2,0,2,4,2,1,1,4
3878,163142,2022,Thailand,Bulgaria,1,3,1,5,31/05/2022,0,0,0,0,4,0,0,4,0,0,0,0,2,3,6,11,1,0,1,2
3879,151857,2022,,,-,-,-,-,-,-,-,-,-,-,-,-,-,-,-,-,-,-,-,-,-,-,-,-,-
3880,163144,2022,,,-,-,-,-,-,-,-,-,-,-,-,-,-,-,-,-,-,-,-,-,-,-,-,-,-
3881,164804,2022,,,-,-,-,-,-,-,-,-,-,-,-,-,-,-,-,-,-,-,-,-,-,-,-,-,-
3882,153425,2022,Bulgaria,Belgium,0,0,0,0,19/06/2022,0,0,0,0,0,0,0,0,0,0,0,0,0,0,0,0,0,0,0,0
3883,153425,2022,Bulgaria,Canada,0,0,0,0,18/06/2022,0,0,0,0,0,0,0,0,0,0,0,0,0,0,0,0,0,0,0,0
3884,153425,2022,Bulgaria,Japan,0,0,0,0,16/06/2022,0,0,0,0,0,0,0,0,0,0,0,0,0,0,0,0,0,0,0,0
3885,153425,2022,Bulgaria,USA,0,0,0,0,15/06/2022,0,0,0,0,0,0,0,0,0,0,0,0,0,0,0,0,0,0,0,0
3886,153425,2022,Bulgaria,Türkiye,0,0,0,0,04/06/2022,4,0,5,9,0,0,0,0,0,0,0,0,0,0,0,0,1,1,0,2
3887,153425,2022,Serbia,Bulgaria,0,0,0,0,03/06/2022,0,0,0,0,0,0,0,0,0,0,0,0,0,0,0,0,0,0,0,0
3888,153425,2022,Bulgaria,Netherlands,0,0,0,0,02/06/2022,0,0,0,0,0,0,0,0,0,0,0,0,0,0,0,0,0,0,0,0
3889,153425,2022,Thailand,Bulgaria,0,0,0,0,31/05/2022,0,0,0,0,0,0,0,0,0,0,0,0,0,0,0,0,0,0,0,0
3890,183413,2022,,,-,-,-,-,-,-,-,-,-,-,-,-,-,-,-,-,-,-,-,-,-,-,-,-,-
3891,164660,2022,Poland,Bulgaria,0,0,0,0,03/07/2022,0,0,0,0,0,0,0,0,0,0,0,0,0,0,0,0,0,0,0,0
3892,164660,2022,Italy,Bulgaria,0,0,0,0,02/07/2022,0,0,0,0,0,0,0,0,0,0,0,0,0,0,0,0,0,0,0,0
3893,164660,2022,Brazil,Bulgaria,0,0,0,0,01/07/2022,0,0,0,0,0,0,0,0,0,0,0,0,0,0,0,0,0,0,0,0
3894,164660,2022,Dominican Republic,Bulgaria,0,0,0,0,28/06/2022,0,0,0,0,0,0,0,0,0,0,0,0,0,0,0,0,0,0,0,0
3895,164660,2022,Bulgaria,Belgium,0,0,0,0,19/06/2022,0,0,0,0,0,0,0,0,0,0,0,0,0,0,0,0,0,0,0,0
3896,164660,2022,Bulgaria,Canada,0,0,0,0,18/06/2022,0,0,0,0,0,0,0,0,0,0,0,0,0,0,0,0,0,0,0,0
3897,164660,2022,Bulgaria,Japan,0,0,0,0,16/06/2022,0,0,0,0,0,0,0,0,0,0,0,0,0,0,0,0,0,0,0,0
3898,164660,2022,Bulgaria,USA,0,0,0,0,15/06/2022,0,0,0,0,0,0,0,0,0,0,0,0,0,0,0,0,0,0,0,0
3899,140907,2022,Poland,Bulgaria,0,0,0,0,03/07/2022,0,0,0,0,0,0,0,0,0,0,0,0,0,0,0,0,0,0,0,0
3900,140907,2022,Italy,Bulgaria,0,0,0,0,02/07/2022,0,0,0,0,1,1,0,2,0,0,0,0,0,1,3,4,0,0,0,0
3901,140907,2022,Brazil,Bulgaria,0,0,0,0,01/07/2022,0,0,0,0,0,0,0,0,0,0,0,0,0,0,0,0,0,0,0,0
3902,140907,2022,Dominican Republic,Bulgaria,0,0,0,0,28/06/2022,0,0,0,0,0,0,0,0,0,0,0,0,0,0,0,0,0,0,0,0
3903,140907,2022,Bulgaria,Belgium,0,0,0,0,19/06/2022,0,0,0,0,0,0,0,0,0,0,0,0,0,0,0,0,0,0,0,0
3904,140907,2022,Bulgaria,Canada,0,0,0,0,18/06/2022,0,0,0,0,0,0,0,0,0,0,0,0,0,0,0,0,0,0,0,0
3905,140907,2022,Bulgaria,Japan,0,0,0,0,16/06/2022,0,0,0,0,1,2,2,5,0,0,2,2,0,0,4,4,0,0,0,0
3906,140907,2022,Bulgaria,USA,0,0,1,1,15/06/2022,0,0,0,0,0,1,0,1,0,0,0,0,0,0,0,0,0,0,0,0
3907,140907,2022,Bulgaria,Türkiye,0,0,0,0,04/06/2022,0,0,0,0,0,2,0,2,0,0,0,0,1,0,2,3,1,0,1,2
3908,140907,2022,Serbia,Bulgaria,0,0,0,0,03/06/2022,0,0,0,0,0,0,1,1,0,0,0,0,1,0,1,2,0,0,0,0
3909,140907,2022,Bulgaria,Netherlands,0,0,1,1,02/06/2022,0,0,3,3,1,1,1,3,0,2,2,4,0,0,0,0,1,0,0,1
3910,140907,2022,Thailand,Bulgaria,0,0,0,0,31/05/2022,0,0,0,0,0,0,0,0,0,0,0,0,0,0,0,0,0,0,0,0
3911,175276,2022,Korea,Canada,0,0,0,0,05/06/2022,0,0,0,0,0,0,0,0,0,0,0,0,0,0,0,0,0,0,0,0
3912,175276,2022,USA,Canada,0,0,0,0,04/06/2022,0,0,0,0,0,0,0,0,0,0,0,0,0,0,0,0,0,0,0,0
3913,175276,2022,Canada,Dominican Republic,0,0,0,0,03/06/2022,0,0,0,0,0,0,0,0,0,0,0,0,0,0,0,0,0,0,0,0
3914,175276,2022,Poland,Canada,0,0,0,0,01/06/2022,0,0,0,0,0,0,0,0,0,0,0,0,0,0,0,0,0,0,0,0
3915,182883,2022,,,-,-,-,-,-,-,-,-,-,-,-,-,-,-,-,-,-,-,-,-,-,-,-,-,-
3916,168355,2022,Netherlands,Canada,3,5,13,21,03/07/2022,0,0,7,7,18,12,18,48,1,3,2,6,0,0,0,0,21,2,0,23
3917,168355,2022,Germany,Canada,3,8,3,14,03/07/2022,0,0,7,7,18,8,11,37,1,2,3,6,0,0,0,0,9,2,0,11
3918,168355,2022,Serbia,Canada,0,1,8,9,02/07/2022,0,0,2,2,16,11,20,47,2,2,2,6,0,0,0,0,3,0,0,3
3919,168355,2022,Canada,Türkiye,2,5,6,13,29/06/2022,0,0,2,2,19,8,14,41,0,4,0,4,0,0,0,0,3,1,0,4
3920,168355,2022,Bulgaria,Canada,3,2,8,13,18/06/2022,0,0,2,2,17,6,13,36,0,4,4,8,0,0,0,0,8,2,1,11
3921,168355,2022,China,Canada,1,4,5,10,17/06/2022,1,0,5,6,13,8,14,35,0,0,2,2,0,0,2,2,6,1,1,8
3922,168355,2022,Canada,Belgium,2,4,8,14,16/06/2022,0,1,16,17,20,9,12,41,0,6,8,14,0,0,0,0,11,4,1,16
3923,168355,2022,Canada,Thailand,2,3,7,12,14/06/2022,1,0,1,2,17,7,13,37,1,1,3,5,0,0,0,0,5,0,2,7
3924,168355,2022,Korea,Canada,0,4,5,9,05/06/2022,0,0,2,2,11,3,10,24,3,4,6,13,0,0,0,0,3,0,0,3
3925,168355,2022,USA,Canada,0,3,3,6,04/06/2022,0,0,2,2,8,6,7,21,0,2,4,6,0,0,0,0,5,1,0,6
3926,168355,2022,Canada,Dominican Republic,3,4,3,10,03/06/2022,0,0,2,2,13,5,12,30,2,0,2,4,0,0,0,0,8,0,0,8
3927,168355,2022,Poland,Canada,1,7,9,17,01/06/2022,0,0,4,4,12,11,16,39,1,1,4,6,0,0,0,0,5,3,1,9
3928,139514,2022,,,-,-,-,-,-,-,-,-,-,-,-,-,-,-,-,-,-,-,-,-,-,-,-,-,-
3929,175158,2022,Netherlands,Canada,0,0,0,0,03/07/2022,0,0,0,0,0,0,0,0,0,0,0,0,0,0,0,0,0,0,0,0
3930,175158,2022,Germany,Canada,0,0,0,0,03/07/2022,0,0,3,3,0,0,0,0,0,0,0,0,1,1,7,9,5,2,0,7
3931,175158,2022,Serbia,Canada,0,0,0,0,02/07/2022,0,0,2,2,0,0,0,0,0,0,0,0,1,0,4,5,0,0,0,0
3932,175158,2022,Canada,Türkiye,0,0,0,0,29/06/2022,0,0,6,6,0,0,1,1,0,0,0,0,7,4,13,24,7,4,1,12
3933,175158,2022,Bulgaria,Canada,0,0,0,0,18/06/2022,0,0,12,12,0,0,0,0,0,0,0,0,4,0,9,13,8,3,0,11
3934,175158,2022,China,Canada,0,0,0,0,17/06/2022,0,0,0,0,0,0,0,0,0,0,0,0,0,0,0,0,0,0,0,0
3935,175158,2022,Canada,Belgium,0,0,0,0,16/06/2022,0,0,8,8,0,0,0,0,0,0,0,0,3,0,10,13,7,2,2,11
3936,175158,2022,Canada,Thailand,0,0,0,0,14/06/2022,0,0,3,3,0,0,0,0,0,0,0,0,2,0,11,13,3,2,1,6
3937,175158,2022,Korea,Canada,0,0,0,0,05/06/2022,0,0,2,2,0,0,0,0,0,0,0,0,5,0,1,6,11,3,1,15
3938,175158,2022,USA,Canada,0,0,0,0,04/06/2022,0,0,0,0,0,0,0,0,0,0,0,0,0,0,0,0,0,0,0,0
3939,175158,2022,Canada,Dominican Republic,0,0,0,0,03/06/2022,0,0,5,5,0,0,0,0,0,0,0,0,8,2,7,17,13,1,1,15
3940,175158,2022,Poland,Canada,0,0,0,0,01/06/2022,0,0,12,12,0,0,0,0,0,0,0,0,6,1,5,12,9,5,0,14
3941,153629,2022,Netherlands,Canada,0,0,0,0,03/07/2022,0,0,0,0,0,0,0,0,0,0,0,0,0,0,0,0,0,0,0,0
3942,153629,2022,Germany,Canada,0,0,0,0,03/07/2022,0,0,0,0,0,0,0,0,0,0,0,0,0,0,0,0,0,0,0,0
3943,153629,2022,Serbia,Canada,0,0,0,0,02/07/2022,0,0,0,0,0,0,0,0,0,0,0,0,0,0,0,0,0,0,0,0
3944,153629,2022,Canada,Türkiye,0,0,0,0,29/06/2022,0,0,0,0,0,0,0,0,0,0,0,0,0,0,0,0,0,0,0,0
3945,153629,2022,Bulgaria,Canada,0,0,0,0,18/06/2022,0,0,0,0,0,0,0,0,0,0,0,0,0,0,0,0,0,0,0,0
3946,153629,2022,China,Canada,0,0,4,4,17/06/2022,1,0,0,1,1,0,0,1,0,0,0,0,0,0,0,0,2,0,0,2
3947,153629,2022,Canada,Belgium,0,0,0,0,16/06/2022,0,0,0,0,0,0,0,0,0,0,0,0,0,0,0,0,0,0,0,0
3948,153629,2022,Canada,Thailand,0,0,0,0,14/06/2022,0,0,0,0,0,0,0,0,0,0,0,0,0,0,0,0,0,0,0,0
3949,153629,2022,Korea,Canada,0,0,0,0,05/06/2022,0,0,0,0,0,0,0,0,0,0,0,0,0,0,0,0,0,0,0,0
3950,153629,2022,USA,Canada,0,0,4,4,04/06/2022,0,0,1,1,2,0,1,3,1,1,1,3,1,0,1,2,0,0,0,0
3951,153629,2022,Canada,Dominican Republic,0,0,0,0,03/06/2022,0,0,0,0,0,0,0,0,0,0,0,0,0,0,0,0,0,0,0,0
3952,153629,2022,Poland,Canada,0,0,0,0,01/06/2022,0,0,0,0,0,0,0,0,0,0,0,0,0,0,0,0,0,0,0,0
3953,189220,2022,,,-,-,-,-,-,-,-,-,-,-,-,-,-,-,-,-,-,-,-,-,-,-,-,-,-
3954,142777,2022,Netherlands,Canada,0,0,0,0,03/07/2022,0,0,0,0,0,0,0,0,0,0,0,0,0,0,0,0,0,0,0,0
3955,142777,2022,Germany,Canada,0,0,0,0,03/07/2022,0,0,0,0,0,0,0,0,0,0,0,0,0,0,0,0,0,0,0,0
3956,142777,2022,Serbia,Canada,0,2,8,10,02/07/2022,0,0,0,0,4,0,2,6,2,4,2,8,0,0,0,0,0,0,0,0
3957,142777,2022,Canada,Türkiye,0,0,0,0,29/06/2022,0,0,0,0,0,0,0,0,0,0,0,0,0,0,0,0,0,0,0,0
3958,142777,2022,Bulgaria,Canada,0,0,0,0,18/06/2022,0,0,0,0,0,0,0,0,0,0,0,0,0,0,0,0,0,0,0,0
3959,142777,2022,China,Canada,0,0,10,10,17/06/2022,0,0,3,3,2,1,3,6,1,3,13,17,0,0,0,0,1,1,0,2
3960,142777,2022,Canada,Belgium,0,0,0,0,16/06/2022,0,0,0,0,0,0,0,0,0,0,0,0,0,0,0,0,0,0,0,0
3961,142777,2022,Canada,Thailand,0,0,2,2,14/06/2022,0,0,0,0,0,0,0,0,0,1,1,2,0,0,0,0,0,0,0,0
3962,132236,2022,Netherlands,Canada,0,0,21,21,03/07/2022,0,0,9,9,21,4,20,45,1,3,0,4,15,3,28,46,12,2,0,14
3963,132236,2022,Germany,Canada,0,1,15,16,03/07/2022,0,0,1,1,26,8,20,54,0,0,0,0,6,2,10,18,12,3,0,15
3964,132236,2022,Serbia,Canada,0,1,2,3,02/07/2022,0,1,0,1,4,3,10,17,0,0,0,0,2,0,4,6,1,0,0,1
3965,132236,2022,Canada,Türkiye,0,1,15,16,29/06/2022,0,0,2,2,19,4,14,37,4,0,2,6,7,0,21,28,4,0,0,4
3966,132236,2022,Bulgaria,Canada,1,0,8,9,18/06/2022,0,1,1,2,8,5,20,33,1,0,5,6,6,1,33,40,8,3,0,11
3967,132236,2022,China,Canada,0,0,0,0,17/06/2022,0,0,0,0,0,0,0,0,0,0,0,0,0,0,0,0,0,0,0,0
3968,132236,2022,Canada,Belgium,0,1,14,15,16/06/2022,0,0,2,2,23,4,16,43,1,1,2,4,6,0,28,34,10,4,0,14
3969,132236,2022,Canada,Thailand,0,0,7,7,14/06/2022,0,0,0,0,12,4,18,34,1,6,2,9,5,3,29,37,3,3,0,6
3970,132236,2022,Korea,Canada,0,1,15,16,05/06/2022,0,0,0,0,11,5,9,25,0,1,2,3,20,3,6,29,7,1,0,8
3971,132236,2022,USA,Canada,0,0,9,9,04/06/2022,0,0,1,1,10,6,11,27,0,2,1,3,20,1,17,38,5,2,0,7
3972,132236,2022,Canada,Dominican Republic,0,0,13,13,03/06/2022,0,0,1,1,18,4,5,27,1,2,3,6,9,0,6,15,9,1,0,10
3973,132236,2022,Poland,Canada,0,0,14,14,01/06/2022,0,0,3,3,19,6,17,42,0,1,5,6,33,3,19,55,10,1,0,11
3974,157583,2022,Netherlands,Canada,0,0,0,0,03/07/2022,0,0,0,0,0,0,0,0,0,0,0,0,0,0,0,0,0,0,0,0
3975,157583,2022,Germany,Canada,0,0,0,0,03/07/2022,0,0,0,0,0,0,0,0,0,0,0,0,0,0,0,0,0,0,0,0
3976,157583,2022,Serbia,Canada,0,0,0,0,02/07/2022,0,0,3,3,0,0,0,0,0,0,0,0,0,0,0,0,0,0,0,0
3977,157583,2022,Canada,Türkiye,0,0,0,0,29/06/2022,0,0,0,0,0,0,0,0,0,0,0,0,0,0,0,0,0,0,0,0
3978,157583,2022,Korea,Canada,0,0,0,0,05/06/2022,0,0,0,0,0,0,0,0,0,0,0,0,0,0,0,0,0,0,0,0
3979,157583,2022,USA,Canada,0,1,0,1,04/06/2022,4,0,7,11,0,0,0,0,0,0,0,0,0,0,0,0,1,1,0,2
3980,157583,2022,Canada,Dominican Republic,0,0,0,0,03/06/2022,0,0,0,0,0,0,0,0,0,0,0,0,0,0,0,0,0,0,0,0
3981,157583,2022,Poland,Canada,0,1,0,1,01/06/2022,1,0,4,5,0,0,0,0,1,0,0,1,0,0,0,0,0,0,0,0
3982,173581,2022,Netherlands,Canada,0,0,2,2,03/07/2022,0,0,0,0,4,1,3,8,0,1,1,2,1,0,1,2,3,0,0,3
3983,173581,2022,Germany,Canada,0,1,3,4,03/07/2022,0,0,0,0,0,0,1,1,0,0,0,0,0,0,2,2,1,0,0,1
3984,173581,2022,Serbia,Canada,1,0,11,12,02/07/2022,0,0,0,0,4,3,6,13,1,1,2,4,7,1,10,18,3,0,0,3
3985,173581,2022,Canada,Türkiye,0,0,0,0,29/06/2022,0,0,0,0,0,0,0,0,0,0,0,0,0,0,0,0,0,0,0,0
3986,173581,2022,Bulgaria,Canada,0,0,0,0,18/06/2022,0,0,0,0,0,0,0,0,0,0,0,0,0,0,0,0,0,0,0,0
3987,173581,2022,China,Canada,0,1,1,2,17/06/2022,0,0,2,2,4,2,4,10,0,0,1,1,2,1,3,6,1,1,0,2
3988,173581,2022,Canada,Belgium,0,0,1,1,16/06/2022,0,0,0,0,0,0,0,0,0,0,0,0,0,2,2,4,0,0,0,0
3989,173581,2022,Canada,Thailand,1,3,6,10,14/06/2022,0,0,1,1,4,2,5,11,0,3,0,3,3,0,9,12,3,2,0,5
3990,173581,2022,Korea,Canada,0,0,0,0,05/06/2022,0,0,0,0,0,0,0,0,0,0,0,0,0,0,0,0,0,0,0,0
3991,173581,2022,USA,Canada,0,0,6,6,04/06/2022,0,0,2,2,6,2,11,19,1,0,1,2,5,0,5,10,5,0,0,5
3992,173581,2022,Canada,Dominican Republic,0,0,0,0,03/06/2022,0,0,0,0,0,0,0,0,0,0,0,0,0,0,0,0,0,0,0,0
3993,173581,2022,Poland,Canada,0,1,1,2,01/06/2022,0,0,0,0,0,0,0,0,0,0,0,0,3,0,0,3,2,0,0,2
3994,139522,2022,Netherlands,Canada,2,0,19,21,03/07/2022,0,0,3,3,4,0,5,9,3,4,4,11,0,0,0,0,4,0,0,4
3995,139522,2022,Germany,Canada,0,1,15,16,03/07/2022,0,0,3,3,9,0,2,11,3,4,3,10,0,0,0,0,1,1,0,2
3996,139522,2022,Serbia,Canada,0,0,8,8,02/07/2022,0,0,0,0,2,0,2,4,0,1,0,1,0,0,0,0,0,0,0,0
3997,139522,2022,Canada,Türkiye,0,1,15,16,29/06/2022,0,0,0,0,3,1,4,8,2,4,1,7,0,0,0,0,3,1,0,4
3998,139522,2022,Bulgaria,Canada,0,0,12,12,18/06/2022,1,0,1,2,5,0,3,8,1,5,3,9,0,0,0,0,3,2,0,5
3999,139522,2022,China,Canada,1,0,3,4,17/06/2022,0,0,0,0,0,2,0,2,1,2,1,4,0,0,1,1,1,0,0,1
4000,139522,2022,Canada,Belgium,1,1,11,13,16/06/2022,0,0,1,1,3,0,2,5,5,3,7,15,0,0,0,0,1,2,0,3
4001,139522,2022,Canada,Thailand,1,0,5,6,14/06/2022,0,0,0,0,3,0,4,7,1,1,4,6,0,0,0,0,0,0,0,0
4002,139522,2022,Korea,Canada,2,0,13,15,05/06/2022,0,0,1,1,8,0,1,9,3,1,5,9,0,0,0,0,4,0,0,4
4003,139522,2022,USA,Canada,0,1,4,5,04/06/2022,0,0,0,0,0,2,2,4,0,2,2,4,0,0,0,0,0,0,0,0
4004,139522,2022,Canada,Dominican Republic,1,0,11,12,03/06/2022,0,0,2,2,3,0,1,4,1,2,6,9,0,0,0,0,2,0,0,2
4005,139522,2022,Poland,Canada,0,1,11,12,01/06/2022,0,0,1,1,2,0,2,4,3,5,3,11,0,0,0,0,4,3,0,7
4006,173585,2022,Netherlands,Canada,0,0,12,12,03/07/2022,0,2,128,130,1,1,1,3,2,1,1,4,0,0,0,0,15,3,0,18
4007,173585,2022,Germany,Canada,0,1,15,16,03/07/2022,5,0,116,121,0,0,3,3,3,1,1,5,0,0,0,0,5,1,0,6
4008,173585,2022,Serbia,Canada,0,0,13,13,02/07/2022,7,1,69,77,2,1,1,4,1,0,0,1,0,0,1,1,0,0,1,1
4009,173585,2022,Canada,Türkiye,1,0,13,14,29/06/2022,0,3,92,95,1,0,3,4,3,2,0,5,0,0,0,0,3,0,0,3
4010,173585,2022,Bulgaria,Canada,0,0,11,11,18/06/2022,14,0,70,84,1,0,4,5,1,8,4,13,0,0,0,0,7,3,1,11
4011,173585,2022,China,Canada,1,1,9,11,17/06/2022,17,0,55,72,2,1,3,6,0,1,0,1,0,0,0,0,8,4,2,14
4012,173585,2022,Canada,Belgium,1,0,18,19,16/06/2022,26,0,68,94,4,1,1,6,1,7,3,11,0,1,0,1,10,3,1,14
4013,173585,2022,Canada,Thailand,1,1,10,12,14/06/2022,27,3,68,98,0,0,1,1,0,3,0,3,0,0,0,0,4,6,0,10
4014,173585,2022,Korea,Canada,1,1,8,10,05/06/2022,20,0,48,68,1,0,2,3,3,1,2,6,0,0,0,0,5,1,1,7
4015,173585,2022,USA,Canada,0,0,11,11,04/06/2022,9,0,56,65,3,0,1,4,2,0,0,2,1,0,0,1,13,3,0,16
4016,173585,2022,Canada,Dominican Republic,1,0,15,16,03/06/2022,15,0,51,66,2,0,1,3,0,1,0,1,0,1,0,1,9,1,1,11
4017,173585,2022,Poland,Canada,1,1,12,14,01/06/2022,12,1,75,88,0,0,4,4,1,1,2,4,0,0,0,0,14,3,1,18
4018,174676,2022,Netherlands,Canada,0,3,7,10,03/07/2022,0,0,3,3,6,6,15,27,1,3,3,7,8,3,15,26,6,0,0,6
4019,174676,2022,Germany,Canada,0,3,10,13,03/07/2022,0,0,2,2,6,2,11,19,0,2,0,2,16,1,16,33,17,2,0,19
4020,174676,2022,Serbia,Canada,0,3,12,15,02/07/2022,0,0,3,3,8,5,20,33,3,1,4,8,7,2,35,44,1,0,0,1
4021,174676,2022,Canada,Türkiye,2,4,10,16,29/06/2022,0,0,3,3,8,5,5,18,4,1,1,6,11,1,21,33,5,0,0,5
4022,174676,2022,Bulgaria,Canada,2,0,10,12,18/06/2022,0,0,1,1,5,4,3,12,0,0,3,3,1,2,9,12,8,1,0,9
4023,174676,2022,China,Canada,0,3,6,9,17/06/2022,0,0,6,6,11,5,14,30,0,1,5,6,3,6,26,35,5,1,2,8
4024,174676,2022,Canada,Belgium,0,4,6,10,16/06/2022,0,0,0,0,12,5,8,25,2,2,2,6,1,2,26,29,9,0,1,10
4025,174676,2022,Canada,Thailand,1,0,3,4,14/06/2022,0,0,0,0,0,2,4,6,1,0,0,1,1,0,3,4,1,0,0,1
4026,174676,2022,Korea,Canada,0,1,5,6,05/06/2022,0,0,1,1,6,1,10,17,0,2,1,3,5,0,3,8,5,2,1,8
4027,174676,2022,USA,Canada,0,1,0,1,04/06/2022,0,0,1,1,0,0,2,2,1,0,0,1,1,0,3,4,1,1,0,2
4028,174676,2022,Canada,Dominican Republic,2,2,8,12,03/06/2022,0,0,5,5,4,2,10,16,3,2,1,6,4,2,4,10,8,2,0,10
4029,174676,2022,Poland,Canada,0,4,8,12,01/06/2022,0,0,3,3,8,4,11,23,1,2,1,4,3,2,2,7,10,1,0,11
4030,166581,2022,,,-,-,-,-,-,-,-,-,-,-,-,-,-,-,-,-,-,-,-,-,-,-,-,-,-
4031,174680,2022,Netherlands,Canada,0,1,5,6,03/07/2022,0,0,0,0,0,0,0,0,0,0,0,0,0,0,0,0,0,0,0,0
4032,174680,2022,Germany,Canada,0,0,5,5,03/07/2022,0,0,0,0,0,0,0,0,0,0,0,0,0,0,0,0,1,1,0,2
4033,174680,2022,Serbia,Canada,0,0,2,2,02/07/2022,0,0,0,0,2,0,1,3,0,0,0,0,0,0,0,0,0,0,0,0
4034,174680,2022,Canada,Türkiye,1,0,6,7,29/06/2022,0,0,0,0,0,0,0,0,0,0,0,0,0,0,0,0,3,0,0,3
4035,174680,2022,Bulgaria,Canada,0,2,1,3,18/06/2022,0,0,0,0,0,0,0,0,0,1,0,1,2,0,2,4,1,0,0,1
4036,174680,2022,China,Canada,1,0,9,10,17/06/2022,0,0,2,2,6,3,10,19,0,0,1,1,6,1,19,26,9,1,0,10
4037,174680,2022,Canada,Belgium,0,0,9,9,16/06/2022,0,0,0,0,0,0,0,0,0,0,0,0,0,0,0,0,1,0,0,1
4038,174680,2022,Canada,Thailand,0,0,2,2,14/06/2022,0,0,0,0,0,0,0,0,0,0,0,0,2,0,2,4,0,0,0,0
4039,174680,2022,Korea,Canada,0,1,1,2,05/06/2022,0,0,0,0,0,0,0,0,0,0,0,0,0,1,0,1,1,0,0,1
4040,174680,2022,USA,Canada,0,1,1,2,04/06/2022,0,0,0,0,2,0,1,3,0,0,0,0,2,1,1,4,2,0,0,2
4041,174680,2022,Canada,Dominican Republic,0,0,0,0,03/06/2022,0,0,0,0,0,0,0,0,0,0,0,0,0,0,0,0,0,0,0,0
4042,174680,2022,Poland,Canada,0,1,0,1,01/06/2022,0,0,0,0,0,0,0,0,0,0,0,0,0,0,0,0,1,1,1,3
4043,170054,2022,Korea,Canada,0,0,0,0,05/06/2022,0,0,0,0,0,0,0,0,0,0,0,0,0,0,0,0,0,0,0,0
4044,170054,2022,USA,Canada,0,0,0,0,04/06/2022,0,0,13,13,0,0,0,0,0,0,0,0,4,0,2,6,9,2,0,11
4045,170054,2022,Canada,Dominican Republic,0,0,0,0,03/06/2022,0,0,0,0,0,0,0,0,0,0,0,0,0,0,0,0,0,0,0,0
4046,170054,2022,Poland,Canada,0,0,0,0,01/06/2022,0,0,0,0,0,0,0,0,0,0,0,0,0,0,0,0,0,0,0,0
4047,156485,2022,Bulgaria,Canada,0,0,0,0,18/06/2022,0,0,0,0,0,0,0,0,0,0,0,0,0,0,0,0,0,0,0,0
4048,156485,2022,China,Canada,0,0,1,1,17/06/2022,3,0,16,19,0,0,0,0,0,0,1,1,0,0,0,0,1,0,2,3
4049,156485,2022,Canada,Belgium,0,0,0,0,16/06/2022,0,0,0,0,0,0,0,0,0,0,0,0,0,0,0,0,0,0,0,0
4050,156485,2022,Canada,Thailand,0,0,0,0,14/06/2022,0,0,0,0,0,0,0,0,0,0,0,0,0,0,0,0,0,0,0,0
4051,168354,2022,Netherlands,Canada,0,2,3,5,03/07/2022,0,0,3,3,8,2,7,17,4,7,4,15,1,1,0,2,5,1,0,6
4052,168354,2022,Germany,Canada,0,2,7,9,03/07/2022,0,0,0,0,5,0,9,14,4,5,4,13,1,0,2,3,1,0,0,1
4053,168354,2022,Serbia,Canada,0,0,10,10,02/07/2022,0,0,0,0,7,2,5,14,4,2,3,9,1,0,1,2,2,0,0,2
4054,168354,2022,Canada,Türkiye,0,1,12,13,29/06/2022,0,0,2,2,6,0,7,13,1,3,0,4,0,0,0,0,0,0,0,0
4055,168354,2022,Bulgaria,Canada,1,1,6,8,18/06/2022,0,0,0,0,9,0,5,14,3,8,2,13,0,0,0,0,4,1,0,5
4056,168354,2022,China,Canada,1,2,7,10,17/06/2022,0,0,1,1,7,0,3,10,1,4,0,5,0,0,0,0,2,1,0,3
4057,168354,2022,Canada,Belgium,0,3,12,15,16/06/2022,0,0,1,1,7,2,3,12,2,1,1,4,0,0,3,3,4,0,0,4
4058,168354,2022,Canada,Thailand,0,4,6,10,14/06/2022,0,0,0,0,7,0,5,12,1,3,3,7,0,0,0,0,0,0,0,0
4059,168354,2022,Korea,Canada,1,1,13,15,05/06/2022,0,0,1,1,6,1,4,11,3,2,5,10,2,0,0,2,6,0,1,7
4060,168354,2022,USA,Canada,0,1,6,7,04/06/2022,0,0,1,1,5,1,7,13,1,3,3,7,0,0,0,0,1,0,0,1
4061,168354,2022,Canada,Dominican Republic,1,0,9,10,03/06/2022,0,0,1,1,3,1,2,6,2,1,2,5,0,0,1,1,4,1,0,5
4062,168354,2022,Poland,Canada,0,3,11,14,01/06/2022,0,0,1,1,7,1,3,11,0,4,2,6,3,0,1,4,3,1,0,4
4063,181280,2022,Netherlands,Canada,0,0,0,0,03/07/2022,0,0,14,14,0,0,0,0,0,0,0,0,7,0,10,17,14,3,0,17
4064,181280,2022,Germany,Canada,0,0,0,0,03/07/2022,0,0,5,5,0,0,0,0,0,0,0,0,9,0,10,19,8,1,0,9
4065,181280,2022,Serbia,Canada,0,0,0,0,02/07/2022,0,0,3,3,0,0,0,0,0,0,0,0,1,0,5,6,1,1,0,2
4066,181280,2022,Canada,Türkiye,0,0,0,0,29/06/2022,0,0,0,0,0,0,0,0,0,0,0,0,0,0,0,0,0,0,0,0
4067,181280,2022,Bulgaria,Canada,0,0,0,0,18/06/2022,0,0,0,0,0,0,0,0,0,0,0,0,0,0,0,0,0,0,0,0
4068,181280,2022,China,Canada,0,0,0,0,17/06/2022,2,0,6,8,0,0,0,0,0,0,0,0,3,1,13,17,14,4,1,19
4069,181280,2022,Canada,Belgium,0,0,0,0,16/06/2022,0,0,0,0,0,0,0,0,0,0,0,0,0,0,0,0,0,0,0,0
4070,181280,2022,Canada,Thailand,0,0,0,0,14/06/2022,0,0,0,0,0,0,0,0,0,0,0,0,0,0,0,0,0,0,0,0
4071,181279,2022,,,-,-,-,-,-,-,-,-,-,-,-,-,-,-,-,-,-,-,-,-,-,-,-,-,-
4072,181178,2022,,,-,-,-,-,-,-,-,-,-,-,-,-,-,-,-,-,-,-,-,-,-,-,-,-,-
4073,189157,2022,,,-,-,-,-,-,-,-,-,-,-,-,-,-,-,-,-,-,-,-,-,-,-,-,-,-
4074,174681,2022,,,-,-,-,-,-,-,-,-,-,-,-,-,-,-,-,-,-,-,-,-,-,-,-,-,-
4075,189156,2022,Netherlands,Canada,0,0,0,0,03/07/2022,0,0,0,0,0,0,0,0,0,0,0,0,0,0,0,0,0,0,0,0
4076,189156,2022,Germany,Canada,0,0,0,0,03/07/2022,0,0,0,0,0,0,0,0,0,0,0,0,0,0,0,0,0,0,0,0
4077,189156,2022,Serbia,Canada,0,0,0,0,02/07/2022,0,0,0,0,0,0,0,0,0,0,0,0,0,0,0,0,0,0,0,0
4078,189156,2022,Canada,Türkiye,0,0,0,0,29/06/2022,0,0,0,0,0,0,0,0,0,0,0,0,0,0,0,0,0,0,0,0
4079,189156,2022,Bulgaria,Canada,0,0,0,0,18/06/2022,0,0,0,0,0,0,0,0,0,0,0,0,0,0,0,0,0,0,0,0
4080,189156,2022,China,Canada,0,1,0,1,17/06/2022,0,0,0,0,0,0,2,2,0,0,0,0,0,0,0,0,0,2,0,2
4081,189156,2022,Canada,Belgium,0,0,0,0,16/06/2022,0,0,0,0,0,0,0,0,0,0,0,0,0,0,0,0,0,0,0,0
4082,189156,2022,Canada,Thailand,0,0,0,0,14/06/2022,0,0,0,0,0,0,0,0,0,0,0,0,0,0,0,0,0,0,0,0
4083,189156,2022,Korea,Canada,0,0,0,0,05/06/2022,0,0,0,0,0,0,0,0,0,0,0,0,0,0,0,0,0,0,0,0
4084,189156,2022,USA,Canada,1,2,2,5,04/06/2022,0,0,0,0,0,2,3,5,0,1,0,1,0,0,0,0,1,1,0,2
4085,189156,2022,Canada,Dominican Republic,0,0,0,0,03/06/2022,0,0,0,0,0,0,0,0,0,0,0,0,0,0,0,0,0,0,0,0
4086,189156,2022,Poland,Canada,1,1,2,4,01/06/2022,0,0,0,0,1,0,0,1,0,0,0,0,0,0,0,0,1,0,0,1
4087,135746,2022,Italy,China,0,0,16,16,14/07/2022,0,0,1,1,7,1,7,15,2,3,5,10,0,1,2,3,1,0,0,1
4088,135746,2022,China,Korea,0,2,12,14,03/07/2022,0,0,0,0,9,3,7,19,2,6,9,17,1,0,0,1,2,1,1,4
4089,135746,2022,China,Dominican Republic,2,0,17,19,01/07/2022,1,0,0,1,7,0,7,14,1,10,4,15,0,0,0,0,1,0,3,4
4090,135746,2022,Poland,China,1,0,11,12,30/06/2022,0,0,3,3,5,1,7,13,2,4,2,8,0,0,0,0,0,0,0,0
4091,135746,2022,China,Brazil,0,1,16,17,28/06/2022,0,0,1,1,10,1,8,19,2,8,1,11,0,0,0,0,2,1,0,3
4092,135746,2022,Japan,China,1,1,7,9,19/06/2022,0,0,1,1,5,1,4,10,3,7,6,16,0,0,0,0,1,1,0,2
4093,135746,2022,USA,China,1,0,8,9,18/06/2022,0,1,1,2,3,0,7,10,1,5,5,11,0,0,0,0,2,0,1,3
4094,135746,2022,China,Canada,1,0,16,17,17/06/2022,1,0,1,2,4,1,10,15,3,6,7,16,0,0,0,0,3,1,0,4
4095,135746,2022,China,Belgium,0,0,9,9,15/06/2022,0,0,1,1,5,0,4,9,1,2,5,8,0,0,0,0,1,0,0,1
4096,135746,2022,Thailand,China,3,1,14,18,05/06/2022,1,0,2,3,6,1,10,17,2,9,9,20,0,0,0,0,4,0,3,7
4097,135746,2022,China,Italy,0,1,11,12,04/06/2022,1,0,0,1,6,0,5,11,4,11,4,19,0,0,0,0,2,0,0,2
4098,135746,2022,Türkiye,China,1,2,13,16,03/06/2022,0,0,1,1,7,2,6,15,3,3,6,12,0,0,1,1,2,0,1,3
4099,135746,2022,China,Netherlands,0,0,13,13,01/06/2022,0,0,3,3,7,1,3,11,4,7,10,21,0,0,0,0,1,1,2,4
4100,162354,2022,Italy,China,0,0,17,17,14/07/2022,30,0,70,100,0,0,1,1,0,3,5,8,0,0,0,0,10,2,2,14
4101,162354,2022,China,Korea,0,0,15,15,03/07/2022,8,0,86,94,0,0,1,1,0,2,4,6,0,0,0,0,5,2,2,9
4102,162354,2022,China,Dominican Republic,0,1,7,8,01/07/2022,64,0,0,64,2,0,0,2,3,5,6,14,0,0,0,0,5,0,2,7
4103,162354,2022,Poland,China,0,2,8,10,30/06/2022,0,2,60,62,1,0,0,1,1,1,1,3,0,0,0,0,8,2,3,13
4104,162354,2022,China,Brazil,1,0,20,21,28/06/2022,32,1,69,102,1,0,1,2,1,5,6,12,0,0,0,0,7,0,3,10
4105,162354,2022,China,Belgium,0,0,0,0,15/06/2022,0,0,0,0,0,0,0,0,0,0,0,0,0,0,0,0,0,0,0,0
4106,162354,2022,Thailand,China,0,0,6,6,05/06/2022,26,0,22,48,1,2,0,3,0,1,1,2,0,0,0,0,5,0,1,6
4107,162354,2022,China,Italy,0,0,6,6,04/06/2022,25,0,12,37,1,0,0,1,0,2,0,2,0,0,1,1,3,5,0,8
4108,162354,2022,Türkiye,China,1,1,15,17,03/06/2022,48,0,39,87,3,0,0,3,2,3,1,6,0,0,1,1,1,2,0,3
4109,162354,2022,China,Netherlands,2,0,12,14,01/06/2022,22,1,71,94,1,0,2,3,3,3,5,11,0,0,0,0,6,5,7,18
4110,152337,2022,Italy,China,0,0,0,0,14/07/2022,0,0,0,0,0,0,0,0,0,0,0,0,0,0,0,0,0,0,0,0
4111,152337,2022,China,Korea,0,0,0,0,03/07/2022,0,0,0,0,0,0,0,0,0,0,0,0,0,0,0,0,0,0,0,0
4112,152337,2022,China,Dominican Republic,0,0,0,0,01/07/2022,0,0,0,0,0,0,0,0,0,0,0,0,0,0,0,0,0,0,0,0
4113,152337,2022,Poland,China,0,0,0,0,30/06/2022,0,0,0,0,0,0,0,0,0,0,0,0,0,0,0,0,0,0,0,0
4114,152337,2022,China,Brazil,0,0,0,0,28/06/2022,0,0,0,0,0,0,0,0,0,0,0,0,0,0,0,0,0,0,0,0
4115,152337,2022,Japan,China,0,0,0,0,19/06/2022,0,0,0,0,0,0,0,0,0,0,0,0,0,0,0,0,0,0,0,0
4116,152337,2022,USA,China,1,1,3,5,18/06/2022,0,0,1,1,2,0,5,7,1,2,1,4,0,0,0,0,0,0,0,0
4117,152337,2022,China,Canada,0,0,1,1,17/06/2022,0,0,2,2,2,0,0,2,0,0,2,2,0,0,0,0,0,0,0,0
4118,152337,2022,China,Belgium,0,0,0,0,15/06/2022,0,0,0,0,0,0,0,0,0,0,0,0,0,0,0,0,0,0,0,0
4119,152337,2022,Thailand,China,0,0,0,0,05/06/2022,0,0,0,0,0,0,0,0,0,0,0,0,0,0,0,0,0,0,0,0
4120,152337,2022,China,Italy,0,0,0,0,04/06/2022,0,0,0,0,0,0,0,0,0,0,0,0,0,0,0,0,0,0,0,0
4121,152337,2022,Türkiye,China,0,0,0,0,03/06/2022,0,0,0,0,0,0,0,0,0,0,0,0,0,0,0,0,0,0,0,0
4122,152337,2022,China,Netherlands,0,0,0,0,01/06/2022,0,0,0,0,0,0,0,0,0,0,0,0,0,0,0,0,0,0,0,0
4123,152332,2022,Italy,China,0,0,0,0,14/07/2022,0,0,0,0,0,0,0,0,0,0,0,0,0,0,0,0,0,0,0,0
4124,152332,2022,China,Korea,0,0,0,0,03/07/2022,0,0,0,0,0,0,0,0,0,0,0,0,0,0,0,0,0,0,0,0
4125,152332,2022,China,Dominican Republic,0,0,0,0,01/07/2022,0,0,0,0,0,0,0,0,0,0,0,0,0,0,0,0,0,0,0,0
4126,152332,2022,Poland,China,0,0,0,0,30/06/2022,0,0,0,0,0,0,0,0,0,0,0,0,0,0,0,0,0,0,0,0
4127,152332,2022,China,Brazil,0,0,0,0,28/06/2022,0,0,0,0,0,0,0,0,0,0,0,0,0,0,0,0,0,0,0,0
4128,143206,2022,Italy,China,0,0,12,12,14/07/2022,0,0,5,5,18,3,13,34,2,4,3,9,4,2,6,12,12,2,1,15
4129,143206,2022,China,Korea,1,0,16,17,03/07/2022,0,0,0,0,13,3,10,26,3,7,2,12,1,0,2,3,3,0,2,5
4130,143206,2022,China,Dominican Republic,1,0,10,11,01/07/2022,2,1,0,3,9,2,8,19,0,4,0,4,2,2,1,5,6,1,0,7
4131,143206,2022,Poland,China,1,1,10,12,30/06/2022,0,0,1,1,9,2,4,15,1,1,1,3,5,0,3,8,4,0,1,5
4132,143206,2022,China,Brazil,1,0,14,15,28/06/2022,2,0,11,13,14,6,13,33,2,7,2,11,4,0,15,19,9,3,2,14
4133,143206,2022,Japan,China,2,0,17,19,19/06/2022,0,1,5,6,9,4,16,29,1,3,4,8,2,1,10,13,5,1,2,8
4134,143206,2022,USA,China,0,1,11,12,18/06/2022,0,0,3,3,9,3,6,18,2,3,1,6,4,0,1,5,8,3,1,12
4135,143206,2022,China,Canada,1,2,11,14,17/06/2022,0,0,5,5,13,1,17,31,1,2,1,4,3,0,7,10,17,2,0,19
4136,143206,2022,China,Belgium,0,0,16,16,15/06/2022,0,0,0,0,15,0,7,22,3,1,2,6,2,0,0,2,7,2,0,9
4137,143206,2022,Thailand,China,1,0,18,19,05/06/2022,1,0,4,5,18,3,17,38,1,1,5,7,7,1,8,16,12,1,1,14
4138,143206,2022,China,Italy,1,0,9,10,04/06/2022,0,0,1,1,13,4,7,24,2,3,1,6,6,0,13,19,9,1,0,10
4139,143206,2022,Türkiye,China,0,1,20,21,03/06/2022,0,0,6,6,12,6,6,24,0,1,2,3,8,1,2,11,12,1,5,18
4140,143206,2022,China,Netherlands,1,0,13,14,01/06/2022,0,1,5,6,19,1,17,37,0,5,2,7,4,1,16,21,6,3,6,15
4141,143201,2022,Italy,China,1,1,10,12,14/07/2022,0,0,5,5,6,0,2,8,5,4,5,14,1,0,0,1,4,0,1,5
4142,143201,2022,China,Korea,0,2,18,20,03/07/2022,0,0,3,3,8,0,6,14,2,6,3,11,0,0,0,0,0,0,2,2
4143,143201,2022,China,Dominican Republic,0,0,10,10,01/07/2022,4,0,0,4,6,1,3,10,1,4,4,9,1,0,2,3,1,0,1,2
4144,143201,2022,Poland,China,0,1,6,7,30/06/2022,0,0,0,0,6,0,2,8,3,1,2,6,0,0,0,0,1,0,1,2
4145,143201,2022,China,Brazil,1,1,13,15,28/06/2022,1,0,2,3,9,1,1,11,5,3,3,11,0,0,1,1,2,0,0,2
4146,143201,2022,Japan,China,0,0,8,8,19/06/2022,0,0,1,1,1,3,4,8,3,0,5,8,0,0,1,1,2,0,0,2
4147,143201,2022,USA,China,0,0,7,7,18/06/2022,0,0,0,0,2,0,1,3,0,4,1,5,0,1,0,1,2,0,0,2
4148,143201,2022,China,Canada,1,1,12,14,17/06/2022,0,0,0,0,7,2,4,13,4,3,6,13,1,0,1,2,4,0,0,4
4149,143201,2022,China,Belgium,1,1,11,13,15/06/2022,0,0,1,1,7,1,1,9,1,5,5,11,0,0,0,0,2,2,0,4
4150,143201,2022,Thailand,China,0,0,18,18,05/06/2022,0,0,2,2,9,2,6,17,1,6,6,13,0,0,0,0,4,4,3,11
4151,143201,2022,China,Italy,0,0,13,13,04/06/2022,0,0,3,3,4,1,6,11,2,5,12,19,0,0,0,0,2,0,1,3
4152,143201,2022,Türkiye,China,0,1,10,11,03/06/2022,0,0,2,2,5,3,5,13,3,3,5,11,1,0,3,4,2,0,0,2
4153,143201,2022,China,Netherlands,0,2,6,8,01/06/2022,0,0,6,6,18,4,7,29,3,6,9,18,0,0,0,0,1,0,3,4
4154,152917,2022,Italy,China,0,0,1,1,14/07/2022,0,0,0,0,0,0,0,0,0,0,0,0,0,0,0,0,0,1,0,1
4155,152917,2022,China,Korea,1,1,9,11,03/07/2022,0,0,3,3,4,4,4,12,1,2,1,4,4,1,9,14,6,0,0,6
4156,152917,2022,China,Dominican Republic,0,0,10,10,01/07/2022,0,0,0,0,5,2,7,14,2,0,1,3,1,0,8,9,5,1,0,6
4157,152917,2022,Poland,China,0,0,14,14,30/06/2022,0,0,1,1,7,3,9,19,1,1,2,4,4,0,5,9,6,1,0,7
4158,152917,2022,China,Brazil,0,0,12,12,28/06/2022,0,0,1,1,2,1,7,10,0,2,2,4,2,3,12,17,6,1,0,7
4159,152917,2022,Japan,China,0,1,3,4,19/06/2022,0,0,0,0,4,1,3,8,0,0,0,0,1,0,3,4,2,1,0,3
4160,152917,2022,USA,China,0,0,12,12,18/06/2022,0,0,2,2,7,2,4,13,0,2,1,3,1,1,8,10,3,2,0,5
4161,152917,2022,China,Canada,1,0,4,5,17/06/2022,0,0,1,1,2,0,4,6,0,1,0,1,1,0,2,3,2,0,0,2
4162,152917,2022,China,Belgium,0,0,13,13,15/06/2022,0,0,1,1,7,0,9,16,1,3,2,6,8,1,11,20,7,3,0,10
4163,152917,2022,Thailand,China,0,0,3,3,05/06/2022,0,0,0,0,1,2,1,4,0,1,0,1,0,0,5,5,4,0,0,4
4164,152917,2022,China,Italy,0,1,11,12,04/06/2022,0,0,2,2,4,0,7,11,2,1,1,4,0,1,6,7,3,0,0,3
4165,152917,2022,Türkiye,China,0,1,8,9,03/06/2022,0,0,2,2,6,5,4,15,0,1,3,4,4,0,9,13,6,1,1,8
4166,152917,2022,China,Netherlands,0,0,2,2,01/06/2022,0,0,0,0,1,2,4,7,0,1,0,1,0,0,5,5,0,1,1,2
4167,135740,2022,Italy,China,1,3,18,22,14/07/2022,0,0,5,5,9,3,19,31,0,4,1,5,10,1,9,20,6,3,0,9
4168,135740,2022,China,Korea,0,2,3,5,03/07/2022,1,0,0,1,3,2,4,9,1,1,0,2,4,0,7,11,1,2,1,4
4169,135740,2022,China,Dominican Republic,0,0,0,0,01/07/2022,0,0,0,0,0,0,0,0,0,0,0,0,0,0,0,0,0,0,0,0
4170,135740,2022,Poland,China,0,0,0,0,30/06/2022,0,0,0,0,0,0,0,0,0,0,0,0,0,0,0,0,0,0,0,0
4171,135740,2022,China,Brazil,0,2,5,7,28/06/2022,0,0,3,3,3,2,8,13,0,1,0,1,5,0,3,8,5,0,0,5
4172,135740,2022,Japan,China,1,0,7,8,19/06/2022,1,0,3,4,3,3,7,13,1,2,1,4,6,4,15,25,3,2,1,6
4173,135740,2022,USA,China,0,0,0,0,18/06/2022,0,0,0,0,0,0,3,3,0,0,0,0,0,0,0,0,0,0,0,0
4174,135740,2022,China,Canada,2,2,12,16,17/06/2022,0,0,4,4,4,1,16,21,1,0,0,1,2,1,8,11,6,0,0,6
4175,135740,2022,China,Belgium,0,0,2,2,15/06/2022,0,0,0,0,2,1,4,7,1,2,1,4,0,0,5,5,4,0,0,4
4176,135740,2022,Thailand,China,2,1,12,15,05/06/2022,1,0,2,3,7,3,7,17,2,4,2,8,9,1,20,30,9,3,0,12
4177,135740,2022,China,Italy,0,0,10,10,04/06/2022,0,0,1,1,4,2,8,14,1,1,0,2,3,0,7,10,6,2,1,9
4178,135740,2022,Türkiye,China,0,1,3,4,03/06/2022,0,0,0,0,1,0,0,1,0,0,1,1,3,0,6,9,1,2,0,3
4179,135740,2022,China,Netherlands,0,0,18,18,01/06/2022,0,0,2,2,3,4,7,14,1,0,2,3,9,0,25,34,7,4,5,16
4180,172644,2022,Italy,China,0,0,0,0,14/07/2022,0,0,0,0,0,0,0,0,0,0,0,0,0,0,0,0,0,0,0,0
4181,172644,2022,China,Belgium,0,0,0,0,15/06/2022,0,0,0,0,0,0,0,0,0,0,0,0,0,0,0,0,0,0,0,0
4182,172644,2022,Thailand,China,0,0,2,2,05/06/2022,0,0,0,0,0,0,0,0,0,0,0,0,0,0,0,0,1,0,0,1
4183,172644,2022,China,Italy,0,0,0,0,04/06/2022,0,0,0,0,0,0,0,0,0,0,0,0,0,0,0,0,0,0,0,0
4184,172644,2022,Türkiye,China,0,0,2,2,03/06/2022,0,0,0,0,0,0,0,0,0,0,0,0,0,0,0,0,0,0,0,0
4185,172644,2022,China,Netherlands,0,1,2,3,01/06/2022,0,0,0,0,0,0,0,0,0,0,0,0,0,0,0,0,0,0,0,0
4186,152318,2022,Italy,China,0,2,8,10,14/07/2022,0,0,8,8,14,8,13,35,2,8,4,14,13,1,11,25,14,2,0,16
4187,152318,2022,China,Korea,2,2,7,11,03/07/2022,0,1,1,2,18,3,16,37,3,4,2,9,9,1,17,27,11,3,4,18
4188,152318,2022,China,Dominican Republic,2,0,14,16,01/07/2022,0,0,0,0,12,5,7,24,1,1,0,2,8,0,6,14,3,1,0,4
4189,152318,2022,Poland,China,1,4,9,14,30/06/2022,0,0,0,0,11,4,9,24,3,1,0,4,5,0,5,10,3,2,1,6
4190,152318,2022,China,Brazil,0,1,13,14,28/06/2022,0,0,3,3,20,11,20,51,1,4,4,9,7,0,22,29,7,1,4,12
4191,152318,2022,Japan,China,0,3,10,13,19/06/2022,0,0,3,3,25,7,16,48,2,4,1,7,10,1,14,25,12,4,1,17
4192,152318,2022,USA,China,0,2,7,9,18/06/2022,0,1,0,1,12,4,5,21,1,2,3,6,7,2,6,15,6,2,0,8
4193,152318,2022,China,Canada,3,0,15,18,17/06/2022,0,0,3,3,17,8,7,32,0,0,2,2,5,1,8,14,8,3,1,12
4194,152318,2022,China,Belgium,0,1,4,5,15/06/2022,0,0,0,0,8,2,8,18,1,5,0,6,1,0,8,9,3,2,2,7
4195,152318,2022,Thailand,China,1,1,16,18,05/06/2022,1,0,2,3,26,6,22,54,0,6,3,9,4,0,6,10,14,3,3,20
4196,152318,2022,China,Italy,3,3,15,21,04/06/2022,0,0,0,0,15,3,14,32,3,0,4,7,1,1,17,19,7,3,2,12
4197,152318,2022,Türkiye,China,1,2,11,14,03/06/2022,0,0,0,0,20,2,15,37,1,6,1,8,7,1,12,20,7,4,4,15
4198,152318,2022,China,Netherlands,0,1,13,14,01/06/2022,0,1,1,2,19,3,23,45,0,5,4,9,5,0,11,16,6,6,5,17
4199,152326,2022,China,Korea,0,0,0,0,03/07/2022,0,0,0,0,0,0,0,0,0,0,0,0,0,0,0,0,0,0,0,0
4200,152326,2022,China,Dominican Republic,0,0,0,0,01/07/2022,0,0,0,0,0,0,0,0,0,0,0,0,0,0,0,0,0,0,0,0
4201,152326,2022,Poland,China,0,0,2,2,30/06/2022,0,0,0,0,0,0,0,0,0,0,0,0,0,0,0,0,0,0,0,0
4202,152326,2022,China,Brazil,0,0,3,3,28/06/2022,0,0,0,0,0,0,0,0,0,0,0,0,0,0,0,0,0,1,0,1
4203,135742,2022,Japan,China,0,0,3,3,19/06/2022,0,0,1,1,0,1,1,2,0,4,1,5,0,0,0,0,1,1,0,2
4204,135742,2022,USA,China,0,0,0,0,18/06/2022,0,0,0,0,0,0,0,0,0,0,0,0,0,0,0,0,0,0,0,0
4205,135742,2022,China,Canada,0,0,0,0,17/06/2022,0,0,0,0,0,0,0,0,0,0,0,0,0,0,0,0,0,0,0,0
4206,135742,2022,China,Belgium,0,0,0,0,15/06/2022,0,0,0,0,0,0,0,0,0,0,0,0,0,0,0,0,0,0,0,0
4207,135742,2022,Thailand,China,0,0,0,0,05/06/2022,0,0,0,0,0,0,0,0,0,0,0,0,0,0,0,0,0,0,0,0
4208,135742,2022,China,Italy,0,0,0,0,04/06/2022,0,0,0,0,0,0,0,0,0,0,0,0,0,0,0,0,0,0,0,0
4209,135742,2022,Türkiye,China,0,0,0,0,03/06/2022,0,0,0,0,0,0,0,0,0,0,0,0,0,0,0,0,0,0,0,0
4210,135742,2022,China,Netherlands,0,0,0,0,01/06/2022,0,0,0,0,0,0,0,0,0,0,0,0,0,0,0,0,0,0,0,0
4211,150705,2022,Italy,China,0,0,0,0,14/07/2022,0,0,7,7,0,0,0,0,0,0,0,0,2,3,23,28,14,2,2,18
4212,150705,2022,China,Korea,0,0,0,0,03/07/2022,0,0,1,1,0,0,0,0,0,0,0,0,2,2,9,13,4,2,3,9
4213,150705,2022,China,Dominican Republic,0,0,0,0,01/07/2022,2,0,0,2,0,0,0,0,0,0,0,0,2,1,10,13,4,2,2,8
4214,150705,2022,Poland,China,0,0,0,0,30/06/2022,0,0,8,8,0,0,0,0,0,0,0,0,4,1,10,15,14,2,4,20
4215,150705,2022,China,Brazil,0,0,0,0,28/06/2022,0,0,4,4,0,0,0,0,0,0,0,0,4,0,13,17,13,0,1,14
4216,150705,2022,Japan,China,0,0,0,0,19/06/2022,0,0,5,5,0,0,0,0,0,0,0,0,4,0,3,7,7,1,0,8
4217,150705,2022,USA,China,0,0,0,0,18/06/2022,0,0,1,1,0,0,0,0,0,0,0,0,5,4,22,31,6,2,0,8
4218,150705,2022,China,Canada,0,0,0,0,17/06/2022,0,0,4,4,0,0,0,0,0,0,0,0,2,2,6,10,4,1,0,5
4219,150705,2022,China,Belgium,0,0,0,0,15/06/2022,0,0,5,5,0,0,0,0,0,0,0,0,1,1,12,14,4,1,1,6
4220,150705,2022,Thailand,China,0,0,0,0,05/06/2022,1,0,3,4,0,0,0,0,0,0,0,0,3,0,13,16,5,2,2,9
4221,150705,2022,China,Italy,0,0,0,0,04/06/2022,0,0,3,3,0,0,0,0,0,0,0,0,3,2,7,12,4,3,6,13
4222,150705,2022,Türkiye,China,0,0,0,0,03/06/2022,0,0,4,4,0,0,0,0,0,0,0,0,3,0,8,11,10,2,1,13
4223,150705,2022,China,Netherlands,0,0,0,0,01/06/2022,0,0,12,12,0,0,0,0,0,0,0,0,3,0,12,15,14,5,2,21
4224,124130,2022,Italy,China,0,0,0,0,14/07/2022,0,0,3,3,0,0,0,0,0,0,0,0,0,0,0,0,0,0,0,0
4225,124130,2022,China,Korea,0,0,1,1,03/07/2022,1,0,10,11,0,0,0,0,0,0,0,0,0,0,0,0,0,1,0,1
4226,124130,2022,China,Dominican Republic,0,0,0,0,01/07/2022,0,0,0,0,0,0,0,0,0,0,0,0,0,0,0,0,0,0,0,0
4227,124130,2022,Poland,China,0,0,0,0,30/06/2022,0,0,3,3,0,0,0,0,0,0,1,1,0,0,0,0,0,0,0,0
4228,124130,2022,China,Brazil,0,0,0,0,28/06/2022,1,0,2,3,0,0,0,0,0,0,0,0,0,0,0,0,1,0,0,1
4229,124130,2022,Japan,China,0,0,13,13,19/06/2022,32,3,60,95,0,3,1,4,2,2,4,8,0,0,0,0,7,0,1,8
4230,124130,2022,USA,China,1,1,11,13,18/06/2022,16,1,50,67,0,0,0,0,0,6,4,10,0,0,0,0,3,1,0,4
4231,124130,2022,China,Canada,0,0,7,7,17/06/2022,23,0,70,93,1,0,1,2,1,2,2,5,0,0,1,1,8,2,2,12
4232,124130,2022,China,Belgium,1,2,13,16,15/06/2022,27,1,45,73,1,0,1,2,2,0,3,5,0,0,0,0,6,3,2,11
4233,124130,2022,Thailand,China,0,0,8,8,05/06/2022,39,0,34,73,2,1,2,5,0,1,3,4,0,0,0,0,1,2,2,5
4234,124130,2022,China,Italy,1,0,9,10,04/06/2022,36,0,17,53,1,0,2,3,0,0,3,3,0,0,0,0,4,2,2,8
4235,124130,2022,Türkiye,China,0,0,0,0,03/06/2022,0,0,0,0,0,0,0,0,0,0,0,0,0,0,0,0,0,0,0,0
4236,124130,2022,China,Netherlands,0,0,4,4,01/06/2022,0,0,18,18,0,0,0,0,0,0,1,1,0,0,0,0,0,1,0,1
4237,163909,2022,Italy,China,0,0,0,0,14/07/2022,0,0,0,0,0,0,0,0,0,0,0,0,0,0,0,0,0,0,0,0
4238,163909,2022,China,Korea,0,0,0,0,03/07/2022,0,1,1,2,0,0,0,0,0,0,0,0,1,0,4,5,12,0,5,17
4239,163909,2022,China,Dominican Republic,0,0,0,0,01/07/2022,1,0,0,1,0,0,0,0,0,0,0,0,0,0,0,0,5,1,0,6
4240,163909,2022,Poland,China,0,0,0,0,30/06/2022,0,0,0,0,0,0,0,0,0,0,0,0,0,0,0,0,0,0,0,0
4241,163909,2022,China,Brazil,0,0,0,0,28/06/2022,1,0,4,5,0,0,0,0,0,0,0,0,0,0,0,0,8,3,1,12
4242,163909,2022,Japan,China,0,0,0,0,19/06/2022,0,0,7,7,0,0,0,0,0,0,0,0,3,1,6,10,15,0,1,16
4243,163909,2022,USA,China,0,0,0,0,18/06/2022,0,0,0,0,0,0,0,0,0,0,0,0,0,0,0,0,0,0,0,0
4244,163909,2022,China,Canada,0,0,0,0,17/06/2022,0,0,5,5,0,0,0,0,0,0,0,0,1,1,7,9,13,2,0,15
4245,163909,2022,China,Belgium,0,0,0,0,15/06/2022,0,0,0,0,0,0,0,0,0,0,0,0,0,0,0,0,0,0,0,0
4246,163909,2022,Thailand,China,0,0,0,0,05/06/2022,1,0,2,3,0,0,0,0,0,0,0,0,0,0,0,0,10,0,0,10
4247,163909,2022,China,Italy,0,0,0,0,04/06/2022,0,0,2,2,0,0,0,0,0,0,0,0,0,0,0,0,2,0,1,3
4248,163909,2022,Türkiye,China,0,0,0,0,03/06/2022,0,0,0,0,0,0,0,0,0,0,0,0,0,0,0,0,0,0,0,0
4249,163909,2022,China,Netherlands,0,0,0,0,01/06/2022,0,0,0,0,0,0,0,0,0,0,0,0,0,0,0,0,0,0,0,0
4250,173642,2022,Thailand,China,0,0,1,1,05/06/2022,0,0,0,0,0,1,0,1,0,0,0,0,0,0,1,1,0,0,0,0
4251,173642,2022,China,Italy,0,0,0,0,04/06/2022,0,0,0,0,0,0,0,0,0,0,0,0,0,0,0,0,0,0,0,0
4252,173642,2022,Türkiye,China,0,0,0,0,03/06/2022,0,0,0,0,0,0,0,0,0,0,0,0,0,0,0,0,0,0,0,0
4253,173642,2022,China,Netherlands,0,0,0,0,01/06/2022,0,0,0,0,0,0,0,0,0,0,0,0,0,0,0,0,0,0,0,0
4254,162977,2022,Italy,China,0,0,0,0,14/07/2022,0,0,0,0,0,0,1,1,1,0,0,1,0,0,0,0,0,0,0,0
4255,162977,2022,China,Korea,0,0,0,0,03/07/2022,0,0,0,0,0,0,0,0,0,0,0,0,0,0,0,0,0,0,0,0
4256,162977,2022,China,Dominican Republic,0,0,0,0,01/07/2022,0,0,0,0,0,0,0,0,0,0,0,0,0,0,0,0,0,0,0,0
4257,162977,2022,Poland,China,0,0,2,2,30/06/2022,0,0,1,1,0,0,1,1,0,0,0,0,0,0,0,0,0,0,0,0
4258,162977,2022,China,Brazil,0,0,0,0,28/06/2022,0,0,0,0,1,0,2,3,0,1,0,1,0,0,0,0,0,0,0,0
4259,162977,2022,Japan,China,0,0,0,0,19/06/2022,0,0,0,0,0,0,0,0,0,0,0,0,0,0,0,0,0,0,0,0
4260,162977,2022,USA,China,0,0,0,0,18/06/2022,0,0,0,0,0,0,0,0,0,0,0,0,0,0,0,0,0,0,0,0
4261,162977,2022,China,Canada,0,0,0,0,17/06/2022,0,0,0,0,0,0,0,0,0,0,0,0,0,0,0,0,0,0,0,0
4262,162977,2022,China,Belgium,0,0,0,0,15/06/2022,0,0,0,0,0,0,0,0,0,0,0,0,0,0,0,0,0,0,0,0
4263,175119,2022,,,-,-,-,-,-,-,-,-,-,-,-,-,-,-,-,-,-,-,-,-,-,-,-,-,-
4264,189173,2022,,,-,-,-,-,-,-,-,-,-,-,-,-,-,-,-,-,-,-,-,-,-,-,-,-,-
4265,152329,2022,,,-,-,-,-,-,-,-,-,-,-,-,-,-,-,-,-,-,-,-,-,-,-,-,-,-
4266,135745,2022,,,-,-,-,-,-,-,-,-,-,-,-,-,-,-,-,-,-,-,-,-,-,-,-,-,-
4267,152920,2022,,,-,-,-,-,-,-,-,-,-,-,-,-,-,-,-,-,-,-,-,-,-,-,-,-,-
4268,143198,2022,,,-,-,-,-,-,-,-,-,-,-,-,-,-,-,-,-,-,-,-,-,-,-,-,-,-
4269,175121,2022,,,-,-,-,-,-,-,-,-,-,-,-,-,-,-,-,-,-,-,-,-,-,-,-,-,-
4270,158817,2022,Germany,Dominican Republic,0,0,0,0,19/06/2022,0,1,12,13,0,0,0,0,0,0,0,0,7,2,15,24,9,5,2,16
4271,158817,2022,Netherlands,Dominican Republic,0,0,0,0,18/06/2022,0,0,13,13,0,0,0,0,0,0,0,0,7,2,9,18,7,11,2,20
4272,158817,2022,Italy,Dominican Republic,0,0,0,0,16/06/2022,0,0,13,13,0,0,0,0,0,0,0,0,9,0,9,18,10,4,1,15
4273,158817,2022,Dominican Republic,Korea,0,0,0,0,15/06/2022,0,0,4,4,0,0,0,0,0,0,0,0,2,1,4,7,9,3,1,13
4274,158817,2022,Dominican Republic,Japan,0,0,0,0,04/06/2022,0,0,0,0,0,0,0,0,0,0,0,0,0,0,0,0,0,0,0,0
4275,158817,2022,Dominican Republic,Brazil,0,0,0,0,03/06/2022,0,0,4,4,0,0,0,0,0,0,0,0,8,2,1,11,6,3,0,9
4276,158817,2022,Canada,Dominican Republic,0,0,0,0,03/06/2022,0,0,1,1,0,0,0,0,0,0,0,0,5,2,1,8,4,1,0,5
4277,158817,2022,USA,Dominican Republic,0,0,0,0,01/06/2022,0,0,0,0,0,0,0,0,0,0,0,0,0,0,0,0,0,0,0,0
4278,168727,2022,Germany,Dominican Republic,0,0,0,0,19/06/2022,0,0,0,0,0,0,0,0,0,0,0,0,0,0,0,0,0,0,0,0
4279,168727,2022,Netherlands,Dominican Republic,0,0,0,0,18/06/2022,0,0,0,0,0,0,0,0,0,0,0,0,0,0,0,0,0,0,0,0
4280,168727,2022,Italy,Dominican Republic,0,0,0,0,16/06/2022,0,0,0,0,0,0,0,0,0,0,0,0,0,0,0,0,0,0,0,0
4281,168727,2022,Dominican Republic,Korea,0,0,0,0,15/06/2022,0,0,0,0,0,0,0,0,0,0,0,0,0,0,0,0,0,0,0,0
4282,168727,2022,Dominican Republic,Japan,0,0,1,1,04/06/2022,0,0,0,0,0,0,0,0,0,0,0,0,0,0,0,0,0,0,0,0
4283,168727,2022,Dominican Republic,Brazil,0,0,0,0,03/06/2022,0,0,0,0,0,0,0,0,0,0,0,0,0,0,0,0,0,0,0,0
4284,168727,2022,Canada,Dominican Republic,0,0,0,0,03/06/2022,0,0,0,0,0,0,0,0,0,0,0,0,0,0,0,0,0,0,0,0
4285,168727,2022,USA,Dominican Republic,0,1,3,4,01/06/2022,0,0,0,0,1,2,0,3,1,1,0,2,0,0,0,0,1,0,0,1
4286,151087,2022,Dominican Republic,Poland,0,0,1,1,02/07/2022,0,0,0,0,4,2,3,9,0,0,0,0,0,0,2,2,1,0,0,1
4287,151087,2022,China,Dominican Republic,0,1,7,8,01/07/2022,2,0,0,2,8,2,7,17,0,1,0,1,2,1,14,17,0,0,1,1
4288,151087,2022,Thailand,Dominican Republic,0,0,2,2,30/06/2022,0,0,0,0,0,0,0,0,0,0,0,0,1,0,0,1,0,0,0,0
4289,151087,2022,Dominican Republic,Bulgaria,0,1,4,5,28/06/2022,0,0,0,0,3,2,4,9,0,0,0,0,3,0,7,10,3,2,1,6
4290,151087,2022,Germany,Dominican Republic,0,0,1,1,19/06/2022,0,0,0,0,0,0,3,3,0,0,1,1,1,0,1,2,0,0,0,0
4291,151087,2022,Netherlands,Dominican Republic,0,1,4,5,18/06/2022,0,0,0,0,1,0,0,1,0,0,1,1,1,0,2,3,0,1,0,1
4292,151087,2022,Italy,Dominican Republic,0,0,1,1,16/06/2022,0,0,0,0,3,0,1,4,0,1,1,2,1,0,2,3,1,0,1,2
4293,151087,2022,Dominican Republic,Korea,0,0,1,1,15/06/2022,0,0,0,0,0,0,3,3,0,0,0,0,0,0,4,4,1,0,0,1
4294,151087,2022,Dominican Republic,Japan,0,0,8,8,04/06/2022,0,0,1,1,7,4,18,29,1,2,1,4,17,1,13,31,11,3,1,15
4295,151087,2022,Dominican Republic,Brazil,2,0,8,10,03/06/2022,0,0,5,5,5,4,14,23,0,0,1,1,11,1,19,31,4,2,0,6
4296,151087,2022,Canada,Dominican Republic,0,0,4,4,03/06/2022,0,0,0,0,2,0,6,8,0,1,0,1,3,1,3,7,3,0,0,3
4297,151087,2022,USA,Dominican Republic,0,0,3,3,01/06/2022,0,0,1,1,4,0,2,6,1,2,0,3,10,1,12,23,4,2,0,6
4298,119039,2022,,,-,-,-,-,-,-,-,-,-,-,-,-,-,-,-,-,-,-,-,-,-,-,-,-,-
4299,119545,2022,Dominican Republic,Poland,0,0,0,0,02/07/2022,0,0,0,0,0,0,0,0,0,0,0,0,0,0,0,0,0,0,0,0
4300,119545,2022,China,Dominican Republic,0,0,5,5,01/07/2022,41,0,3,44,1,0,1,2,0,1,0,1,0,0,1,1,1,1,1,3
4301,119545,2022,Thailand,Dominican Republic,0,0,0,0,30/06/2022,0,0,0,0,0,0,0,0,0,0,0,0,0,0,0,0,0,0,0,0
4302,119545,2022,Dominican Republic,Bulgaria,0,0,1,1,28/06/2022,0,0,0,0,0,0,0,0,0,0,0,0,0,0,0,0,0,0,0,0
4303,119545,2022,Germany,Dominican Republic,0,0,0,0,19/06/2022,1,0,5,6,0,0,0,0,0,0,0,0,0,0,0,0,0,0,0,0
4304,119545,2022,Netherlands,Dominican Republic,0,0,0,0,18/06/2022,2,0,8,10,0,0,0,0,0,0,0,0,0,0,0,0,0,0,1,1
4305,119545,2022,Italy,Dominican Republic,0,0,2,2,16/06/2022,0,0,6,6,0,1,0,1,0,0,0,0,0,0,0,0,0,0,0,0
4306,119545,2022,Dominican Republic,Korea,0,0,0,0,15/06/2022,0,0,0,0,0,0,0,0,0,0,0,0,0,0,0,0,0,0,0,0
4307,119545,2022,Dominican Republic,Japan,0,0,0,0,04/06/2022,1,0,28,29,0,0,0,0,0,0,0,0,0,0,0,0,1,0,1,2
4308,119545,2022,Dominican Republic,Brazil,0,0,0,0,03/06/2022,0,0,5,5,0,0,0,0,0,0,0,0,0,0,0,0,1,1,0,2
4309,119545,2022,Canada,Dominican Republic,0,0,0,0,03/06/2022,0,0,9,9,0,0,0,0,0,0,0,0,0,0,0,0,0,0,0,0
4310,119545,2022,USA,Dominican Republic,0,0,0,0,01/06/2022,0,0,4,4,0,0,0,0,0,0,0,0,0,0,0,0,0,0,0,0
4311,119585,2022,Dominican Republic,Poland,0,2,16,18,02/07/2022,10,1,137,148,1,1,2,4,1,5,6,12,0,0,0,0,9,0,1,10
4312,119585,2022,China,Dominican Republic,0,0,3,3,01/07/2022,31,0,1,32,0,0,0,0,0,1,0,1,0,0,0,0,0,0,1,1
4313,119585,2022,Thailand,Dominican Republic,0,0,10,10,30/06/2022,94,1,2,97,0,0,0,0,0,2,3,5,0,0,0,0,4,5,4,13
4314,119585,2022,Dominican Republic,Bulgaria,0,1,6,7,28/06/2022,48,2,1,51,0,0,2,2,1,4,2,7,0,0,0,0,2,0,0,2
4315,119585,2022,Germany,Dominican Republic,0,2,10,12,19/06/2022,18,1,78,97,0,1,2,3,0,2,1,3,0,0,0,0,5,2,1,8
4316,119585,2022,Netherlands,Dominican Republic,1,0,17,18,18/06/2022,33,0,86,119,3,0,2,5,1,3,3,7,0,0,0,0,7,3,2,12
4317,119585,2022,Italy,Dominican Republic,2,1,13,16,16/06/2022,22,0,84,106,1,1,3,5,0,5,4,9,0,0,0,0,6,1,1,8
4318,119585,2022,Dominican Republic,Korea,0,0,14,14,15/06/2022,14,1,53,68,1,0,1,2,0,1,4,5,0,0,0,0,1,1,0,2
4319,119585,2022,Dominican Republic,Japan,1,1,7,9,04/06/2022,12,1,75,88,0,2,3,5,0,1,1,2,0,0,0,0,9,1,0,10
4320,119585,2022,Dominican Republic,Brazil,0,0,6,6,03/06/2022,7,0,76,83,1,0,4,5,0,2,3,5,1,0,0,1,10,2,0,12
4321,119585,2022,Canada,Dominican Republic,0,1,5,6,03/06/2022,4,0,70,74,1,0,2,3,0,0,1,1,0,0,0,0,4,0,0,4
4322,119585,2022,USA,Dominican Republic,0,1,8,9,01/06/2022,5,0,67,72,3,0,1,4,0,0,1,1,0,0,0,0,7,1,0,8
4323,143961,2022,Dominican Republic,Poland,0,0,9,9,02/07/2022,0,0,0,0,2,0,3,5,4,1,0,5,0,0,0,0,1,1,2,4
4324,143961,2022,China,Dominican Republic,0,1,4,5,01/07/2022,0,0,0,0,0,0,3,3,0,3,1,4,0,0,1,1,0,0,0,0
4325,143961,2022,Thailand,Dominican Republic,1,2,7,10,30/06/2022,0,0,0,0,0,0,1,1,4,1,1,6,0,0,0,0,1,0,0,1
4326,143961,2022,Dominican Republic,Bulgaria,0,0,0,0,28/06/2022,0,0,0,0,0,0,0,0,0,0,0,0,0,0,0,0,0,0,0,0
4327,143961,2022,Germany,Dominican Republic,0,0,1,1,19/06/2022,0,0,0,0,1,0,0,1,0,1,0,1,0,0,0,0,1,0,0,1
4328,143961,2022,Netherlands,Dominican Republic,0,0,0,0,18/06/2022,0,0,1,1,0,0,0,0,0,0,0,0,0,0,0,0,1,1,0,2
4329,143961,2022,Italy,Dominican Republic,0,0,0,0,16/06/2022,0,0,1,1,0,0,0,0,0,1,0,1,0,0,0,0,0,0,0,0
4330,143961,2022,Dominican Republic,Korea,0,0,0,0,15/06/2022,0,0,0,0,0,0,0,0,0,0,0,0,0,0,0,0,0,0,0,0
4331,143961,2022,Dominican Republic,Japan,0,0,0,0,04/06/2022,0,0,0,0,0,0,0,0,0,0,0,0,0,0,0,0,0,0,0,0
4332,143961,2022,Dominican Republic,Brazil,0,0,0,0,03/06/2022,0,0,0,0,0,0,0,0,0,0,0,0,0,0,0,0,0,0,0,0
4333,143961,2022,Canada,Dominican Republic,0,2,2,4,03/06/2022,0,0,0,0,1,0,3,4,0,1,0,1,0,1,0,1,2,0,0,2
4334,143961,2022,USA,Dominican Republic,0,0,0,0,01/06/2022,0,0,0,0,0,0,0,0,0,0,0,0,0,0,0,0,0,0,0,0
4335,139912,2022,Dominican Republic,Poland,0,0,0,0,02/07/2022,0,0,0,0,0,0,0,0,0,0,0,0,0,0,0,0,0,0,0,0
4336,139912,2022,China,Dominican Republic,0,0,2,2,01/07/2022,6,1,1,8,0,0,0,0,0,0,0,0,0,0,0,0,1,0,1,2
4337,139912,2022,Thailand,Dominican Republic,0,0,0,0,30/06/2022,0,0,0,0,0,0,0,0,0,0,0,0,0,0,0,0,0,0,0,0
4338,139912,2022,Dominican Republic,Bulgaria,0,0,0,0,28/06/2022,0,0,0,0,0,0,0,0,0,0,0,0,0,0,0,0,0,0,0,0
4339,139911,2022,Dominican Republic,Poland,0,0,0,0,02/07/2022,0,0,0,0,0,0,0,0,0,0,0,0,0,0,0,0,0,0,0,0
4340,139911,2022,China,Dominican Republic,0,1,0,1,01/07/2022,0,0,0,0,2,3,1,6,0,3,0,3,0,0,4,4,2,0,1,3
4341,139911,2022,Thailand,Dominican Republic,0,0,0,0,30/06/2022,0,0,0,0,0,0,0,0,0,0,0,0,0,0,0,0,0,0,0,0
4342,139911,2022,Dominican Republic,Bulgaria,0,0,0,0,28/06/2022,0,0,0,0,0,0,0,0,0,0,0,0,0,0,0,0,0,0,0,0
4343,149531,2022,Germany,Dominican Republic,0,0,3,3,19/06/2022,0,0,0,0,0,1,0,1,0,0,0,0,0,1,1,2,0,0,0,0
4344,149531,2022,Netherlands,Dominican Republic,0,1,15,16,18/06/2022,0,0,0,0,10,1,5,16,0,0,2,2,4,0,6,10,7,1,2,10
4345,149531,2022,Italy,Dominican Republic,0,1,7,8,16/06/2022,0,0,0,0,0,0,0,0,0,0,0,0,0,0,0,0,0,1,0,1
4346,149531,2022,Dominican Republic,Korea,0,1,3,4,15/06/2022,0,0,0,0,0,0,0,0,0,0,0,0,0,0,0,0,0,0,0,0
4347,149531,2022,Dominican Republic,Japan,0,1,2,3,04/06/2022,0,0,0,0,1,1,4,6,0,1,1,2,5,0,1,6,2,1,0,3
4348,149531,2022,Dominican Republic,Brazil,0,1,5,6,03/06/2022,0,0,0,0,1,4,2,7,0,1,0,1,2,0,4,6,3,1,0,4
4349,149531,2022,Canada,Dominican Republic,0,1,10,11,03/06/2022,0,0,4,4,11,4,14,29,1,1,1,3,11,0,7,18,6,1,1,8
4350,149531,2022,USA,Dominican Republic,0,0,6,6,01/06/2022,0,0,0,0,2,5,4,11,0,0,0,0,8,3,14,25,7,0,0,7
4351,123978,2022,Dominican Republic,Poland,2,1,11,14,02/07/2022,0,0,4,4,13,8,18,39,0,6,2,8,5,4,16,25,8,2,5,15
4352,123978,2022,China,Dominican Republic,1,1,7,9,01/07/2022,2,0,0,2,11,8,11,30,3,2,1,6,2,2,24,28,2,2,2,6
4353,123978,2022,Thailand,Dominican Republic,1,2,15,18,30/06/2022,3,0,1,4,18,6,16,40,0,4,3,7,5,1,19,25,8,1,3,12
4354,123978,2022,Dominican Republic,Bulgaria,0,0,6,6,28/06/2022,1,1,0,2,3,2,11,16,0,0,0,0,2,2,21,25,1,0,0,1
4355,123978,2022,Germany,Dominican Republic,0,2,14,16,19/06/2022,0,0,2,2,16,8,11,35,2,1,4,7,3,0,13,16,10,0,2,12
4356,123978,2022,Netherlands,Dominican Republic,0,0,20,20,18/06/2022,0,0,6,6,14,5,17,36,0,3,3,6,7,0,25,32,11,3,1,15
4357,123978,2022,Italy,Dominican Republic,0,4,13,17,16/06/2022,0,0,5,5,19,9,15,43,1,1,3,5,22,1,18,41,4,1,2,7
4358,123978,2022,Dominican Republic,Korea,2,3,9,14,15/06/2022,0,0,0,0,19,4,9,32,1,1,1,3,5,0,8,13,11,0,0,11
4359,123978,2022,Dominican Republic,Japan,1,1,12,14,04/06/2022,0,0,5,5,16,2,28,46,2,0,1,3,25,2,5,32,16,3,0,19
4360,123978,2022,Dominican Republic,Brazil,1,3,11,15,03/06/2022,0,0,3,3,15,6,26,47,1,1,1,3,8,1,9,18,12,4,0,16
4361,123978,2022,Canada,Dominican Republic,2,3,4,9,03/06/2022,0,0,3,3,6,6,12,24,1,1,0,2,16,2,3,21,8,2,0,10
4362,123978,2022,USA,Dominican Republic,0,0,11,11,01/06/2022,0,0,6,6,9,6,17,32,0,0,2,2,5,0,4,9,5,1,0,6
4363,115391,2022,Germany,Dominican Republic,0,0,1,1,19/06/2022,0,0,0,0,0,0,2,2,0,1,1,2,0,0,0,0,0,0,0,0
4364,115391,2022,Netherlands,Dominican Republic,0,0,0,0,18/06/2022,0,0,0,0,0,0,0,0,0,0,0,0,0,0,0,0,0,0,0,0
4365,115391,2022,Italy,Dominican Republic,0,1,0,1,16/06/2022,0,0,3,3,1,0,0,1,0,1,0,1,0,0,0,0,1,0,0,1
4366,115391,2022,Dominican Republic,Korea,0,0,0,0,15/06/2022,0,0,0,0,0,0,0,0,0,0,0,0,0,0,0,0,0,0,0,0
4367,115391,2022,Dominican Republic,Japan,0,2,1,3,04/06/2022,0,0,1,1,2,1,6,9,0,1,1,2,0,0,0,0,2,0,0,2
4368,115391,2022,Dominican Republic,Brazil,0,0,2,2,03/06/2022,0,0,1,1,0,0,0,0,0,0,0,0,0,0,0,0,0,0,0,0
4369,115391,2022,Canada,Dominican Republic,0,0,1,1,03/06/2022,0,0,0,0,0,0,2,2,0,1,0,1,0,0,0,0,0,1,0,1
4370,115391,2022,USA,Dominican Republic,0,0,1,1,01/06/2022,0,0,0,0,2,0,2,4,0,1,1,2,0,0,0,0,0,0,0,0
4371,114294,2022,,,-,-,-,-,-,-,-,-,-,-,-,-,-,-,-,-,-,-,-,-,-,-,-,-,-
4372,119224,2022,,,-,-,-,-,-,-,-,-,-,-,-,-,-,-,-,-,-,-,-,-,-,-,-,-,-
4373,123982,2022,Dominican Republic,Poland,1,2,16,19,02/07/2022,0,0,4,4,19,7,16,42,3,5,2,10,2,1,24,27,14,2,3,19
4374,123982,2022,China,Dominican Republic,0,1,1,2,01/07/2022,0,0,0,0,4,1,6,11,1,1,0,2,0,1,11,12,4,0,1,5
4375,123982,2022,Thailand,Dominican Republic,0,2,15,17,30/06/2022,3,0,0,3,19,3,20,42,0,3,3,6,3,3,16,22,11,4,0,15
4376,123982,2022,Dominican Republic,Bulgaria,0,2,11,13,28/06/2022,0,0,0,0,3,4,9,16,0,1,0,1,1,1,7,9,2,0,1,3
4377,123982,2022,Germany,Dominican Republic,0,3,6,9,19/06/2022,0,0,3,3,9,4,18,31,0,1,5,6,8,2,18,28,5,2,1,8
4378,123982,2022,Netherlands,Dominican Republic,1,1,8,10,18/06/2022,0,1,4,5,21,3,25,49,1,1,8,10,2,0,23,25,10,5,4,19
4379,123982,2022,Italy,Dominican Republic,0,3,10,13,16/06/2022,0,0,5,5,15,3,18,36,2,1,6,9,6,0,18,24,9,0,4,13
4380,123982,2022,Dominican Republic,Korea,0,2,11,13,15/06/2022,0,0,3,3,10,0,6,16,0,1,1,2,2,0,7,9,3,2,1,6
4381,123982,2022,Dominican Republic,Japan,0,0,0,0,04/06/2022,0,0,0,0,0,0,0,0,0,0,0,0,0,0,0,0,0,0,0,0
4382,123982,2022,Dominican Republic,Brazil,0,0,0,0,03/06/2022,0,0,0,0,0,0,0,0,0,0,0,0,0,0,0,0,0,0,0,0
4383,123982,2022,Canada,Dominican Republic,0,0,0,0,03/06/2022,0,0,0,0,0,0,0,0,0,0,0,0,0,0,0,0,0,0,0,0
4384,123982,2022,USA,Dominican Republic,0,0,0,0,01/06/2022,0,0,0,0,0,0,0,0,0,0,0,0,0,0,0,0,0,0,0,0
4385,139910,2022,Dominican Republic,Poland,1,1,18,20,02/07/2022,0,0,0,0,9,2,9,20,2,13,5,20,0,1,2,3,4,0,1,5
4386,139910,2022,China,Dominican Republic,0,0,2,2,01/07/2022,0,0,0,0,0,0,5,5,1,1,0,2,0,0,0,0,0,0,0,0
4387,139910,2022,Thailand,Dominican Republic,0,2,15,17,30/06/2022,2,0,0,2,11,4,9,24,2,2,1,5,0,0,0,0,3,0,1,4
4388,139910,2022,Dominican Republic,Bulgaria,0,0,5,5,28/06/2022,3,0,0,3,8,1,4,13,1,4,0,5,0,1,0,1,1,0,0,1
4389,139910,2022,Germany,Dominican Republic,0,2,14,16,19/06/2022,0,0,1,1,8,1,8,17,8,4,10,22,0,0,0,0,1,1,0,2
4390,139910,2022,Netherlands,Dominican Republic,1,3,14,18,18/06/2022,0,0,3,3,9,1,8,18,2,5,5,12,0,0,1,1,3,0,2,5
4391,139910,2022,Italy,Dominican Republic,2,0,16,18,16/06/2022,0,0,0,0,7,1,5,13,2,4,4,10,0,0,0,0,1,0,0,1
4392,139910,2022,Dominican Republic,Korea,0,2,4,6,15/06/2022,0,0,1,1,3,0,3,6,1,2,7,10,0,0,0,0,2,0,0,2
4393,139910,2022,Dominican Republic,Japan,0,0,14,14,04/06/2022,0,0,5,5,3,2,10,15,2,5,6,13,1,0,0,1,9,1,0,10
4394,139910,2022,Dominican Republic,Brazil,0,2,8,10,03/06/2022,0,0,2,2,5,1,2,8,1,0,2,3,0,0,0,0,1,1,0,2
4395,139910,2022,Canada,Dominican Republic,1,1,5,7,03/06/2022,0,0,0,0,4,1,4,9,1,5,4,10,0,0,0,0,1,1,0,2
4396,139910,2022,USA,Dominican Republic,0,0,4,4,01/06/2022,0,0,3,3,0,1,3,4,3,0,2,5,0,0,0,0,2,0,0,2
4397,162342,2022,Dominican Republic,Poland,0,0,5,5,02/07/2022,0,0,1,1,0,0,0,0,0,0,0,0,2,0,3,5,5,1,0,6
4398,162342,2022,China,Dominican Republic,0,0,0,0,01/07/2022,0,0,0,0,0,0,0,0,0,0,0,0,0,0,2,2,2,0,3,5
4399,162342,2022,Thailand,Dominican Republic,0,0,0,0,30/06/2022,0,0,0,0,0,0,0,0,0,0,0,0,0,0,0,0,0,0,0,0
4400,162342,2022,Dominican Republic,Bulgaria,0,0,3,3,28/06/2022,0,0,0,0,0,0,0,0,0,0,0,0,0,0,2,2,0,0,0,0
4401,139927,2022,Dominican Republic,Poland,0,5,14,19,02/07/2022,0,0,1,1,21,9,14,44,2,6,3,11,1,0,2,3,5,2,2,9
4402,139927,2022,China,Dominican Republic,2,1,4,7,01/07/2022,0,0,0,0,8,5,8,21,0,1,1,2,0,0,0,0,2,2,2,6
4403,139927,2022,Thailand,Dominican Republic,2,3,14,19,30/06/2022,0,0,0,0,15,3,15,33,1,5,2,8,0,0,0,0,5,1,1,7
4404,139927,2022,Dominican Republic,Bulgaria,0,1,6,7,28/06/2022,0,0,0,0,8,6,9,23,2,4,2,8,0,0,0,0,0,0,2,2
4405,139927,2022,Germany,Dominican Republic,1,3,11,15,19/06/2022,0,0,1,1,15,2,9,26,1,1,4,6,2,1,4,7,6,5,0,11
4406,139927,2022,Netherlands,Dominican Republic,0,1,4,5,18/06/2022,0,0,1,1,8,5,10,23,2,4,2,8,1,0,0,1,5,2,1,8
4407,139927,2022,Italy,Dominican Republic,0,3,11,14,16/06/2022,0,0,1,1,13,9,11,33,3,1,2,6,1,0,0,1,4,2,1,7
4408,139927,2022,Dominican Republic,Korea,0,2,10,12,15/06/2022,0,0,2,2,8,6,4,18,1,4,0,5,0,0,0,0,5,0,0,5
4409,139927,2022,Dominican Republic,Japan,0,1,8,9,04/06/2022,0,0,0,0,10,8,13,31,4,2,1,7,0,0,0,0,6,2,0,8
4410,139927,2022,Dominican Republic,Brazil,2,1,9,12,03/06/2022,0,0,2,2,12,7,10,29,2,4,1,7,1,0,1,2,6,1,0,7
4411,139927,2022,Canada,Dominican Republic,2,1,5,8,03/06/2022,0,0,0,0,1,4,10,15,1,1,2,4,0,0,0,0,4,1,0,5
4412,139927,2022,USA,Dominican Republic,0,1,9,10,01/06/2022,0,0,1,1,7,5,21,33,0,0,3,3,1,0,0,1,12,2,2,16
4413,149530,2022,Dominican Republic,Poland,0,1,5,6,02/07/2022,0,0,2,2,0,1,2,3,0,0,0,0,0,0,0,0,1,0,0,1
4414,149530,2022,China,Dominican Republic,0,1,6,7,01/07/2022,4,1,0,5,1,1,2,4,0,4,1,5,0,0,1,1,1,0,2,3
4415,149530,2022,Thailand,Dominican Republic,0,0,3,3,30/06/2022,0,0,0,0,1,1,0,2,1,2,3,6,0,0,0,0,0,0,1,1
4416,149530,2022,Dominican Republic,Bulgaria,0,1,3,4,28/06/2022,0,0,0,0,4,3,1,8,0,0,0,0,0,0,0,0,0,0,0,0
4417,149530,2022,Germany,Dominican Republic,0,2,9,11,19/06/2022,0,1,2,3,2,1,0,3,0,0,5,5,0,0,2,2,1,1,0,2
4418,149530,2022,Netherlands,Dominican Republic,0,2,8,10,18/06/2022,0,0,1,1,3,3,4,10,2,2,6,10,0,0,0,0,0,1,3,4
4419,149530,2022,Italy,Dominican Republic,0,3,11,14,16/06/2022,0,0,4,4,5,1,0,6,3,3,3,9,0,1,1,2,1,0,0,1
4420,149530,2022,Dominican Republic,Korea,0,0,9,9,15/06/2022,0,0,0,0,0,1,1,2,3,4,4,11,0,0,0,0,0,0,0,0
4421,149530,2022,Dominican Republic,Japan,1,3,9,13,04/06/2022,0,0,1,1,3,2,4,9,4,6,3,13,0,0,1,1,3,0,0,3
4422,149530,2022,Dominican Republic,Brazil,0,4,5,9,03/06/2022,0,0,2,2,3,2,2,7,0,4,4,8,0,0,0,0,2,0,1,3
4423,149530,2022,Canada,Dominican Republic,0,0,3,3,03/06/2022,0,0,3,3,0,0,4,4,0,1,0,1,0,1,0,1,0,0,0,0
4424,149530,2022,USA,Dominican Republic,0,1,9,10,01/06/2022,0,0,4,4,4,1,2,7,2,4,2,8,0,0,0,0,2,0,0,2
4425,139913,2022,Dominican Republic,Poland,0,0,0,0,02/07/2022,0,0,6,6,0,0,0,0,0,0,0,0,8,2,27,37,10,3,1,14
4426,139913,2022,China,Dominican Republic,0,0,0,0,01/07/2022,4,0,0,4,0,0,0,0,0,0,0,0,0,1,6,7,4,0,5,9
4427,139913,2022,Thailand,Dominican Republic,0,0,0,0,30/06/2022,7,0,1,8,0,0,0,0,0,0,0,0,7,2,25,34,16,4,4,24
4428,139913,2022,Dominican Republic,Bulgaria,0,0,0,0,28/06/2022,0,0,0,0,0,0,0,0,0,0,0,0,1,1,18,20,0,2,1,3
4429,139913,2022,Germany,Dominican Republic,0,0,2,2,19/06/2022,0,0,0,0,0,0,0,0,0,0,0,0,0,0,4,4,0,0,0,0
4430,139913,2022,Netherlands,Dominican Republic,0,0,0,0,18/06/2022,0,0,0,0,0,0,0,0,0,0,0,0,0,0,0,0,0,0,0,0
4431,139913,2022,Italy,Dominican Republic,0,0,0,0,16/06/2022,0,0,0,0,0,0,0,0,0,0,0,0,0,0,0,0,0,0,0,0
4432,139913,2022,Dominican Republic,Korea,0,0,0,0,15/06/2022,0,0,0,0,0,0,0,0,0,0,0,0,0,0,0,0,0,0,0,0
4433,139913,2022,Dominican Republic,Japan,0,0,0,0,04/06/2022,0,0,12,12,0,0,0,0,0,0,0,0,8,0,6,14,17,5,1,23
4434,139913,2022,Dominican Republic,Brazil,0,0,0,0,03/06/2022,0,0,5,5,0,0,0,0,0,0,0,0,6,2,9,17,11,4,0,15
4435,139913,2022,Canada,Dominican Republic,0,0,0,0,03/06/2022,0,0,1,1,0,0,0,0,0,0,0,0,4,1,6,11,8,2,0,10
4436,139913,2022,USA,Dominican Republic,0,0,0,0,01/06/2022,0,0,6,6,0,0,0,0,0,0,0,0,4,0,4,8,10,2,0,12
4437,152140,2022,Germany,Dominican Republic,0,0,0,0,19/06/2022,0,0,0,0,0,0,0,0,0,0,0,0,0,0,0,0,0,0,0,0
4438,152140,2022,Germany,Türkiye,0,0,0,0,18/06/2022,0,0,0,0,0,0,0,0,0,0,0,0,0,0,0,0,1,1,0,2
4439,152140,2022,Germany,Italy,0,0,0,0,17/06/2022,0,0,0,0,0,0,0,0,0,0,0,0,0,0,0,0,0,0,0,0
4440,152140,2022,Netherlands,Germany,0,0,0,0,14/06/2022,0,0,0,0,0,0,0,0,0,0,0,0,0,0,0,0,0,0,0,0
4441,152140,2022,Poland,Germany,0,0,0,0,05/06/2022,0,0,0,0,0,0,0,0,0,0,0,0,0,0,0,0,0,0,0,0
4442,152140,2022,Germany,Korea,0,0,0,0,03/06/2022,0,0,0,0,0,0,0,0,0,0,0,0,1,0,2,3,2,1,0,3
4443,152140,2022,Germany,Japan,0,0,2,2,02/06/2022,0,0,0,0,1,0,0,1,0,0,0,0,0,0,2,2,2,1,0,3
4444,152140,2022,Germany,Brazil,0,0,0,0,31/05/2022,0,0,0,0,0,0,0,0,0,0,0,0,0,1,1,2,0,0,0,0
4445,150973,2022,USA,Germany,1,0,10,11,03/07/2022,5,0,102,107,0,1,1,2,0,2,1,3,0,0,0,0,15,2,0,17
4446,150973,2022,Germany,Canada,0,1,7,8,03/07/2022,6,0,86,92,1,0,1,2,0,1,5,6,0,0,1,1,7,1,0,8
4447,150973,2022,Germany,Belgium,1,0,12,13,30/06/2022,7,0,97,104,2,0,2,4,0,1,0,1,0,0,0,0,16,0,0,16
4448,150973,2022,Serbia,Germany,0,0,14,14,28/06/2022,19,0,84,103,0,0,1,1,0,1,2,3,0,0,0,0,10,1,0,11
4449,150973,2022,Germany,Dominican Republic,0,2,5,7,19/06/2022,32,0,71,103,1,0,0,1,0,3,4,7,0,0,0,0,3,2,1,6
4450,150973,2022,Germany,Türkiye,0,0,3,3,18/06/2022,12,0,33,45,0,0,0,0,0,2,0,2,0,0,0,0,0,0,0,0
4451,150973,2022,Germany,Italy,1,0,11,12,17/06/2022,19,0,55,74,1,1,0,2,1,2,2,5,0,0,0,0,1,2,3,6
4452,150973,2022,Netherlands,Germany,0,1,8,9,14/06/2022,9,0,30,39,1,0,0,1,0,0,0,0,0,0,0,0,4,0,2,6
4453,150973,2022,Poland,Germany,0,0,3,3,05/06/2022,4,0,27,31,1,0,1,2,0,1,0,1,0,0,0,0,2,0,1,3
4454,150973,2022,Germany,Korea,2,1,11,14,03/06/2022,16,0,51,67,1,0,0,1,0,3,2,5,0,0,0,0,6,0,0,6
4455,150973,2022,Germany,Japan,0,1,5,6,02/06/2022,19,0,37,56,1,1,1,3,0,0,3,3,0,0,0,0,1,3,0,4
4456,150973,2022,Germany,Brazil,2,0,11,13,31/05/2022,20,0,72,92,1,0,1,2,0,3,2,5,0,0,1,1,11,3,0,14
4457,136671,2022,USA,Germany,0,0,0,0,03/07/2022,0,0,11,11,0,0,0,0,0,0,0,0,8,0,9,17,10,1,0,11
4458,136671,2022,Germany,Canada,0,0,0,0,03/07/2022,0,0,9,9,0,0,0,0,0,0,0,0,12,0,8,20,12,3,0,15
4459,136671,2022,Germany,Belgium,0,0,0,0,30/06/2022,0,0,16,16,0,0,0,0,0,0,0,0,12,2,4,18,11,1,0,12
4460,136671,2022,Serbia,Germany,0,0,0,0,28/06/2022,1,0,12,13,0,0,0,0,0,0,0,0,2,0,8,10,7,3,0,10
4461,136671,2022,Germany,Dominican Republic,0,0,0,0,19/06/2022,0,0,9,9,0,0,0,0,0,0,0,0,15,0,12,27,11,4,2,17
4462,136671,2022,Germany,Türkiye,0,0,0,0,18/06/2022,0,0,3,3,0,0,0,0,0,0,0,0,2,0,2,4,4,3,0,7
4463,136671,2022,Germany,Italy,0,0,0,0,17/06/2022,0,0,5,5,0,0,0,0,0,0,0,0,8,0,6,14,3,7,4,14
4464,136671,2022,Netherlands,Germany,0,0,0,0,14/06/2022,0,0,0,0,0,0,0,0,0,0,0,0,7,1,10,18,9,7,0,16
4465,136671,2022,Poland,Germany,0,0,0,0,05/06/2022,0,0,11,11,0,0,0,0,0,0,0,0,20,2,11,33,20,7,0,27
4466,136671,2022,Germany,Korea,0,0,0,0,03/06/2022,0,0,6,6,0,0,0,0,0,0,0,0,12,4,5,21,13,4,0,17
4467,136671,2022,Germany,Japan,0,0,0,0,02/06/2022,0,0,17,17,0,0,0,0,0,0,0,0,35,2,15,52,26,5,0,31
4468,136671,2022,Germany,Brazil,0,0,0,0,31/05/2022,0,0,10,10,0,0,0,0,0,0,0,0,29,0,14,43,18,2,1,21
4469,163661,2022,USA,Germany,0,0,0,0,03/07/2022,0,0,0,0,0,0,0,0,0,0,0,0,0,0,0,0,0,0,0,0
4470,163661,2022,Germany,Canada,1,0,7,8,03/07/2022,0,0,14,14,0,0,0,0,0,1,0,1,0,0,0,0,4,0,0,4
4471,163661,2022,Germany,Belgium,0,0,0,0,30/06/2022,0,0,5,5,0,0,0,0,0,0,0,0,0,0,0,0,0,0,0,0
4472,163661,2022,Serbia,Germany,0,0,0,0,28/06/2022,0,0,0,0,0,0,0,0,0,0,0,0,0,0,0,0,0,0,0,0
4473,163661,2022,Germany,Dominican Republic,0,0,2,2,19/06/2022,7,1,5,13,1,0,1,2,0,1,0,1,0,0,0,0,3,0,0,3
4474,163661,2022,Germany,Türkiye,0,1,6,7,18/06/2022,8,0,30,38,0,0,0,0,0,0,3,3,0,0,0,0,2,2,1,5
4475,163661,2022,Germany,Italy,0,0,0,0,17/06/2022,0,0,4,4,0,0,0,0,0,0,0,0,0,0,0,0,0,0,0,0
4476,163661,2022,Netherlands,Germany,0,0,8,8,14/06/2022,23,0,81,104,0,0,0,0,1,2,1,4,0,0,0,0,7,2,0,9
4477,163661,2022,Poland,Germany,0,1,11,12,05/06/2022,17,1,74,92,0,0,1,1,0,2,0,2,0,0,0,0,9,4,0,13
4478,163661,2022,Germany,Korea,0,0,0,0,03/06/2022,0,0,0,0,0,0,0,0,0,0,0,0,0,0,0,0,0,0,0,0
4479,163661,2022,Germany,Japan,0,2,9,11,02/06/2022,19,0,67,86,0,0,1,1,0,1,0,1,0,0,0,0,13,4,0,17
4480,163661,2022,Germany,Brazil,0,0,5,5,31/05/2022,11,0,27,38,0,0,0,0,0,1,0,1,0,0,0,0,4,2,0,6
4481,123911,2022,USA,Germany,0,0,6,6,03/07/2022,0,0,2,2,3,2,5,10,0,0,0,0,5,0,4,9,7,1,1,9
4482,123911,2022,Germany,Canada,1,0,9,10,03/07/2022,0,0,5,5,6,2,12,20,0,3,2,5,7,0,5,12,11,3,0,14
4483,123911,2022,Germany,Belgium,0,1,21,22,30/06/2022,0,0,13,13,7,4,15,26,0,2,1,3,9,0,6,15,14,3,0,17
4484,123911,2022,Serbia,Germany,0,0,2,2,28/06/2022,0,0,1,1,3,1,5,9,1,0,0,1,2,0,8,10,4,0,0,4
4485,123911,2022,Germany,Dominican Republic,2,1,12,15,19/06/2022,0,0,2,2,7,7,14,28,0,1,0,1,9,0,9,18,6,1,0,7
4486,123911,2022,Germany,Türkiye,1,0,6,7,18/06/2022,0,0,1,1,3,1,6,10,0,2,2,4,5,0,7,12,3,2,2,7
4487,123911,2022,Germany,Italy,0,0,4,4,17/06/2022,0,0,0,0,1,1,0,2,0,0,1,1,1,0,2,3,1,0,1,2
4488,123911,2022,Netherlands,Germany,0,0,8,8,14/06/2022,0,0,0,0,4,2,6,12,0,0,0,0,5,0,3,8,1,0,1,2
4489,123911,2022,Poland,Germany,0,0,2,2,05/06/2022,0,0,2,2,0,0,0,0,0,0,0,0,5,0,2,7,5,3,0,8
4490,123911,2022,Germany,Korea,0,0,7,7,03/06/2022,0,0,1,1,0,2,8,10,0,2,0,2,2,0,2,4,5,1,0,6
4491,123911,2022,Germany,Japan,0,0,9,9,02/06/2022,0,0,1,1,2,4,6,12,0,0,1,1,5,0,1,6,9,0,0,9
4492,123911,2022,Germany,Brazil,1,2,19,22,31/05/2022,0,0,7,7,13,4,15,32,1,1,0,2,4,0,4,8,17,3,0,20
4493,168102,2022,USA,Germany,0,2,0,2,03/07/2022,0,0,2,2,3,3,3,9,0,0,2,2,1,0,2,3,0,2,0,2
4494,168102,2022,Germany,Canada,1,2,5,8,03/07/2022,0,0,2,2,13,3,18,34,1,3,0,4,1,0,1,2,8,2,0,10
4495,168102,2022,Germany,Belgium,0,0,0,0,30/06/2022,0,0,0,0,0,0,0,0,0,0,0,0,0,0,0,0,0,0,0,0
4496,168102,2022,Serbia,Germany,0,0,3,3,28/06/2022,0,0,0,0,1,1,2,4,0,2,1,3,1,0,3,4,2,0,0,2
4497,168102,2022,Germany,Dominican Republic,0,0,0,0,19/06/2022,0,0,0,0,0,0,0,0,0,0,0,0,0,0,0,0,0,0,0,0
4498,168102,2022,Germany,Türkiye,2,2,3,7,18/06/2022,0,0,0,0,8,9,12,29,3,3,0,6,11,0,19,30,4,3,0,7
4499,168102,2022,Germany,Italy,0,0,0,0,17/06/2022,0,0,0,0,0,1,0,1,0,0,0,0,0,0,0,0,0,0,0,0
4500,168102,2022,Netherlands,Germany,0,0,1,1,14/06/2022,0,0,0,0,0,1,1,2,0,0,0,0,0,0,0,0,1,1,0,2
4501,168102,2022,Poland,Germany,0,2,1,3,05/06/2022,0,0,0,0,7,1,11,19,0,2,2,4,4,1,4,9,7,2,1,10
4502,168102,2022,Germany,Korea,0,0,0,0,03/06/2022,0,0,0,0,0,0,1,1,0,0,0,0,0,0,0,0,0,0,0,0
4503,168102,2022,Germany,Japan,1,1,4,6,02/06/2022,0,0,0,0,7,3,10,20,1,0,1,2,8,1,1,10,7,3,0,10
4504,168102,2022,Germany,Brazil,0,2,4,6,31/05/2022,0,0,0,0,4,2,13,19,0,0,0,0,4,0,2,6,1,0,0,1
4505,163658,2022,USA,Germany,0,1,8,9,03/07/2022,0,0,8,8,7,3,12,22,0,0,0,0,3,1,7,11,7,3,0,10
4506,163658,2022,Germany,Canada,1,0,5,6,03/07/2022,0,0,3,3,1,4,5,10,0,0,0,0,7,0,5,12,3,3,0,6
4507,163658,2022,Germany,Belgium,1,3,7,11,30/06/2022,0,0,6,6,27,3,17,47,0,0,2,2,7,0,3,10,9,0,0,9
4508,163658,2022,Serbia,Germany,2,3,9,14,28/06/2022,0,0,3,3,9,4,11,24,1,2,1,4,2,2,30,34,5,1,2,8
4509,163658,2022,Germany,Dominican Republic,2,1,16,19,19/06/2022,0,0,2,2,9,6,6,21,0,0,1,1,6,0,3,9,11,3,1,15
4510,163658,2022,Germany,Italy,2,3,10,15,17/06/2022,0,0,3,3,7,1,8,16,2,0,1,3,12,1,18,31,4,3,1,8
4511,163658,2022,Netherlands,Germany,0,3,9,12,14/06/2022,0,1,1,2,14,0,12,26,0,3,3,6,18,3,8,29,4,2,2,8
4512,163658,2022,Poland,Germany,2,4,12,18,05/06/2022,0,0,3,3,17,7,15,39,2,2,1,5,9,0,7,16,16,4,0,20
4513,163658,2022,Germany,Korea,0,1,5,6,03/06/2022,0,0,1,1,4,0,7,11,1,1,0,2,1,1,3,5,10,0,0,10
4514,163658,2022,Germany,Japan,1,1,6,8,02/06/2022,0,0,6,6,13,2,22,37,2,1,0,3,4,0,7,11,11,1,0,12
4515,163658,2022,Germany,Brazil,0,3,3,6,31/05/2022,0,0,0,0,3,2,6,11,0,1,1,2,8,0,3,11,4,2,0,6
4516,144980,2022,USA,Germany,0,1,4,5,03/07/2022,0,0,3,3,6,3,10,19,0,0,1,1,5,1,8,14,5,0,0,5
4517,144980,2022,Germany,Canada,0,1,4,5,03/07/2022,0,0,0,0,0,0,0,0,0,0,0,0,2,0,5,7,3,0,0,3
4518,144980,2022,Germany,Belgium,0,1,12,13,30/06/2022,0,0,3,3,13,1,12,26,1,7,0,8,12,0,16,28,9,2,0,11
4519,144980,2022,Serbia,Germany,0,0,5,5,28/06/2022,0,0,2,2,6,2,8,16,1,2,4,7,4,0,6,10,7,1,0,8
4520,144980,2022,Germany,Dominican Republic,0,0,7,7,19/06/2022,0,0,1,1,5,4,7,16,4,1,0,5,1,0,2,3,2,0,0,2
4521,144980,2022,Germany,Türkiye,0,1,5,6,18/06/2022,0,0,1,1,5,3,5,13,0,0,0,0,11,1,7,19,1,0,0,1
4522,144980,2022,Germany,Italy,1,0,10,11,17/06/2022,0,0,0,0,5,1,12,18,0,0,1,1,4,1,7,12,1,0,1,2
4523,144980,2022,Netherlands,Germany,0,0,12,12,14/06/2022,0,1,0,1,8,1,16,25,1,5,2,8,6,0,4,10,3,0,0,3
4524,144980,2022,Poland,Germany,0,0,18,18,05/06/2022,0,0,4,4,9,1,22,32,2,3,1,6,9,1,6,16,10,1,1,12
4525,144980,2022,Germany,Korea,0,0,11,11,03/06/2022,0,0,8,8,7,0,4,11,0,2,0,2,5,0,0,5,5,0,1,6
4526,144980,2022,Germany,Japan,0,0,15,15,02/06/2022,0,0,5,5,12,4,18,34,1,1,1,3,5,0,3,8,13,2,2,17
4527,144980,2022,Germany,Brazil,0,0,8,8,31/05/2022,0,0,2,2,9,5,18,32,1,2,0,3,6,1,10,17,10,2,1,13
4528,151016,2022,USA,Germany,0,1,7,8,03/07/2022,0,0,3,3,12,7,22,41,1,2,0,3,10,1,10,21,11,6,0,17
4529,151016,2022,Germany,Canada,3,4,12,19,03/07/2022,0,0,5,5,18,3,17,38,0,4,1,5,7,1,11,19,5,2,0,7
4530,151016,2022,Germany,Belgium,0,1,4,5,30/06/2022,0,0,1,1,5,2,10,17,0,0,1,1,0,0,2,2,3,1,0,4
4531,151016,2022,Serbia,Germany,0,3,7,10,28/06/2022,0,0,2,2,13,9,16,38,1,3,1,5,2,0,10,12,2,1,0,3
4532,151016,2022,Germany,Dominican Republic,2,4,6,12,19/06/2022,0,0,1,1,20,5,14,39,0,1,0,1,7,1,8,16,4,1,1,6
4533,151016,2022,Germany,Türkiye,0,0,0,0,18/06/2022,0,0,1,1,0,0,0,0,0,0,1,1,0,0,0,0,0,0,0,0
4534,151016,2022,Germany,Italy,1,3,5,9,17/06/2022,0,0,0,0,11,5,17,33,1,1,1,3,2,0,5,7,0,1,0,1
4535,151016,2022,Netherlands,Germany,0,5,6,11,14/06/2022,0,0,0,0,22,5,17,44,1,2,2,5,5,0,5,10,3,1,1,5
4536,151016,2022,Poland,Germany,1,5,10,16,05/06/2022,0,0,1,1,18,4,12,34,2,1,0,3,3,1,3,7,4,0,1,5
4537,151016,2022,Germany,Korea,0,2,5,7,03/06/2022,0,0,2,2,19,1,12,32,3,2,3,8,1,2,2,5,5,1,0,6
4538,151016,2022,Germany,Japan,1,3,7,11,02/06/2022,0,1,3,4,11,4,15,30,0,1,1,2,3,0,0,3,5,3,0,8
4539,151016,2022,Germany,Brazil,1,2,6,9,31/05/2022,0,0,0,0,14,7,18,39,0,2,0,2,2,1,3,6,3,2,0,5
4540,118954,2022,USA,Germany,0,0,5,5,03/07/2022,0,0,1,1,5,1,5,11,0,0,0,0,0,0,0,0,4,0,0,4
4541,118954,2022,Germany,Canada,0,0,1,1,03/07/2022,0,0,0,0,0,0,0,0,0,0,0,0,0,0,0,0,0,0,0,0
4542,118954,2022,Germany,Belgium,0,0,0,0,30/06/2022,0,0,0,0,0,0,0,0,0,0,0,0,0,0,0,0,1,0,0,1
4543,118954,2022,Serbia,Germany,0,0,4,4,28/06/2022,0,0,0,0,2,2,2,6,0,1,0,1,0,0,0,0,1,0,0,1
4544,118954,2022,Germany,Dominican Republic,0,1,4,5,19/06/2022,0,0,0,0,1,0,1,2,0,0,0,0,0,0,0,0,2,0,0,2
4545,118954,2022,Germany,Türkiye,3,2,14,19,18/06/2022,0,0,1,1,10,6,7,23,1,2,0,3,0,1,0,1,1,3,0,4
4546,118954,2022,Germany,Italy,0,0,1,1,17/06/2022,0,0,0,0,0,0,0,0,0,0,0,0,0,0,0,0,0,1,0,1
4547,118954,2022,Netherlands,Germany,0,0,0,0,14/06/2022,0,0,0,0,0,0,0,0,0,0,0,0,0,0,0,0,0,0,0,0
4548,118954,2022,Poland,Germany,0,0,0,0,05/06/2022,0,0,0,0,0,0,0,0,0,0,0,0,0,0,0,0,0,0,0,0
4549,118954,2022,Germany,Korea,0,0,1,1,03/06/2022,0,0,0,0,0,1,2,3,0,1,0,1,0,0,0,0,0,0,0,0
4550,118954,2022,Germany,Japan,0,2,2,4,02/06/2022,0,0,0,0,1,0,1,2,0,0,1,1,1,0,0,1,0,0,0,0
4551,118954,2022,Germany,Brazil,0,0,4,4,31/05/2022,0,0,2,2,1,1,2,4,0,0,0,0,0,0,0,0,4,0,0,4
4552,150812,2022,USA,Germany,0,0,4,4,03/07/2022,0,0,1,1,3,1,5,9,2,0,0,2,0,0,0,0,1,1,0,2
4553,150812,2022,Germany,Canada,0,0,11,11,03/07/2022,0,0,2,2,4,2,4,10,1,9,6,16,1,0,0,1,3,0,0,3
4554,150812,2022,Germany,Belgium,0,1,1,2,30/06/2022,0,0,1,1,2,1,0,3,0,4,3,7,0,0,0,0,0,0,0,0
4555,150812,2022,Serbia,Germany,2,1,14,17,28/06/2022,0,0,0,0,4,2,3,9,0,5,3,8,0,0,0,0,2,1,0,3
4556,150812,2022,Germany,Dominican Republic,0,0,3,3,19/06/2022,0,0,1,1,1,1,4,6,1,3,0,4,0,0,0,0,1,0,1,2
4557,150812,2022,Germany,Türkiye,0,1,8,9,18/06/2022,0,0,0,0,5,0,6,11,0,2,4,6,0,0,0,0,2,0,1,3
4558,150812,2022,Germany,Italy,0,0,5,5,17/06/2022,0,0,1,1,2,1,1,4,2,2,0,4,0,0,0,0,0,1,0,1
4559,150812,2022,Netherlands,Germany,0,3,9,12,14/06/2022,0,0,0,0,7,4,4,15,1,7,0,8,0,1,0,1,2,1,1,4
4560,150812,2022,Poland,Germany,0,0,11,11,05/06/2022,0,0,2,2,7,2,2,11,0,4,7,11,0,1,1,2,1,0,0,1
4561,150812,2022,Germany,Korea,0,0,0,0,03/06/2022,0,0,0,0,0,0,0,0,0,0,0,0,0,0,0,0,0,0,0,0
4562,150812,2022,Germany,Japan,3,1,12,16,02/06/2022,0,0,1,1,10,2,4,16,1,5,4,10,2,1,2,5,0,0,0,0
4563,150812,2022,Germany,Brazil,0,1,8,9,31/05/2022,0,0,3,3,8,2,3,13,2,6,5,13,0,0,0,0,3,0,0,3
4564,151014,2022,,,-,-,-,-,-,-,-,-,-,-,-,-,-,-,-,-,-,-,-,-,-,-,-,-,-
4565,163989,2022,,,-,-,-,-,-,-,-,-,-,-,-,-,-,-,-,-,-,-,-,-,-,-,-,-,-
4566,151021,2022,,,-,-,-,-,-,-,-,-,-,-,-,-,-,-,-,-,-,-,-,-,-,-,-,-,-
4567,153929,2022,USA,Germany,2,2,19,23,03/07/2022,0,0,2,2,5,0,5,10,3,5,2,10,0,0,0,0,2,0,1,3
4568,153929,2022,Germany,Canada,0,0,19,19,03/07/2022,0,0,1,1,10,2,5,17,2,5,0,7,0,0,0,0,3,0,0,3
4569,153929,2022,Germany,Belgium,2,1,17,20,30/06/2022,0,0,0,0,8,0,4,12,2,6,1,9,1,0,0,1,1,2,0,3
4570,153929,2022,Serbia,Germany,1,0,11,12,28/06/2022,0,0,1,1,10,2,11,23,2,6,3,11,0,1,1,2,4,0,0,4
4571,153929,2022,Germany,Dominican Republic,1,1,18,20,19/06/2022,0,0,1,1,6,1,7,14,2,7,7,16,0,0,0,0,1,0,0,1
4572,153929,2022,Germany,Türkiye,0,0,0,0,18/06/2022,0,0,1,1,2,0,2,4,1,1,0,2,0,0,0,0,0,0,0,0
4573,153929,2022,Germany,Italy,0,0,9,9,17/06/2022,0,0,1,1,4,3,3,10,1,2,2,5,0,0,0,0,0,0,0,0
4574,153929,2022,Netherlands,Germany,1,2,10,13,14/06/2022,0,0,0,0,7,0,4,11,3,1,4,8,1,0,0,1,1,2,0,3
4575,153929,2022,Poland,Germany,1,1,15,17,05/06/2022,0,0,1,1,6,4,7,17,2,3,4,9,1,0,0,1,2,0,0,2
4576,153929,2022,Germany,Korea,1,1,15,17,03/06/2022,0,0,1,1,6,1,10,17,2,3,4,9,1,0,1,2,4,0,1,5
4577,153929,2022,Germany,Japan,0,1,13,14,02/06/2022,0,0,1,1,13,1,18,32,1,2,7,10,2,0,3,5,5,0,0,5
4578,153929,2022,Germany,Brazil,1,1,14,16,31/05/2022,0,0,0,0,10,1,5,16,2,6,8,16,0,0,0,0,4,0,0,4
4579,182628,2022,USA,Germany,0,0,0,0,03/07/2022,0,0,0,0,0,0,0,0,0,0,0,0,0,0,0,0,0,0,0,0
4580,182628,2022,Germany,Canada,0,0,0,0,03/07/2022,0,0,0,0,0,0,0,0,0,0,0,0,0,0,0,0,0,0,0,0
4581,182628,2022,Germany,Belgium,0,0,0,0,30/06/2022,0,0,0,0,0,0,0,0,0,0,0,0,0,0,0,0,0,0,0,0
4582,182628,2022,Serbia,Germany,0,0,0,0,28/06/2022,0,0,0,0,0,0,0,0,0,0,0,0,0,0,0,0,0,0,0,0
4583,182628,2022,Germany,Dominican Republic,0,0,0,0,19/06/2022,0,0,0,0,0,0,0,0,0,0,0,0,0,0,0,0,0,0,0,0
4584,182628,2022,Germany,Türkiye,0,2,6,8,18/06/2022,0,0,0,0,1,0,2,3,0,2,2,4,0,0,0,0,1,0,0,1
4585,182628,2022,Germany,Italy,0,0,0,0,17/06/2022,0,0,0,0,0,0,0,0,0,0,0,0,0,0,0,0,0,0,0,0
4586,182628,2022,Netherlands,Germany,0,0,0,0,14/06/2022,0,0,0,0,0,0,0,0,0,0,0,0,0,0,0,0,0,0,0,0
4587,182628,2022,Poland,Germany,0,0,5,5,05/06/2022,0,0,0,0,0,0,0,0,0,0,0,0,0,0,0,0,0,1,0,1
4588,182628,2022,Germany,Korea,0,0,0,0,03/06/2022,0,0,0,0,0,0,0,0,0,0,0,0,0,0,0,0,0,0,0,0
4589,182628,2022,Germany,Japan,0,0,4,4,02/06/2022,0,0,0,0,0,0,0,0,0,0,0,0,0,0,0,0,1,0,0,1
4590,182628,2022,Germany,Brazil,0,0,0,0,31/05/2022,0,0,0,0,0,0,0,0,0,0,0,0,0,0,0,0,0,0,0,0
4591,181272,2022,USA,Germany,0,0,0,0,03/07/2022,0,0,9,9,0,0,0,0,0,1,0,1,0,0,0,0,2,1,0,3
4592,181272,2022,Germany,Canada,0,0,0,0,03/07/2022,0,0,0,0,0,0,0,0,0,0,0,0,0,0,0,0,0,0,0,0
4593,181272,2022,Germany,Belgium,0,0,0,0,30/06/2022,0,0,0,0,0,0,0,0,0,0,0,0,0,0,0,0,0,0,0,0
4594,181272,2022,Serbia,Germany,0,0,0,0,28/06/2022,0,0,0,0,0,0,0,0,0,0,0,0,0,0,0,0,0,0,0,0
4595,177765,2022,USA,Germany,0,1,4,5,03/07/2022,0,0,2,2,6,1,4,11,1,1,2,4,0,0,0,0,2,1,0,3
4596,177765,2022,Germany,Canada,0,0,0,0,03/07/2022,0,0,0,0,0,0,0,0,0,0,0,0,0,0,0,0,0,0,0,0
4597,177765,2022,Germany,Belgium,0,0,7,7,30/06/2022,0,0,1,1,5,1,5,11,0,2,0,2,0,0,0,0,1,0,0,1
4598,177765,2022,Serbia,Germany,0,0,0,0,28/06/2022,0,0,0,0,0,0,0,0,0,0,0,0,0,0,0,0,0,0,0,0
4599,177765,2022,Germany,Dominican Republic,0,1,6,7,19/06/2022,0,0,1,1,4,0,3,7,1,1,3,5,0,0,0,0,0,0,0,0
4600,177765,2022,Germany,Türkiye,0,0,0,0,18/06/2022,0,0,0,0,0,0,0,0,0,0,0,0,0,0,0,0,0,0,0,0
4601,177765,2022,Germany,Italy,0,1,1,2,17/06/2022,0,0,0,0,1,1,2,4,0,0,0,0,0,0,0,0,0,0,0,0
4602,177765,2022,Netherlands,Germany,0,0,0,0,14/06/2022,0,0,0,0,0,0,0,0,0,0,0,0,0,0,0,0,0,0,0,0
4603,177765,2022,Poland,Germany,0,0,0,0,05/06/2022,0,0,0,0,0,0,0,0,0,0,0,0,0,0,0,0,0,0,0,0
4604,177765,2022,Germany,Korea,2,1,8,11,03/06/2022,0,0,0,0,8,0,0,8,0,1,4,5,0,0,1,1,2,0,1,3
4605,177765,2022,Germany,Japan,0,0,0,0,02/06/2022,0,0,0,0,0,0,0,0,0,0,0,0,0,0,0,0,0,0,0,0
4606,177765,2022,Germany,Brazil,0,0,1,1,31/05/2022,0,0,0,0,1,0,0,1,0,0,0,0,1,0,0,1,0,0,0,0
4607,151011,2022,,,-,-,-,-,-,-,-,-,-,-,-,-,-,-,-,-,-,-,-,-,-,-,-,-,-
4608,158238,2022,,,-,-,-,-,-,-,-,-,-,-,-,-,-,-,-,-,-,-,-,-,-,-,-,-,-
4609,151017,2022,,,-,-,-,-,-,-,-,-,-,-,-,-,-,-,-,-,-,-,-,-,-,-,-,-,-
4610,189214,2022,,,-,-,-,-,-,-,-,-,-,-,-,-,-,-,-,-,-,-,-,-,-,-,-,-,-
4611,189215,2022,,,-,-,-,-,-,-,-,-,-,-,-,-,-,-,-,-,-,-,-,-,-,-,-,-,-
4612,189213,2022,,,-,-,-,-,-,-,-,-,-,-,-,-,-,-,-,-,-,-,-,-,-,-,-,-,-
4613,119316,2022,,,-,-,-,-,-,-,-,-,-,-,-,-,-,-,-,-,-,-,-,-,-,-,-,-,-
4614,151658,2022,Italy,Brazil,0,1,1,2,17/07/2022,0,0,0,0,0,0,0,0,0,0,0,0,0,0,0,0,0,0,0,0
4615,151658,2022,Türkiye,Italy,0,0,3,3,16/07/2022,0,0,0,0,0,0,0,0,0,0,0,0,0,0,0,0,0,0,0,0
4616,151658,2022,Italy,China,0,2,2,4,14/07/2022,0,0,0,0,1,1,0,2,1,0,0,1,0,0,0,0,0,1,0,1
4617,151658,2022,Thailand,Italy,0,0,0,0,03/07/2022,0,0,0,0,0,0,0,0,0,0,0,0,0,0,0,0,0,0,0,0
4618,151658,2022,Italy,Bulgaria,0,0,0,0,02/07/2022,0,0,0,0,0,0,0,0,0,0,0,0,0,0,0,0,0,0,0,0
4619,151658,2022,Italy,Korea,0,0,0,0,01/07/2022,0,0,0,0,0,0,0,0,0,0,0,0,0,0,0,0,0,0,0,0
4620,151658,2022,Italy,Poland,0,1,2,3,29/06/2022,0,0,0,0,0,0,0,0,0,1,0,1,0,0,0,0,0,0,0,0
4621,151658,2022,Italy,Brazil,1,2,15,18,18/06/2022,0,0,0,0,7,0,4,11,1,1,5,7,0,0,0,0,5,1,0,6
4622,151658,2022,Germany,Italy,1,1,3,5,17/06/2022,0,0,0,0,0,0,0,0,0,0,0,0,0,0,0,0,0,0,0,0
4623,151658,2022,Italy,Dominican Republic,0,2,5,7,16/06/2022,0,0,1,1,0,0,0,0,0,0,0,0,0,0,0,0,0,1,0,1
4624,151658,2022,Serbia,Italy,0,0,2,2,15/06/2022,0,0,0,0,1,0,1,2,0,0,1,1,0,0,0,0,0,0,1,1
4625,151658,2022,China,Italy,2,1,9,12,04/06/2022,0,0,1,1,0,2,3,5,0,2,5,7,0,0,1,1,1,1,0,2
4626,151658,2022,Netherlands,Italy,2,2,11,15,03/06/2022,0,0,2,2,6,2,2,10,2,0,5,7,0,0,0,0,3,0,0,3
4627,151658,2022,Belgium,Italy,0,1,4,5,02/06/2022,0,0,1,1,0,0,0,0,0,0,0,0,0,0,0,0,2,0,0,2
4628,151658,2022,Türkiye,Italy,0,1,4,5,31/05/2022,0,0,0,0,0,0,0,0,0,0,0,0,0,0,0,0,1,0,0,1
4629,151986,2022,Italy,Brazil,0,0,1,1,18/06/2022,2,0,6,8,0,0,0,0,0,0,0,0,0,0,0,0,0,0,0,0
4630,151986,2022,Germany,Italy,0,0,1,1,17/06/2022,0,0,1,1,0,0,0,0,0,0,0,0,0,0,0,0,0,0,0,0
4631,151986,2022,Italy,Dominican Republic,0,0,11,11,16/06/2022,18,1,29,48,0,0,1,1,1,1,1,3,0,0,0,0,1,0,0,1
4632,151986,2022,Serbia,Italy,0,0,0,0,15/06/2022,0,0,0,0,0,0,0,0,0,0,0,0,0,0,0,0,0,0,0,0
4633,151986,2022,China,Italy,0,0,3,3,04/06/2022,1,0,4,5,0,0,0,0,0,0,0,0,0,0,0,0,0,0,0,0
4634,151986,2022,Netherlands,Italy,0,1,9,10,03/06/2022,27,1,45,73,0,0,1,1,2,2,3,7,0,0,0,0,11,1,2,14
4635,151986,2022,Belgium,Italy,0,1,1,2,02/06/2022,0,0,1,1,0,0,0,0,0,0,0,0,0,0,0,0,0,1,0,1
4636,151986,2022,Türkiye,Italy,0,0,2,2,31/05/2022,1,0,2,3,0,0,0,0,0,0,0,0,0,0,0,0,0,0,0,0
4637,118764,2022,Italy,Brazil,0,0,0,0,17/07/2022,0,0,0,0,0,0,0,0,0,0,0,0,0,0,0,0,0,0,0,0
4638,118764,2022,Türkiye,Italy,0,0,0,0,16/07/2022,0,0,0,0,0,0,0,0,0,0,0,0,0,0,4,4,3,0,0,3
4639,118764,2022,Italy,China,0,0,0,0,14/07/2022,0,0,0,0,0,0,0,0,0,0,0,0,0,0,0,0,0,0,0,0
4640,118764,2022,Thailand,Italy,0,0,0,0,03/07/2022,0,0,0,0,0,0,0,0,0,0,0,0,0,0,0,0,0,0,0,0
4641,118764,2022,Italy,Bulgaria,0,1,14,15,02/07/2022,0,0,0,0,8,0,8,16,1,3,0,4,2,0,14,16,8,2,1,11
4642,118764,2022,Italy,Korea,0,0,0,0,01/07/2022,0,0,0,0,0,0,0,0,0,0,0,0,0,0,0,0,0,1,0,1
4643,118764,2022,Italy,Poland,0,2,12,14,29/06/2022,1,0,0,1,5,2,12,19,1,4,2,7,3,0,18,21,16,2,4,22
4644,118764,2022,China,Italy,0,0,0,0,04/06/2022,0,0,0,0,0,0,0,0,0,0,0,0,0,0,0,0,0,0,0,0
4645,118764,2022,Netherlands,Italy,0,1,8,9,03/06/2022,0,0,1,1,10,0,12,22,1,3,1,5,7,1,13,21,4,2,0,6
4646,118764,2022,Belgium,Italy,1,1,10,12,02/06/2022,0,0,1,1,8,2,15,25,0,3,2,5,4,1,12,17,4,3,0,7
4647,118764,2022,Türkiye,Italy,0,0,0,0,31/05/2022,0,0,0,0,0,0,0,0,0,0,0,0,0,0,1,1,0,0,0,0
4648,142391,2022,Italy,Brazil,0,0,0,0,17/07/2022,0,0,0,0,0,0,0,0,0,0,0,0,0,0,0,0,0,0,0,0
4649,142391,2022,Türkiye,Italy,0,0,0,0,16/07/2022,0,0,0,0,0,0,0,0,0,0,0,0,0,0,0,0,0,0,0,0
4650,142391,2022,Italy,China,0,0,0,0,14/07/2022,0,0,0,0,0,0,0,0,0,0,0,0,0,0,0,0,0,0,0,0
4651,142391,2022,Thailand,Italy,0,0,0,0,03/07/2022,0,0,0,0,0,0,0,0,0,0,0,0,0,0,0,0,0,0,0,0
4652,142391,2022,Italy,Bulgaria,0,0,0,0,02/07/2022,0,0,0,0,0,0,0,0,0,0,0,0,0,0,0,0,0,0,0,0
4653,142391,2022,Italy,Korea,0,1,10,11,01/07/2022,0,0,0,0,5,1,8,14,0,3,5,8,0,0,0,0,0,4,0,4
4654,142391,2022,Italy,Poland,0,0,0,0,29/06/2022,0,0,0,0,0,0,0,0,0,0,0,0,0,0,0,0,0,0,0,0
4655,142391,2022,Italy,Brazil,0,1,11,12,18/06/2022,0,0,0,0,3,1,4,8,7,3,1,11,0,0,0,0,1,0,1,2
4656,142391,2022,Germany,Italy,0,0,0,0,17/06/2022,0,0,0,0,0,0,0,0,0,0,0,0,0,0,0,0,0,0,0,0
4657,142391,2022,Italy,Dominican Republic,0,0,7,7,16/06/2022,0,0,0,0,6,1,1,8,2,3,2,7,0,0,0,0,0,1,0,1
4658,142391,2022,Serbia,Italy,0,0,0,0,15/06/2022,0,0,0,0,0,0,0,0,0,0,0,0,0,0,0,0,0,0,0,0
4659,142391,2022,China,Italy,0,0,9,9,04/06/2022,1,0,1,2,9,1,1,11,1,2,5,8,0,0,0,0,1,0,2,3
4660,142391,2022,Netherlands,Italy,0,0,0,0,03/06/2022,0,0,0,0,0,0,0,0,0,0,0,0,0,0,0,0,0,0,0,0
4661,142391,2022,Belgium,Italy,0,1,14,15,02/06/2022,0,0,1,1,4,1,3,8,1,2,4,7,0,0,0,0,0,0,0,0
4662,142391,2022,Türkiye,Italy,0,0,7,7,31/05/2022,0,0,1,1,5,1,5,11,2,5,5,12,0,0,0,0,1,1,0,2
4663,143371,2022,Italy,Brazil,0,0,0,0,17/07/2022,0,0,5,5,1,0,0,1,0,0,1,1,0,0,0,0,0,0,0,0
4664,143371,2022,Türkiye,Italy,0,0,0,0,16/07/2022,1,0,1,2,0,0,0,0,0,0,0,0,0,0,0,0,0,0,0,0
4665,143371,2022,Italy,China,0,0,5,5,14/07/2022,6,0,27,33,1,0,0,1,0,0,3,3,0,0,0,0,3,0,0,3
4666,143371,2022,Thailand,Italy,0,0,0,0,03/07/2022,0,0,0,0,0,0,0,0,0,0,0,0,0,0,0,0,0,0,0,0
4667,143371,2022,Italy,Bulgaria,0,0,0,0,02/07/2022,0,0,0,0,0,0,0,0,0,0,0,0,0,0,0,0,0,0,0,0
4668,143371,2022,Italy,Korea,0,2,9,11,01/07/2022,13,1,85,99,1,1,3,5,2,2,2,6,0,0,0,0,4,2,1,7
4669,143371,2022,Italy,Poland,0,3,7,10,29/06/2022,76,0,0,76,1,1,0,2,0,4,0,4,0,0,1,1,0,2,0,2
4670,143371,2022,Italy,Brazil,0,0,14,14,18/06/2022,21,0,45,66,0,0,1,1,4,1,4,9,0,0,0,0,3,1,0,4
4671,143371,2022,Germany,Italy,0,0,15,15,17/06/2022,28,1,60,89,3,0,2,5,2,2,6,10,0,0,0,0,1,2,0,3
4672,143371,2022,Italy,Dominican Republic,0,0,10,10,16/06/2022,28,0,50,78,2,0,1,3,0,3,4,7,0,0,0,0,5,0,0,5
4673,143371,2022,Serbia,Italy,0,0,14,14,15/06/2022,0,0,70,70,2,0,1,3,3,0,8,11,0,0,0,0,7,0,2,9
4674,143371,2022,China,Italy,1,3,9,13,04/06/2022,55,0,45,100,3,0,2,5,0,1,5,6,0,0,0,0,11,2,1,14
4675,143371,2022,Netherlands,Italy,0,0,0,0,03/06/2022,0,0,0,0,0,0,0,0,0,0,0,0,0,0,0,0,0,0,0,0
4676,143371,2022,Belgium,Italy,0,1,12,13,02/06/2022,13,3,81,97,0,0,1,1,2,2,4,8,0,1,0,1,7,2,1,10
4677,143371,2022,Türkiye,Italy,0,1,8,9,31/05/2022,13,1,61,75,2,0,2,4,1,0,1,2,1,1,0,2,5,2,0,7
4678,115478,2022,Italy,Brazil,0,0,0,0,17/07/2022,0,0,7,7,0,0,0,0,0,0,0,0,4,1,1,6,7,4,4,15
4679,115478,2022,Türkiye,Italy,0,0,0,0,16/07/2022,0,0,13,13,0,0,0,0,0,0,0,0,6,0,3,9,11,1,1,13
4680,115478,2022,Italy,China,0,0,0,0,14/07/2022,0,0,9,9,0,0,0,0,0,0,0,0,9,0,2,11,19,4,3,26
4681,115478,2022,Thailand,Italy,0,0,0,0,03/07/2022,0,0,2,2,0,0,0,0,0,0,0,0,6,0,2,8,13,1,1,15
4682,115478,2022,Italy,Bulgaria,0,0,0,0,02/07/2022,0,0,1,1,0,0,0,0,0,0,0,0,1,1,4,6,8,4,1,13
4683,115478,2022,Italy,Korea,0,0,0,0,01/07/2022,0,0,0,0,0,0,0,0,0,0,0,0,0,0,0,0,0,0,0,0
4684,115478,2022,Italy,Poland,0,0,0,0,29/06/2022,7,0,0,7,0,0,0,0,0,0,0,0,5,0,9,14,13,3,4,20
4685,115478,2022,Italy,Brazil,0,0,0,0,18/06/2022,0,0,6,6,0,0,0,0,0,0,0,0,7,0,5,12,4,3,0,7
4686,115478,2022,Germany,Italy,0,0,0,0,17/06/2022,0,0,5,5,0,0,0,0,0,0,0,0,6,0,4,10,14,0,1,15
4687,115478,2022,Italy,Dominican Republic,0,0,0,0,16/06/2022,0,0,13,13,0,0,0,0,0,0,0,0,9,1,4,14,14,3,0,17
4688,115478,2022,Serbia,Italy,0,0,0,0,15/06/2022,0,0,2,2,0,0,0,0,0,0,0,0,4,0,5,9,13,0,1,14
4689,115478,2022,China,Italy,0,0,0,0,04/06/2022,3,0,8,11,0,0,0,0,0,0,0,0,7,0,15,22,13,3,3,19
4690,115478,2022,Netherlands,Italy,0,0,0,0,03/06/2022,1,0,10,11,0,0,0,0,0,0,0,0,0,0,9,9,14,2,0,16
4691,115478,2022,Belgium,Italy,0,0,0,0,02/06/2022,0,0,15,15,0,0,0,0,0,0,0,0,4,0,8,12,10,3,0,13
4692,115478,2022,Türkiye,Italy,0,0,0,0,31/05/2022,1,0,8,9,0,0,0,0,0,0,0,0,3,0,9,12,6,2,2,10
4693,173402,2022,Italy,Brazil,0,0,0,0,17/07/2022,0,0,0,0,0,0,0,0,0,0,0,0,0,0,0,0,0,1,0,1
4694,173402,2022,Türkiye,Italy,0,0,0,0,16/07/2022,0,0,0,0,0,0,0,0,0,0,0,0,0,0,0,0,0,0,0,0
4695,173402,2022,Italy,China,0,0,0,0,14/07/2022,0,0,0,0,0,0,0,0,0,0,0,0,0,0,0,0,0,0,0,0
4696,173402,2022,Thailand,Italy,0,0,0,0,03/07/2022,0,0,0,0,0,0,0,0,0,0,0,0,2,0,0,2,1,0,0,1
4697,173402,2022,Italy,Bulgaria,0,0,0,0,02/07/2022,0,0,0,0,0,0,0,0,0,0,0,0,0,0,0,0,0,0,0,0
4698,173402,2022,Italy,Korea,0,0,0,0,01/07/2022,0,1,3,4,0,0,0,0,0,0,0,0,9,1,13,23,22,1,2,25
4699,173402,2022,Italy,Poland,0,0,0,0,29/06/2022,0,0,0,0,0,0,0,0,0,0,0,0,0,0,0,0,0,0,0,0
4700,173402,2022,Italy,Brazil,0,0,0,0,18/06/2022,0,0,0,0,0,0,0,0,0,0,0,0,3,0,3,6,1,1,0,2
4701,173402,2022,Germany,Italy,0,0,0,0,17/06/2022,0,0,0,0,0,0,0,0,0,0,0,0,1,0,2,3,1,0,0,1
4702,173402,2022,Italy,Dominican Republic,0,0,0,0,16/06/2022,0,0,0,0,0,0,0,0,0,0,0,0,1,0,1,2,0,1,0,1
4703,173402,2022,Serbia,Italy,0,0,0,0,15/06/2022,0,0,0,0,0,0,0,0,0,0,0,0,0,0,0,0,1,0,0,1
4704,173402,2022,China,Italy,0,0,0,0,04/06/2022,0,0,0,0,0,0,0,0,0,0,0,0,0,0,0,0,0,0,0,0
4705,173402,2022,Netherlands,Italy,0,0,0,0,03/06/2022,0,0,0,0,0,0,0,0,0,0,0,0,1,0,1,2,1,0,1,2
4706,173402,2022,Belgium,Italy,0,0,0,0,02/06/2022,0,0,0,0,0,0,0,0,0,0,0,0,0,0,0,0,0,0,0,0
4707,173402,2022,Türkiye,Italy,0,0,0,0,31/05/2022,0,0,0,0,0,0,0,0,0,0,0,0,0,0,0,0,0,0,0,0
4708,150441,2022,Italy,Brazil,0,1,8,9,17/07/2022,19,0,58,77,0,0,4,4,0,0,2,2,1,1,1,3,4,5,3,12
4709,150441,2022,Türkiye,Italy,0,0,16,16,16/07/2022,15,1,69,85,1,0,0,1,0,0,3,3,0,1,0,1,11,2,0,13
4710,150441,2022,Italy,China,0,0,12,12,14/07/2022,17,0,80,97,2,0,1,3,0,2,0,2,0,0,1,1,8,5,1,14
4711,150441,2022,Thailand,Italy,1,1,17,19,03/07/2022,10,0,75,85,1,0,1,2,0,2,0,2,0,0,0,0,8,2,2,12
4712,150441,2022,Italy,Bulgaria,1,2,11,14,02/07/2022,6,2,73,81,2,0,1,3,0,5,3,8,0,0,0,0,3,1,1,5
4713,150441,2022,Italy,Korea,0,0,6,6,01/07/2022,1,0,12,13,0,0,0,0,0,0,0,0,0,0,0,0,1,0,0,1
4714,150441,2022,Italy,Poland,1,0,13,14,29/06/2022,35,2,0,37,1,0,1,2,1,1,2,4,0,0,0,0,3,1,1,5
4715,123744,2022,Italy,Brazil,1,1,8,10,17/07/2022,0,1,7,8,10,0,7,17,0,0,1,1,6,1,6,13,3,4,2,9
4716,123744,2022,Türkiye,Italy,1,3,9,13,16/07/2022,0,0,5,5,9,2,11,22,1,3,0,4,9,0,11,20,16,1,0,17
4717,123744,2022,Italy,China,2,2,10,14,14/07/2022,0,0,5,5,11,1,13,25,1,3,2,6,21,2,16,39,7,2,0,9
4718,123744,2022,Italy,Brazil,0,2,13,15,18/06/2022,0,0,4,4,6,5,0,11,1,1,1,3,6,3,5,14,7,0,0,7
4719,123744,2022,Germany,Italy,0,0,13,13,17/06/2022,0,0,1,1,11,2,2,15,0,0,3,3,8,2,7,17,5,1,0,6
4720,123744,2022,Italy,Dominican Republic,0,0,9,9,16/06/2022,0,0,2,2,4,2,6,12,2,1,0,3,4,1,7,12,0,0,0,0
4721,123744,2022,Serbia,Italy,4,3,16,23,15/06/2022,0,0,0,0,7,6,8,21,1,0,3,4,7,2,20,29,8,1,2,11
4722,136690,2022,Italy,Brazil,1,2,8,11,17/07/2022,0,0,0,0,6,1,2,9,2,2,0,4,0,0,0,0,2,0,0,2
4723,136690,2022,Türkiye,Italy,0,2,8,10,16/07/2022,0,1,3,4,4,2,3,9,0,4,2,6,0,0,0,0,4,2,0,6
4724,136690,2022,Italy,China,1,2,12,15,14/07/2022,0,0,2,2,7,1,8,16,1,3,7,11,1,0,0,1,6,0,0,6
4725,136690,2022,Thailand,Italy,0,2,8,10,03/07/2022,0,0,0,0,7,0,5,12,0,3,3,6,0,0,0,0,1,1,0,2
4726,136690,2022,Italy,Bulgaria,1,2,11,14,02/07/2022,0,0,0,0,5,0,4,9,2,6,6,14,0,0,0,0,4,0,1,5
4727,136690,2022,Italy,Korea,1,0,12,13,01/07/2022,0,0,0,0,7,0,5,12,0,5,4,9,0,0,0,0,4,0,1,5
4728,136690,2022,Italy,Poland,0,2,12,14,29/06/2022,0,0,0,0,7,1,3,11,1,3,3,7,0,0,1,1,0,1,0,1
4729,136690,2022,Italy,Brazil,0,0,0,0,18/06/2022,0,0,0,0,0,0,0,0,0,0,0,0,0,0,0,0,0,0,0,0
4730,136690,2022,Germany,Italy,0,0,11,11,17/06/2022,0,0,1,1,6,3,5,14,3,3,4,10,0,0,1,1,2,1,0,3
4731,136690,2022,Italy,Dominican Republic,0,0,15,15,16/06/2022,0,0,0,0,4,2,8,14,1,9,2,12,0,0,0,0,3,1,0,4
4732,136690,2022,Serbia,Italy,0,1,14,15,15/06/2022,0,0,0,0,4,2,5,11,2,0,8,10,1,0,0,1,6,0,1,7
4733,136690,2022,China,Italy,0,0,6,6,04/06/2022,0,0,2,2,2,3,3,8,1,3,2,6,0,0,0,0,0,0,0,0
4734,136690,2022,Netherlands,Italy,0,0,0,0,03/06/2022,0,0,0,0,0,0,0,0,0,0,0,0,0,0,0,0,0,0,0,0
4735,136690,2022,Belgium,Italy,1,1,8,10,02/06/2022,0,0,0,0,5,1,2,8,3,7,8,18,1,0,0,1,1,3,0,4
4736,136690,2022,Türkiye,Italy,1,2,7,10,31/05/2022,0,0,0,0,2,3,2,7,1,4,2,7,0,0,0,0,2,1,0,3
4737,136694,2022,Italy,Brazil,0,1,16,17,17/07/2022,0,0,1,1,8,0,0,8,1,5,6,12,0,0,0,0,3,1,2,6
4738,136694,2022,Türkiye,Italy,0,2,6,8,16/07/2022,0,0,0,0,4,2,4,10,5,8,2,15,0,0,0,0,2,3,0,5
4739,136694,2022,Italy,China,0,1,11,12,14/07/2022,0,0,2,2,5,1,4,10,3,3,2,8,0,0,1,1,5,0,0,5
4740,136694,2022,Thailand,Italy,1,1,9,11,03/07/2022,0,0,0,0,6,0,4,10,2,3,5,10,0,0,0,0,2,1,0,3
4741,136694,2022,Italy,Bulgaria,2,2,8,12,02/07/2022,0,0,0,0,6,1,1,8,1,4,5,10,0,0,0,0,1,0,0,1
4742,136694,2022,Italy,Korea,0,0,0,0,01/07/2022,0,0,0,0,0,0,0,0,0,0,0,0,0,0,0,0,0,0,0,0
4743,136694,2022,Italy,Poland,0,2,9,11,29/06/2022,1,1,0,2,6,2,4,12,7,1,5,13,0,0,1,1,3,0,2,5
4744,136694,2022,Italy,Brazil,0,0,0,0,18/06/2022,0,0,0,0,0,0,0,0,0,0,0,0,0,0,0,0,0,0,0,0
4745,136694,2022,Germany,Italy,0,2,5,7,17/06/2022,0,0,1,1,4,2,3,9,3,2,4,9,0,0,0,0,1,1,0,2
4746,136694,2022,Italy,Dominican Republic,0,0,5,5,16/06/2022,0,0,1,1,1,0,3,4,2,2,1,5,0,0,0,0,0,0,0,0
4747,136694,2022,Serbia,Italy,1,0,14,15,15/06/2022,0,1,1,2,3,1,5,9,3,0,10,13,1,0,0,1,3,0,0,3
4748,143393,2022,Italy,Brazil,0,0,1,1,18/06/2022,0,0,1,1,1,0,2,3,0,1,0,1,0,0,2,2,1,0,0,1
4749,143393,2022,Germany,Italy,0,0,0,0,17/06/2022,0,0,0,0,0,0,0,0,0,0,0,0,0,0,0,0,0,0,0,0
4750,143393,2022,Italy,Dominican Republic,0,4,5,9,16/06/2022,0,0,2,2,17,4,9,30,0,1,1,2,11,1,14,26,13,2,0,15
4751,143393,2022,Serbia,Italy,0,0,0,0,15/06/2022,0,0,0,0,0,0,0,0,0,0,0,0,0,0,0,0,0,0,0,0
4752,180478,2022,,,-,-,-,-,-,-,-,-,-,-,-,-,-,-,-,-,-,-,-,-,-,-,-,-,-
4753,156104,2022,Italy,Brazil,0,1,14,15,17/07/2022,0,0,2,2,7,3,7,17,1,1,1,3,15,0,28,43,8,1,1,10
4754,156104,2022,Türkiye,Italy,0,0,16,16,16/07/2022,0,0,0,0,7,1,12,20,1,3,3,7,9,1,11,21,5,0,1,6
4755,156104,2022,Italy,China,1,1,8,10,14/07/2022,0,0,0,0,4,3,4,11,1,1,1,3,7,0,4,11,3,0,0,3
4756,156104,2022,Thailand,Italy,1,2,7,10,03/07/2022,0,0,0,0,8,0,8,16,3,3,0,6,4,0,14,18,3,1,1,5
4757,156104,2022,Italy,Bulgaria,0,0,11,11,02/07/2022,0,0,0,0,18,0,9,27,2,3,1,6,3,3,19,25,5,1,1,7
4758,156104,2022,Italy,Korea,0,0,0,0,01/07/2022,0,0,0,0,0,0,0,0,0,0,0,0,0,0,0,0,0,0,0,0
4759,156104,2022,Italy,Poland,0,0,0,0,29/06/2022,0,0,0,0,0,0,0,0,0,0,0,0,0,0,0,0,0,0,0,0
4760,151664,2022,Italy,Brazil,0,0,0,0,17/07/2022,0,0,0,0,0,0,0,0,0,0,0,0,0,0,0,0,0,0,0,0
4761,151664,2022,Türkiye,Italy,0,0,0,0,16/07/2022,0,0,0,0,0,0,0,0,0,0,0,0,0,0,0,0,0,0,0,0
4762,151664,2022,Italy,China,0,0,0,0,14/07/2022,0,0,0,0,0,0,0,0,0,0,0,0,0,0,0,0,0,0,0,0
4763,151664,2022,Thailand,Italy,0,0,0,0,03/07/2022,0,0,0,0,0,0,0,0,0,0,0,0,0,0,0,0,0,0,0,0
4764,151664,2022,Italy,Bulgaria,0,1,7,8,02/07/2022,0,0,0,0,11,2,6,19,1,2,3,6,0,0,0,0,4,0,1,5
4765,151664,2022,Italy,Korea,0,1,20,21,01/07/2022,0,0,3,3,17,6,13,36,4,6,1,11,0,0,0,0,11,0,1,12
4766,151664,2022,Italy,Poland,0,0,0,0,29/06/2022,0,0,0,0,0,1,1,2,0,0,1,1,0,0,0,0,1,0,0,1
4767,151664,2022,Italy,Brazil,0,0,0,0,18/06/2022,0,0,0,0,0,0,0,0,0,0,0,0,0,0,0,0,0,0,0,0
4768,151664,2022,Germany,Italy,0,0,0,0,17/06/2022,0,0,0,0,0,0,0,0,0,0,0,0,0,0,0,0,0,0,0,0
4769,151664,2022,Italy,Dominican Republic,0,1,12,13,16/06/2022,0,0,0,0,9,6,18,33,2,4,0,6,0,0,0,0,1,1,0,2
4770,151664,2022,Serbia,Italy,0,0,0,0,15/06/2022,0,0,0,0,0,0,0,0,0,0,0,0,0,0,0,0,0,0,0,0
4771,151664,2022,China,Italy,0,0,10,10,04/06/2022,1,0,2,3,18,9,13,40,1,4,2,7,0,0,0,0,3,0,2,5
4772,151664,2022,Netherlands,Italy,0,0,8,8,03/06/2022,0,0,0,0,15,4,5,24,1,1,1,3,0,0,0,0,4,0,3,7
4773,151664,2022,Belgium,Italy,1,1,16,18,02/06/2022,1,0,1,2,26,9,16,51,2,2,4,8,0,0,0,0,7,2,1,10
4774,151664,2022,Türkiye,Italy,0,0,9,9,31/05/2022,0,0,1,1,14,9,17,40,1,4,1,6,0,0,0,0,2,1,1,4
4775,143391,2022,China,Italy,0,0,0,0,04/06/2022,0,0,0,0,0,0,0,0,0,0,0,0,0,0,0,0,0,0,0,0
4776,143391,2022,Netherlands,Italy,0,0,0,0,03/06/2022,0,0,0,0,0,0,0,0,0,0,0,0,0,0,0,0,0,0,0,0
4777,143391,2022,Belgium,Italy,0,0,0,0,02/06/2022,0,0,0,0,0,1,1,2,0,0,0,0,0,0,1,1,0,0,0,0
4778,143391,2022,Türkiye,Italy,0,0,0,0,31/05/2022,0,0,0,0,0,0,0,0,0,0,0,0,0,1,0,1,1,0,0,1
4779,136701,2022,Italy,Brazil,0,0,0,0,17/07/2022,0,0,0,0,0,0,0,0,0,0,0,0,0,0,0,0,0,0,0,0
4780,136701,2022,Türkiye,Italy,0,0,0,0,16/07/2022,0,0,0,0,0,0,2,2,0,0,0,0,1,0,3,4,0,0,0,0
4781,136701,2022,Italy,China,0,0,6,6,14/07/2022,0,0,3,3,5,6,10,21,0,1,2,3,6,0,14,20,10,1,0,11
4782,136701,2022,Thailand,Italy,0,0,9,9,03/07/2022,0,1,0,1,9,1,6,16,0,0,2,2,4,0,15,19,4,4,5,13
4783,136701,2022,Italy,Bulgaria,0,0,0,0,02/07/2022,0,0,0,0,0,0,0,0,0,0,0,0,0,0,0,0,0,0,0,0
4784,136701,2022,Italy,Korea,0,2,11,13,01/07/2022,1,0,3,4,13,5,16,34,4,2,2,8,3,0,17,20,9,1,1,11
4785,136701,2022,Italy,Poland,1,0,2,3,29/06/2022,0,0,0,0,0,0,0,0,0,0,0,0,0,1,0,1,0,0,0,0
4786,136701,2022,Italy,Brazil,0,0,0,0,18/06/2022,0,0,0,0,0,0,0,0,0,0,0,0,0,0,0,0,0,0,0,0
4787,136701,2022,Germany,Italy,0,0,0,0,17/06/2022,0,0,0,0,0,0,0,0,0,0,0,0,0,0,0,0,0,0,0,0
4788,136701,2022,Italy,Dominican Republic,0,0,0,0,16/06/2022,0,0,0,0,0,0,0,0,0,0,0,0,0,0,0,0,0,0,0,0
4789,136701,2022,Serbia,Italy,0,0,0,0,15/06/2022,0,0,0,0,0,0,0,0,0,0,0,0,0,0,0,0,0,0,0,0
4790,150840,2022,Italy,Brazil,0,3,7,10,17/07/2022,0,0,0,0,18,8,16,42,3,3,3,9,0,0,0,0,4,4,1,9
4791,150840,2022,Türkiye,Italy,1,2,8,11,16/07/2022,0,0,2,2,22,5,18,45,3,2,4,9,0,0,0,0,2,2,0,4
4792,150840,2022,Italy,China,4,1,15,20,14/07/2022,0,0,2,2,32,10,24,66,0,4,1,5,0,0,0,0,10,5,1,16
4793,150840,2022,Thailand,Italy,4,1,9,14,03/07/2022,0,1,1,2,19,4,10,33,1,1,1,3,0,0,0,0,4,2,2,8
4794,150840,2022,Italy,Bulgaria,0,0,0,0,02/07/2022,0,0,0,0,0,0,0,0,0,0,0,0,0,0,0,0,0,0,0,0
4795,150840,2022,Italy,Korea,0,0,0,0,01/07/2022,0,0,0,0,0,0,0,0,0,0,0,0,0,0,0,0,0,0,0,0
4796,150840,2022,Italy,Poland,1,6,7,14,29/06/2022,1,1,0,2,26,5,21,52,2,1,3,6,0,0,0,0,6,0,2,8
4797,150840,2022,Italy,Brazil,0,3,11,14,18/06/2022,0,0,0,0,20,5,13,38,2,4,2,8,0,0,0,0,3,2,0,5
4798,150840,2022,Germany,Italy,0,3,8,11,17/06/2022,0,0,2,2,22,8,11,41,0,2,1,3,0,0,0,0,3,2,1,6
4799,150840,2022,Italy,Dominican Republic,1,2,1,4,16/06/2022,0,0,0,0,6,4,7,17,1,2,1,4,0,0,0,0,3,0,1,4
4800,150840,2022,Serbia,Italy,2,3,10,15,15/06/2022,0,0,1,1,19,4,18,41,2,0,7,9,0,0,0,0,5,0,5,10
4801,173917,2022,,,-,-,-,-,-,-,-,-,-,-,-,-,-,-,-,-,-,-,-,-,-,-,-,-,-
4802,163627,2022,,,-,-,-,-,-,-,-,-,-,-,-,-,-,-,-,-,-,-,-,-,-,-,-,-,-
4803,143370,2022,Thailand,Italy,0,0,0,0,03/07/2022,0,0,0,0,0,0,0,0,0,0,0,0,0,0,0,0,0,0,0,0
4804,143370,2022,Italy,Bulgaria,0,0,0,0,02/07/2022,0,0,0,0,0,0,0,0,0,0,0,0,0,0,0,0,0,0,0,0
4805,143370,2022,Italy,Korea,2,4,16,22,01/07/2022,0,0,3,3,12,7,6,25,1,2,3,6,2,0,20,22,5,4,2,11
4806,143370,2022,Italy,Poland,1,2,16,19,29/06/2022,2,0,1,3,16,7,13,36,2,4,1,7,6,3,33,42,9,2,0,11
4807,143370,2022,Italy,Brazil,0,4,9,13,18/06/2022,0,0,1,1,10,3,6,19,0,3,1,4,5,2,20,27,4,1,1,6
4808,143370,2022,Germany,Italy,1,2,9,12,17/06/2022,0,0,1,1,7,5,7,19,0,1,4,5,7,3,20,30,4,0,0,4
4809,143370,2022,Italy,Dominican Republic,1,3,7,11,16/06/2022,0,0,0,0,9,4,15,28,1,1,1,3,12,1,21,34,3,1,2,6
4810,143370,2022,Serbia,Italy,0,5,6,11,15/06/2022,0,0,0,0,14,4,5,23,2,0,1,3,11,0,13,24,3,0,2,5
4811,143370,2022,China,Italy,1,5,5,11,04/06/2022,0,0,1,1,21,8,11,40,1,2,3,6,5,3,19,27,15,5,1,21
4812,143370,2022,Netherlands,Italy,0,4,14,18,03/06/2022,1,0,1,2,13,3,8,24,1,3,0,4,2,1,11,14,7,2,2,11
4813,143370,2022,Belgium,Italy,0,2,0,2,02/06/2022,0,0,0,0,1,2,2,5,0,1,0,1,2,0,5,7,1,0,0,1
4814,143370,2022,Türkiye,Italy,0,2,4,6,31/05/2022,1,0,1,2,5,1,6,12,0,4,2,6,12,2,25,39,4,1,1,6
4815,163061,2022,China,Italy,0,0,0,0,04/06/2022,0,0,0,0,0,1,2,3,0,0,0,0,0,0,0,0,1,0,1,2
4816,163061,2022,Netherlands,Italy,0,0,0,0,03/06/2022,0,0,0,0,0,0,0,0,0,0,0,0,0,0,0,0,0,0,0,0
4817,163061,2022,Belgium,Italy,0,1,0,1,02/06/2022,0,0,0,0,0,0,0,0,0,0,0,0,0,0,1,1,1,0,0,1
4818,163061,2022,Türkiye,Italy,0,1,1,2,31/05/2022,0,0,0,0,1,1,0,2,0,0,0,0,0,0,2,2,0,0,0,0
4819,136697,2022,China,Italy,0,2,12,14,04/06/2022,1,0,3,4,6,6,8,20,0,1,0,1,10,2,27,39,3,4,2,9
4820,136697,2022,Netherlands,Italy,0,0,0,0,03/06/2022,0,0,0,0,0,0,0,0,0,0,0,0,0,0,0,0,0,0,0,0
4821,136697,2022,Belgium,Italy,2,1,14,17,02/06/2022,0,0,1,1,12,1,14,27,1,4,3,8,11,2,25,38,6,3,0,9
4822,136697,2022,Türkiye,Italy,0,1,7,8,31/05/2022,0,0,1,1,8,0,11,19,1,4,1,6,1,0,8,9,4,2,1,7
4823,151661,2022,China,Italy,0,0,1,1,04/06/2022,0,0,0,0,0,0,0,0,0,1,0,1,0,0,0,0,0,0,0,0
4824,151661,2022,Netherlands,Italy,1,0,12,13,03/06/2022,0,0,3,3,6,1,7,14,3,0,4,7,0,0,1,1,2,0,0,2
4825,151661,2022,Belgium,Italy,0,0,0,0,02/06/2022,0,0,0,0,0,0,1,1,0,0,1,1,0,0,0,0,0,0,0,0
4826,151661,2022,Türkiye,Italy,0,0,2,2,31/05/2022,0,0,1,1,0,0,1,1,0,0,0,0,0,0,0,0,0,0,0,0
4827,173730,2022,,,-,-,-,-,-,-,-,-,-,-,-,-,-,-,-,-,-,-,-,-,-,-,-,-,-
4828,168062,2022,Brazil,Japan,0,0,0,0,13/07/2022,0,0,0,0,0,0,0,0,0,0,0,0,0,0,0,0,0,0,0,0
4829,168062,2022,Belgium,Japan,0,0,0,0,03/07/2022,0,0,0,0,0,0,0,0,0,0,0,0,0,0,0,0,0,0,0,0
4830,168062,2022,Japan,Serbia,0,0,0,0,02/07/2022,0,0,0,0,0,0,0,0,0,0,0,0,0,0,0,0,0,0,0,0
4831,168062,2022,Türkiye,Japan,0,0,0,0,01/07/2022,0,0,7,7,0,0,0,0,0,0,0,0,6,1,8,15,7,1,0,8
4832,168062,2022,Japan,Netherlands,0,0,0,0,29/06/2022,0,0,3,3,0,0,0,0,0,0,0,0,11,0,9,20,12,3,0,15
4833,168062,2022,Japan,China,0,0,0,0,19/06/2022,0,0,0,0,0,0,0,0,0,0,0,0,0,0,0,0,0,0,0,0
4834,168062,2022,Japan,Thailand,0,0,0,0,17/06/2022,0,0,0,0,0,0,0,0,0,0,0,0,0,0,0,0,0,0,0,0
4835,168062,2022,Bulgaria,Japan,0,0,0,0,16/06/2022,1,0,3,4,0,0,0,0,0,0,0,0,5,0,7,12,18,6,1,25
4836,168062,2022,Japan,Poland,0,0,0,0,14/06/2022,0,0,0,0,0,0,0,0,0,0,0,0,0,0,0,0,0,0,0,0
4837,168062,2022,Japan,USA,0,0,0,0,05/06/2022,0,0,0,0,0,0,0,0,0,0,0,0,0,0,0,0,0,0,0,0
4838,168062,2022,Dominican Republic,Japan,0,0,0,0,04/06/2022,0,0,0,0,0,0,0,0,0,0,0,0,0,0,0,0,0,0,0,0
4839,168062,2022,Germany,Japan,0,0,0,0,02/06/2022,0,0,0,0,0,0,0,0,0,0,0,0,0,0,0,0,0,0,0,0
4840,168062,2022,Korea,Japan,0,0,0,0,02/06/2022,0,0,0,0,0,0,0,0,0,0,0,0,0,0,0,0,0,0,0,0
4841,146207,2022,Brazil,Japan,0,0,0,0,13/07/2022,0,0,0,0,0,0,0,0,0,0,0,0,0,0,0,0,0,0,0,0
4842,146207,2022,Belgium,Japan,2,1,8,11,03/07/2022,0,0,1,1,5,2,7,14,1,0,0,1,10,1,1,12,6,1,0,7
4843,146207,2022,Japan,Serbia,0,1,1,2,02/07/2022,0,0,2,2,3,2,4,9,0,0,0,0,5,0,5,10,2,0,0,2
4844,146207,2022,Türkiye,Japan,1,1,6,8,01/07/2022,0,0,4,4,8,2,4,14,0,0,1,1,10,1,7,18,6,0,0,6
4845,146207,2022,Japan,Netherlands,0,1,7,8,29/06/2022,0,0,0,0,4,1,10,15,0,1,0,1,10,2,10,22,0,0,0,0
4846,146207,2022,Japan,China,0,0,0,0,19/06/2022,0,0,0,0,0,0,0,0,0,0,0,0,0,0,0,0,0,0,0,0
4847,146207,2022,Japan,Thailand,0,0,0,0,17/06/2022,0,0,0,0,0,0,0,0,0,0,0,0,0,0,0,0,0,0,0,0
4848,146207,2022,Bulgaria,Japan,0,2,7,9,16/06/2022,0,0,2,2,9,1,4,14,0,0,1,1,7,0,17,24,8,0,0,8
4849,146207,2022,Japan,Poland,0,0,0,0,14/06/2022,0,0,0,0,0,0,0,0,0,0,0,0,0,0,0,0,0,0,0,0
4850,146207,2022,Japan,USA,0,0,0,0,05/06/2022,0,0,0,0,0,0,0,0,0,0,0,0,0,0,0,0,0,0,0,0
4851,146207,2022,Dominican Republic,Japan,0,0,6,6,04/06/2022,0,0,1,1,2,2,7,11,0,0,1,1,6,0,1,7,3,0,0,3
4852,146207,2022,Germany,Japan,2,0,15,17,02/06/2022,0,0,2,2,6,0,17,23,0,3,4,7,25,2,6,33,16,1,0,17
4853,146207,2022,Korea,Japan,0,0,9,9,02/06/2022,0,0,3,3,4,2,6,12,0,0,2,2,5,0,2,7,7,0,0,7
4854,143437,2022,Brazil,Japan,0,1,8,9,13/07/2022,0,0,1,1,12,6,25,43,1,1,1,3,11,1,31,43,5,3,2,10
4855,143437,2022,Belgium,Japan,1,1,13,15,03/07/2022,0,0,5,5,24,6,33,63,0,3,0,3,9,0,6,15,9,0,0,9
4856,143437,2022,Japan,Serbia,0,0,16,16,02/07/2022,0,0,3,3,13,5,31,49,1,1,2,4,8,1,11,20,11,1,0,12
4857,143437,2022,Türkiye,Japan,0,0,0,0,01/07/2022,0,0,0,0,0,0,0,0,0,0,0,0,0,0,0,0,0,0,0,0
4858,143437,2022,Japan,Netherlands,0,0,15,15,29/06/2022,0,0,0,0,31,3,35,69,0,1,2,3,18,0,11,29,7,3,0,10
4859,143437,2022,Japan,China,1,1,10,12,19/06/2022,0,0,1,1,17,3,23,43,4,2,2,8,5,3,23,31,15,3,0,18
4860,143437,2022,Japan,Thailand,0,1,10,11,17/06/2022,0,0,1,1,18,5,17,40,3,2,3,8,3,0,9,12,11,2,3,16
4861,143437,2022,Bulgaria,Japan,1,0,14,15,16/06/2022,0,0,2,2,17,2,12,31,0,1,4,5,4,0,12,16,9,1,0,10
4862,143437,2022,Japan,Poland,1,0,15,16,14/06/2022,0,0,0,0,16,3,12,31,2,1,2,5,3,0,9,12,6,1,1,8
4863,143437,2022,Japan,USA,0,2,10,12,05/06/2022,0,0,0,0,17,4,21,42,2,3,2,7,18,0,3,21,10,1,0,11
4864,143437,2022,Dominican Republic,Japan,0,1,13,14,04/06/2022,0,0,4,4,17,8,26,51,2,1,4,7,14,1,4,19,8,1,0,9
4865,143437,2022,Germany,Japan,0,2,18,20,02/06/2022,0,0,4,4,33,9,34,76,0,2,3,5,19,1,6,26,13,1,0,14
4866,143437,2022,Korea,Japan,0,1,13,14,02/06/2022,0,0,3,3,19,1,14,34,3,2,1,6,7,0,0,7,14,0,0,14
4867,162218,2022,Brazil,Japan,2,1,6,9,13/07/2022,0,0,1,1,6,2,4,12,0,0,1,1,6,0,5,11,4,3,1,8
4868,162218,2022,Belgium,Japan,0,1,7,8,03/07/2022,0,0,0,0,0,0,0,0,0,0,0,0,0,0,0,0,0,1,0,1
4869,162218,2022,Japan,Serbia,1,0,8,9,02/07/2022,0,0,0,0,8,1,19,28,0,3,0,3,4,0,1,5,9,2,0,11
4870,162218,2022,Türkiye,Japan,0,3,12,15,01/07/2022,0,0,5,5,19,8,18,45,0,2,1,3,13,0,5,18,6,1,0,7
4871,162218,2022,Japan,Netherlands,0,3,4,7,29/06/2022,0,0,0,0,10,3,4,17,0,0,1,1,3,1,9,13,5,0,0,5
4872,162218,2022,Japan,China,0,1,2,3,19/06/2022,0,0,0,0,0,0,0,0,0,0,0,0,0,0,0,0,0,0,0,0
4873,162218,2022,Japan,Thailand,0,0,8,8,17/06/2022,0,0,0,0,0,0,0,0,0,0,0,0,0,0,0,0,2,0,0,2
4874,162218,2022,Bulgaria,Japan,2,1,2,5,16/06/2022,0,0,1,1,0,4,4,8,0,1,1,2,1,0,1,2,0,1,0,1
4875,162218,2022,Japan,Poland,0,1,2,3,14/06/2022,0,0,0,0,0,0,0,0,0,0,0,0,0,0,0,0,0,0,0,0
4876,162218,2022,Japan,USA,0,0,2,2,05/06/2022,0,0,0,0,0,0,0,0,0,0,0,0,0,0,0,0,1,0,0,1
4877,162218,2022,Dominican Republic,Japan,0,1,0,1,04/06/2022,0,0,0,0,0,0,0,0,0,0,0,0,0,0,0,0,0,0,0,0
4878,162218,2022,Germany,Japan,0,1,12,13,02/06/2022,0,0,1,1,7,5,10,22,0,2,2,4,1,0,2,3,11,4,0,15
4879,162218,2022,Korea,Japan,2,1,15,18,02/06/2022,0,0,2,2,10,3,12,25,2,1,1,4,12,0,5,17,21,1,0,22
4880,141953,2022,Brazil,Japan,1,1,16,18,13/07/2022,0,0,3,3,6,1,9,16,1,3,6,10,0,0,0,0,4,1,0,5
4881,141953,2022,Belgium,Japan,0,0,10,10,03/07/2022,0,0,3,3,4,3,8,15,1,6,3,10,0,0,1,1,3,0,0,3
4882,141953,2022,Japan,Serbia,2,0,12,14,02/07/2022,0,0,1,1,10,2,9,21,0,3,0,3,0,0,0,0,2,1,1,4
4883,141953,2022,Türkiye,Japan,0,0,5,5,01/07/2022,0,0,3,3,2,2,5,9,1,2,1,4,2,0,1,3,2,1,0,3
4884,141953,2022,Japan,Netherlands,0,0,7,7,29/06/2022,0,0,0,0,5,1,3,9,1,3,3,7,0,0,0,0,1,0,0,1
4885,141953,2022,Japan,China,1,1,9,11,19/06/2022,0,0,1,1,5,2,4,11,1,3,3,7,0,0,1,1,0,0,0,0
4886,141953,2022,Japan,Thailand,0,0,8,8,17/06/2022,0,0,1,1,4,1,13,18,0,3,7,10,1,0,0,1,4,0,0,4
4887,141953,2022,Bulgaria,Japan,0,1,9,10,16/06/2022,0,0,1,1,3,0,10,13,2,2,4,8,0,0,1,1,2,1,1,4
4888,141953,2022,Japan,Poland,1,0,11,12,14/06/2022,0,0,1,1,9,1,6,16,0,3,0,3,0,0,1,1,3,0,1,4
4889,141953,2022,Japan,USA,0,0,8,8,05/06/2022,0,0,3,3,4,1,5,10,3,7,1,11,4,0,0,4,3,0,0,3
4890,141953,2022,Dominican Republic,Japan,0,1,7,8,04/06/2022,0,0,2,2,1,1,2,4,1,2,4,7,0,0,0,0,2,0,0,2
4891,141953,2022,Germany,Japan,0,0,0,0,02/06/2022,0,0,0,0,0,0,0,0,0,0,0,0,0,0,0,0,0,0,0,0
4892,141953,2022,Korea,Japan,0,0,0,0,02/06/2022,0,0,0,0,0,0,0,0,0,0,0,0,0,0,0,0,0,0,0,0
4893,152457,2022,,,-,-,-,-,-,-,-,-,-,-,-,-,-,-,-,-,-,-,-,-,-,-,-,-,-
4894,132100,2022,Japan,China,0,0,0,0,19/06/2022,0,0,0,0,0,0,0,0,0,0,0,0,0,0,0,0,0,0,0,0
4895,132100,2022,Japan,Thailand,0,0,0,0,17/06/2022,0,0,0,0,0,0,0,0,0,0,0,0,0,0,0,0,0,0,0,0
4896,132100,2022,Bulgaria,Japan,0,0,2,2,16/06/2022,0,0,1,1,0,0,0,0,0,0,0,0,0,0,0,0,1,0,0,1
4897,132100,2022,Japan,Poland,0,0,0,0,14/06/2022,0,0,0,0,0,0,0,0,0,0,0,0,0,0,0,0,0,0,0,0
4898,142367,2022,Brazil,Japan,0,0,0,0,13/07/2022,0,0,5,5,0,0,0,0,0,0,0,0,2,2,19,23,6,7,8,21
4899,142367,2022,Belgium,Japan,0,0,0,0,03/07/2022,0,0,14,14,0,0,0,0,0,0,0,0,15,0,13,28,21,1,0,22
4900,142367,2022,Japan,Serbia,0,0,0,0,02/07/2022,0,0,13,13,0,0,0,0,0,0,0,0,28,1,17,46,25,4,0,29
4901,142367,2022,Türkiye,Japan,0,0,0,0,01/07/2022,0,0,9,9,0,0,0,0,0,0,0,0,4,0,7,11,7,4,0,11
4902,142367,2022,Japan,Netherlands,0,0,0,0,29/06/2022,0,0,2,2,0,0,0,0,0,0,0,0,5,0,4,9,6,2,0,8
4903,142367,2022,Japan,China,0,0,0,0,19/06/2022,0,0,17,17,0,0,0,0,0,0,0,0,2,0,14,16,12,4,2,18
4904,142367,2022,Japan,Thailand,0,0,0,0,17/06/2022,1,0,8,9,0,0,0,0,0,0,0,0,4,0,14,18,20,3,0,23
4905,142367,2022,Bulgaria,Japan,0,0,0,0,16/06/2022,0,0,0,0,0,0,0,0,0,0,0,0,0,0,0,0,0,0,0,0
4906,142367,2022,Japan,Poland,0,0,0,0,14/06/2022,0,0,2,2,0,0,0,0,0,0,0,0,6,0,9,15,7,5,1,13
4907,142367,2022,Japan,USA,0,0,0,0,05/06/2022,0,0,9,9,0,0,0,0,0,0,0,0,11,0,8,19,16,4,2,22
4908,142367,2022,Dominican Republic,Japan,0,0,0,0,04/06/2022,0,0,14,14,0,0,0,0,0,0,0,0,19,1,6,26,27,2,0,29
4909,142367,2022,Germany,Japan,0,0,0,0,02/06/2022,0,0,12,12,0,0,0,0,0,0,0,0,16,1,11,28,29,5,4,38
4910,142367,2022,Korea,Japan,0,0,0,0,02/06/2022,0,0,12,12,0,0,0,0,0,0,0,0,3,2,0,5,6,2,0,8
4911,142372,2022,Brazil,Japan,1,1,6,8,13/07/2022,0,0,0,0,4,1,5,10,0,1,0,1,0,0,0,0,4,3,3,10
4912,142372,2022,Belgium,Japan,0,0,8,8,03/07/2022,0,0,2,2,7,3,19,29,0,1,1,2,0,0,0,0,8,0,1,9
4913,142372,2022,Japan,Serbia,1,0,7,8,02/07/2022,0,0,1,1,3,4,16,23,1,1,0,2,0,0,0,0,12,1,0,13
4914,142372,2022,Türkiye,Japan,1,1,5,7,01/07/2022,0,0,4,4,4,4,8,16,0,1,1,2,6,0,5,11,4,1,0,5
4915,142372,2022,Japan,Netherlands,1,1,8,10,29/06/2022,0,0,1,1,7,5,14,26,0,2,1,3,0,0,0,0,5,1,0,6
4916,142372,2022,Japan,China,2,2,18,22,19/06/2022,0,0,2,2,12,7,27,46,1,1,1,3,0,0,0,0,6,2,2,10
4917,142372,2022,Japan,Thailand,0,1,10,11,17/06/2022,0,0,0,0,17,1,19,37,1,1,8,10,0,0,0,0,14,2,0,16
4918,142372,2022,Bulgaria,Japan,0,1,9,10,16/06/2022,0,0,1,1,13,0,18,31,3,0,1,4,0,0,0,0,4,2,1,7
4919,142372,2022,Japan,Poland,0,3,8,11,14/06/2022,0,0,0,0,16,4,19,39,1,2,3,6,0,0,0,0,2,1,0,3
4920,142372,2022,Japan,USA,1,0,10,11,05/06/2022,0,0,1,1,17,2,24,43,1,3,3,7,1,0,0,1,16,1,0,17
4921,142372,2022,Dominican Republic,Japan,1,2,9,12,04/06/2022,0,0,3,3,22,2,17,41,3,0,2,5,0,0,0,0,15,3,1,19
4922,142372,2022,Germany,Japan,0,1,14,15,02/06/2022,0,0,7,7,13,1,15,29,0,0,3,3,0,0,0,0,10,1,1,12
4923,142372,2022,Korea,Japan,0,0,0,0,02/06/2022,0,0,1,1,0,0,0,0,0,0,0,0,0,0,0,0,0,0,0,0
4924,181174,2022,,,-,-,-,-,-,-,-,-,-,-,-,-,-,-,-,-,-,-,-,-,-,-,-,-,-
4925,162877,2022,Japan,USA,0,0,0,0,05/06/2022,0,0,0,0,0,0,0,0,0,0,0,0,0,0,0,0,0,0,0,0
4926,162877,2022,Dominican Republic,Japan,0,0,0,0,04/06/2022,0,0,1,1,2,1,1,4,0,0,0,0,0,0,0,0,0,0,0,0
4927,162877,2022,Germany,Japan,0,0,0,0,02/06/2022,0,0,0,0,0,0,0,0,0,0,0,0,0,0,0,0,0,0,0,0
4928,162877,2022,Korea,Japan,0,0,0,0,02/06/2022,0,0,0,0,0,0,0,0,0,0,0,0,0,0,0,0,0,0,0,0
4929,151953,2022,Brazil,Japan,1,2,10,13,13/07/2022,0,0,5,5,14,5,13,32,1,3,1,5,4,0,11,15,9,1,6,16
4930,151953,2022,Belgium,Japan,1,1,16,18,03/07/2022,0,0,7,7,16,3,11,30,0,5,2,7,16,1,7,24,20,1,0,21
4931,151953,2022,Japan,Serbia,1,2,11,14,02/07/2022,0,0,8,8,15,6,23,44,1,6,3,10,4,0,2,6,18,2,0,20
4932,151953,2022,Türkiye,Japan,0,0,12,12,01/07/2022,0,0,1,1,12,5,8,25,0,1,0,1,4,0,3,7,6,0,0,6
4933,151953,2022,Japan,Netherlands,0,0,4,4,29/06/2022,0,0,0,0,3,2,3,8,0,0,0,0,3,0,4,7,2,0,0,2
4934,151953,2022,Japan,China,1,1,9,11,19/06/2022,0,0,4,4,18,4,6,28,0,4,7,11,8,1,14,23,12,5,0,17
4935,151953,2022,Japan,Thailand,0,1,8,9,17/06/2022,1,0,1,2,6,4,13,23,1,0,3,4,9,0,7,16,9,2,0,11
4936,151953,2022,Bulgaria,Japan,0,0,0,0,16/06/2022,0,0,0,0,0,0,0,0,0,0,0,0,0,0,0,0,0,0,0,0
4937,151953,2022,Japan,Poland,1,2,6,9,14/06/2022,0,0,0,0,5,2,4,11,1,1,0,2,12,1,16,29,12,4,1,17
4938,151953,2022,Japan,USA,0,0,12,12,05/06/2022,0,0,2,2,5,2,6,13,0,3,4,7,7,0,1,8,14,1,0,15
4939,151953,2022,Dominican Republic,Japan,1,1,14,16,04/06/2022,0,0,0,0,5,2,9,16,0,1,4,5,10,1,1,12,12,0,0,12
4940,151953,2022,Germany,Japan,0,0,1,1,02/06/2022,0,0,0,0,0,0,0,0,0,0,0,0,0,0,0,0,0,0,0,0
4941,151953,2022,Korea,Japan,0,0,2,2,02/06/2022,0,0,0,0,0,0,0,0,0,0,0,0,0,0,0,0,0,0,0,0
4942,162227,2022,Brazil,Japan,0,0,2,2,13/07/2022,0,0,0,0,2,1,3,6,0,0,4,4,0,0,0,0,1,0,1,2
4943,162227,2022,Belgium,Japan,0,0,0,0,03/07/2022,0,0,0,0,0,0,0,0,0,0,0,0,0,0,0,0,0,0,0,0
4944,162227,2022,Japan,Serbia,0,2,2,4,02/07/2022,0,0,1,1,0,0,2,2,0,2,3,5,0,0,0,0,0,0,0,0
4945,162227,2022,Türkiye,Japan,1,1,4,6,01/07/2022,0,0,0,0,0,1,4,5,0,0,2,2,0,0,1,1,0,0,0,0
4946,162227,2022,Japan,Netherlands,2,1,12,15,29/06/2022,0,0,1,1,6,1,2,9,1,4,0,5,0,0,0,0,0,0,0,0
4947,162227,2022,Japan,USA,0,0,0,0,05/06/2022,0,0,0,0,0,0,0,0,0,0,0,0,0,0,0,0,0,0,0,0
4948,162227,2022,Dominican Republic,Japan,0,1,7,8,04/06/2022,0,0,1,1,1,0,2,3,0,3,2,5,0,0,0,0,1,0,0,1
4949,162227,2022,Germany,Japan,0,3,9,12,02/06/2022,0,0,2,2,4,1,8,13,1,2,5,8,0,0,0,0,5,0,0,5
4950,162227,2022,Korea,Japan,0,2,7,9,02/06/2022,0,0,2,2,5,0,7,12,0,2,4,6,0,0,0,0,4,1,0,5
4951,189198,2022,,,-,-,-,-,-,-,-,-,-,-,-,-,-,-,-,-,-,-,-,-,-,-,-,-,-
4952,189040,2022,Japan,China,0,0,16,16,19/06/2022,0,0,1,1,2,0,3,5,3,2,3,8,0,0,1,1,4,0,0,4
4953,189040,2022,Japan,Thailand,0,2,6,8,17/06/2022,0,0,2,2,6,0,3,9,1,1,5,7,0,0,0,0,2,0,0,2
4954,189040,2022,Bulgaria,Japan,0,1,5,6,16/06/2022,0,0,3,3,0,0,2,2,0,4,5,9,0,0,1,1,2,0,1,3
4955,189040,2022,Japan,Poland,1,2,9,12,14/06/2022,0,0,0,0,3,1,3,7,0,1,7,8,0,0,2,2,2,1,0,3
4956,162876,2022,Brazil,Japan,0,0,8,8,13/07/2022,32,1,55,88,3,0,0,3,0,1,5,6,0,0,0,0,6,5,5,16
4957,162876,2022,Belgium,Japan,1,0,11,12,03/07/2022,8,0,73,81,2,0,2,4,0,1,0,1,0,0,0,0,10,0,0,10
4958,162876,2022,Japan,Serbia,0,0,4,4,02/07/2022,0,1,34,35,1,0,0,1,0,1,0,1,0,0,0,0,3,1,0,4
4959,162876,2022,Türkiye,Japan,0,0,7,7,01/07/2022,0,0,24,24,0,0,0,0,0,1,0,1,0,0,0,0,4,0,0,4
4960,162876,2022,Japan,Netherlands,0,0,6,6,29/06/2022,8,0,55,63,0,0,2,2,0,0,1,1,0,0,0,0,3,2,0,5
4961,162876,2022,Japan,China,1,1,13,15,19/06/2022,20,1,60,81,1,0,2,3,0,1,1,2,0,0,0,0,12,2,0,14
4962,162876,2022,Japan,Thailand,0,0,0,0,17/06/2022,0,0,0,0,0,0,0,0,0,0,0,0,0,0,0,0,0,0,0,0
4963,162876,2022,Bulgaria,Japan,0,0,1,1,16/06/2022,2,0,8,10,1,0,0,1,0,0,0,0,0,0,0,0,1,0,1,2
4964,162876,2022,Japan,Poland,0,0,1,1,14/06/2022,0,0,0,0,0,0,0,0,0,0,0,0,0,0,0,0,0,0,0,0
4965,162876,2022,Japan,USA,0,0,0,0,05/06/2022,0,0,0,0,0,0,0,0,0,0,0,0,0,0,0,0,0,0,0,0
4966,162876,2022,Dominican Republic,Japan,0,0,2,2,04/06/2022,10,1,24,35,0,0,0,0,0,0,1,1,0,0,0,0,3,2,1,6
4967,162876,2022,Germany,Japan,0,0,6,6,02/06/2022,24,0,46,70,0,0,1,1,0,1,2,3,0,1,0,1,4,1,0,5
4968,162876,2022,Korea,Japan,0,0,8,8,02/06/2022,30,0,48,78,2,0,1,3,0,1,0,1,0,0,1,1,16,2,1,19
4969,163046,2022,Brazil,Japan,0,1,13,14,13/07/2022,0,0,2,2,3,4,4,11,2,6,2,10,0,0,0,0,3,2,1,6
4970,163046,2022,Belgium,Japan,0,0,0,0,03/07/2022,0,0,0,0,0,0,0,0,0,0,0,0,0,0,0,0,0,0,0,0
4971,163046,2022,Japan,Serbia,0,0,3,3,02/07/2022,0,0,0,0,0,1,3,4,0,1,0,1,0,0,0,0,2,0,0,2
4972,163046,2022,Türkiye,Japan,0,0,9,9,01/07/2022,0,1,0,1,2,1,5,8,0,3,1,4,0,0,0,0,1,0,0,1
4973,163046,2022,Japan,Netherlands,0,0,6,6,29/06/2022,0,0,1,1,1,2,2,5,0,0,0,0,0,0,0,0,1,0,0,1
4974,163046,2022,Japan,China,0,0,0,0,19/06/2022,0,0,0,0,0,0,0,0,0,0,0,0,0,0,0,0,0,0,0,0
4975,163046,2022,Japan,Thailand,0,0,0,0,17/06/2022,0,0,0,0,0,0,0,0,0,0,0,0,0,0,0,0,0,0,0,0
4976,163046,2022,Bulgaria,Japan,0,0,3,3,16/06/2022,0,0,0,0,3,0,1,4,0,0,2,2,0,0,0,0,0,1,0,1
4977,163046,2022,Japan,Poland,0,0,0,0,14/06/2022,0,0,0,0,0,0,0,0,0,0,0,0,0,0,0,0,0,0,0,0
4978,163046,2022,Japan,USA,2,3,12,17,05/06/2022,0,0,1,1,3,0,8,11,0,4,1,5,3,0,0,3,3,0,0,3
4979,163046,2022,Dominican Republic,Japan,1,1,7,9,04/06/2022,0,0,2,2,7,2,6,15,1,0,7,8,1,0,0,1,9,1,0,10
4980,163046,2022,Germany,Japan,2,1,9,12,02/06/2022,0,0,1,1,11,3,8,22,0,6,3,9,2,1,0,3,5,0,0,5
4981,163046,2022,Korea,Japan,0,0,10,10,02/06/2022,0,0,2,2,7,2,8,17,0,2,3,5,0,0,0,0,4,0,0,4
4982,146519,2022,Belgium,Japan,0,0,0,0,03/07/2022,0,0,0,0,0,0,0,0,0,0,0,0,0,0,0,0,0,0,0,0
4983,146519,2022,Japan,Serbia,0,0,0,0,02/07/2022,0,0,0,0,0,0,0,0,0,0,0,0,0,0,0,0,0,0,0,0
4984,146519,2022,Türkiye,Japan,0,1,4,5,01/07/2022,0,0,1,1,2,4,10,16,2,0,0,2,0,0,0,0,1,0,0,1
4985,146519,2022,Japan,Netherlands,1,0,5,6,29/06/2022,0,0,2,2,6,4,7,17,0,1,0,1,0,0,0,0,2,0,1,3
4986,161807,2022,Brazil,Japan,0,0,0,0,13/07/2022,0,0,0,0,0,0,0,0,0,0,0,0,0,0,0,0,0,0,0,0
4987,161807,2022,Belgium,Japan,0,1,7,8,03/07/2022,0,1,0,1,5,1,4,10,0,4,0,4,0,1,0,1,0,1,0,1
4988,161807,2022,Japan,Serbia,0,0,4,4,02/07/2022,0,0,2,2,1,1,6,8,0,3,1,4,0,0,0,0,0,0,0,0
4989,161807,2022,Türkiye,Japan,0,0,2,2,01/07/2022,0,0,1,1,1,1,2,4,2,0,0,2,0,0,0,0,0,0,0,0
4990,161807,2022,Japan,Netherlands,0,1,1,2,29/06/2022,0,0,0,0,3,1,4,8,0,0,0,0,0,0,2,2,0,0,0,0
4991,151944,2022,Brazil,Japan,0,0,4,4,13/07/2022,12,0,27,39,0,0,0,0,0,1,1,2,0,0,0,0,1,0,0,1
4992,151944,2022,Belgium,Japan,0,1,5,6,03/07/2022,4,1,53,58,1,0,1,2,0,1,0,1,0,0,0,0,4,0,0,4
4993,151944,2022,Japan,Serbia,0,1,8,9,02/07/2022,7,2,128,137,1,0,3,4,0,3,0,3,0,0,0,0,10,2,0,12
4994,151944,2022,Türkiye,Japan,1,0,6,7,01/07/2022,2,0,94,96,0,0,1,1,0,1,3,4,0,0,0,0,10,4,1,15
4995,151944,2022,Japan,Netherlands,1,1,15,17,29/06/2022,16,0,99,115,1,0,0,1,0,2,0,2,0,0,0,0,4,4,0,8
4996,151944,2022,Japan,China,0,0,1,1,19/06/2022,3,0,17,20,0,0,0,0,0,0,0,0,0,0,0,0,0,1,0,1
4997,151944,2022,Japan,Thailand,0,1,14,15,17/06/2022,31,0,79,110,0,0,0,0,0,0,7,7,0,0,0,0,6,0,0,6
4998,151944,2022,Bulgaria,Japan,0,1,6,7,16/06/2022,29,2,52,83,0,0,0,0,0,1,2,3,0,0,0,0,6,3,1,10
4999,151944,2022,Japan,Poland,0,2,7,9,14/06/2022,25,0,75,100,0,0,0,0,0,1,2,3,0,0,0,0,1,1,1,3
5000,151944,2022,Japan,USA,1,1,9,11,05/06/2022,19,0,79,98,1,0,2,3,0,2,3,5,0,0,0,0,10,0,0,10
5001,151944,2022,Dominican Republic,Japan,0,0,16,16,04/06/2022,23,0,54,77,3,0,0,3,0,1,6,7,0,0,0,0,13,1,0,14
5002,151944,2022,Germany,Japan,0,1,7,8,02/06/2022,25,1,57,83,0,0,0,0,0,1,0,1,0,0,0,0,10,0,0,10
5003,151944,2022,Korea,Japan,0,0,0,0,02/06/2022,0,0,0,0,0,0,0,0,0,0,0,0,0,0,0,0,0,0,0,0
5004,151955,2022,,,-,-,-,-,-,-,-,-,-,-,-,-,-,-,-,-,-,-,-,-,-,-,-,-,-
5005,162215,2022,,,-,-,-,-,-,-,-,-,-,-,-,-,-,-,-,-,-,-,-,-,-,-,-,-,-
5006,162225,2022,,,-,-,-,-,-,-,-,-,-,-,-,-,-,-,-,-,-,-,-,-,-,-,-,-,-
5007,189193,2022,Brazil,Japan,0,3,5,8,13/07/2022,0,0,1,1,9,4,10,23,0,1,2,3,0,0,0,0,3,3,3,9
5008,189193,2022,Japan,China,1,1,0,2,19/06/2022,0,0,0,0,0,0,0,0,0,0,0,0,0,0,0,0,0,0,0,0
5009,189193,2022,Japan,Thailand,0,1,2,3,17/06/2022,0,0,0,0,0,0,0,0,0,0,0,0,0,0,0,0,0,0,0,0
5010,189193,2022,Bulgaria,Japan,1,1,3,5,16/06/2022,0,0,0,0,0,0,0,0,0,0,0,0,0,0,0,0,0,0,0,0
5011,189193,2022,Japan,Poland,0,0,0,0,14/06/2022,0,0,0,0,0,0,0,0,0,0,0,0,0,0,0,0,0,0,0,0
5012,189193,2022,Japan,USA,0,0,1,1,05/06/2022,0,0,0,0,0,0,0,0,0,0,0,0,0,0,0,0,0,0,0,0
5013,189193,2022,Dominican Republic,Japan,0,1,1,2,04/06/2022,0,0,0,0,0,0,0,0,0,0,0,0,0,0,0,0,0,0,0,0
5014,189193,2022,Germany,Japan,0,0,8,8,02/06/2022,0,0,1,1,0,0,0,0,0,0,0,0,0,0,0,0,2,1,1,4
5015,189193,2022,Korea,Japan,0,1,3,4,02/06/2022,0,0,1,1,2,3,5,10,0,1,1,2,1,0,0,1,3,1,0,4
5016,174228,2022,,,-,-,-,-,-,-,-,-,-,-,-,-,-,-,-,-,-,-,-,-,-,-,-,-,-
5017,151962,2022,,,-,-,-,-,-,-,-,-,-,-,-,-,-,-,-,-,-,-,-,-,-,-,-,-,-
5018,189225,2022,,,-,-,-,-,-,-,-,-,-,-,-,-,-,-,-,-,-,-,-,-,-,-,-,-,-
5019,120148,2022,China,Korea,0,2,13,15,03/07/2022,10,1,122,133,0,1,2,3,0,2,2,4,0,0,0,0,12,1,1,14
5020,120148,2022,Italy,Korea,1,2,10,13,01/07/2022,7,1,91,99,0,0,0,0,0,0,2,2,0,0,1,1,6,2,1,9
5021,120148,2022,Korea,Brazil,1,2,6,9,30/06/2022,55,0,2,57,0,0,0,0,0,0,0,0,0,0,1,1,2,1,2,5
5022,120148,2022,Thailand,Korea,1,1,6,8,29/06/2022,45,1,2,48,0,1,0,1,0,0,1,1,0,0,0,0,3,0,1,4
5023,120148,2022,Türkiye,Korea,1,1,14,16,19/06/2022,23,1,91,115,0,0,2,2,0,7,4,11,0,0,0,0,4,0,1,5
5024,120148,2022,Netherlands,Korea,3,3,8,14,19/06/2022,25,2,62,89,0,0,1,1,0,2,0,2,0,0,0,0,3,3,1,7
5025,120148,2022,Serbia,Korea,0,2,11,13,16/06/2022,25,2,94,121,3,0,2,5,0,0,2,2,0,0,0,0,5,2,5,12
5026,120148,2022,Dominican Republic,Korea,1,3,9,13,15/06/2022,23,1,59,83,0,0,1,1,0,2,0,2,0,0,0,0,5,0,0,5
5027,120148,2022,Korea,Canada,0,0,6,6,05/06/2022,2,0,55,57,1,0,0,1,0,0,0,0,0,0,0,0,4,2,0,6
5028,120148,2022,Korea,Poland,0,2,3,5,04/06/2022,7,1,48,56,0,0,0,0,0,0,0,0,0,1,0,1,10,2,0,12
5029,120148,2022,Germany,Korea,1,1,10,12,03/06/2022,12,1,58,71,0,0,0,0,0,0,0,0,1,0,0,1,6,0,0,6
5030,120148,2022,Korea,Japan,0,1,8,9,02/06/2022,18,1,62,81,0,0,2,2,0,0,2,2,0,0,0,0,6,5,0,11
5031,181150,2022,China,Korea,0,0,0,0,03/07/2022,0,0,4,4,0,0,0,0,0,0,0,0,5,1,19,25,17,2,2,21
5032,181150,2022,Italy,Korea,0,0,0,0,01/07/2022,1,0,5,6,0,0,0,0,0,0,0,0,7,0,15,22,15,3,6,24
5033,181150,2022,Korea,Brazil,0,0,0,0,30/06/2022,1,0,1,2,0,0,0,0,0,0,0,0,7,0,15,22,9,1,2,12
5034,181150,2022,Thailand,Korea,0,0,0,0,29/06/2022,9,1,0,10,0,0,0,0,0,0,0,0,9,0,20,29,7,0,2,9
5035,181150,2022,Türkiye,Korea,0,0,0,0,19/06/2022,0,0,5,5,0,0,0,0,0,0,0,0,7,0,12,19,11,1,1,13
5036,181150,2022,Netherlands,Korea,0,0,0,0,19/06/2022,0,0,3,3,0,0,0,0,0,0,0,0,6,0,10,16,8,5,0,13
5037,181150,2022,Serbia,Korea,0,0,0,0,16/06/2022,0,0,8,8,0,0,0,0,0,0,0,0,5,0,6,11,8,4,2,14
5038,181150,2022,Dominican Republic,Korea,0,0,0,0,15/06/2022,0,0,8,8,0,0,0,0,0,0,0,0,13,0,10,23,7,4,0,11
5039,181150,2022,Korea,Canada,0,0,0,0,05/06/2022,0,0,1,1,0,0,0,0,0,0,0,0,9,1,0,10,13,2,0,15
5040,181150,2022,Korea,Poland,0,0,0,0,04/06/2022,0,0,0,0,0,0,0,0,0,0,0,0,0,0,0,0,0,0,0,0
5041,181150,2022,Germany,Korea,0,0,0,0,03/06/2022,0,0,0,0,0,0,0,0,0,0,0,0,0,0,0,0,0,0,0,0
5042,181150,2022,Korea,Japan,0,0,0,0,02/06/2022,0,0,0,0,0,0,0,0,0,0,0,0,0,0,0,0,0,0,0,0
5043,135948,2022,Korea,Canada,0,0,0,0,05/06/2022,0,0,1,1,0,0,0,0,0,0,0,0,4,0,2,6,3,0,0,3
5044,135948,2022,Korea,Poland,0,0,0,0,04/06/2022,0,0,12,12,0,0,0,0,0,0,0,0,12,0,3,15,14,3,2,19
5045,135948,2022,Germany,Korea,0,0,0,0,03/06/2022,0,0,4,4,0,0,0,0,0,0,0,0,6,0,7,13,10,2,0,12
5046,135948,2022,Korea,Japan,0,0,0,0,02/06/2022,0,0,7,7,0,0,0,0,0,0,0,0,7,0,4,11,17,5,1,23
5047,175172,2022,Netherlands,Korea,0,1,0,1,19/06/2022,0,0,1,1,2,2,3,7,0,1,0,1,1,0,0,1,1,0,0,1
5048,175172,2022,Serbia,Korea,0,4,6,10,16/06/2022,0,0,0,0,6,13,15,34,3,2,1,6,3,0,3,6,4,1,1,6
5049,175172,2022,Dominican Republic,Korea,0,2,1,3,15/06/2022,0,0,0,0,2,0,4,6,0,0,0,0,1,0,4,5,0,0,0,0
5050,175172,2022,Korea,Canada,0,2,2,4,05/06/2022,0,0,0,0,7,5,6,18,0,2,0,2,0,0,0,0,3,0,0,3
5051,175172,2022,Korea,Poland,0,1,2,3,04/06/2022,0,0,0,0,4,7,6,17,0,0,1,1,2,1,3,6,2,0,0,2
5052,175172,2022,Germany,Korea,5,3,4,12,03/06/2022,0,0,0,0,7,6,13,26,0,2,5,7,0,0,0,0,0,2,0,2
5053,175172,2022,Korea,Japan,2,1,2,5,02/06/2022,0,0,0,0,2,4,8,14,0,1,1,2,0,0,0,0,2,0,0,2
5054,156286,2022,China,Korea,1,1,14,16,03/07/2022,0,0,0,0,9,3,20,32,1,2,1,4,6,3,15,24,3,4,0,7
5055,156286,2022,Italy,Korea,0,2,7,9,01/07/2022,0,0,0,0,5,6,15,26,0,0,1,1,7,1,24,32,10,2,2,14
5056,156286,2022,Korea,Brazil,0,2,7,9,30/06/2022,5,0,0,5,4,3,14,21,2,0,0,2,5,2,12,19,4,2,2,8
5057,156286,2022,Thailand,Korea,0,3,6,9,29/06/2022,2,0,0,2,5,8,7,20,1,1,1,3,4,0,17,21,6,0,3,9
5058,156286,2022,Türkiye,Korea,0,2,8,10,19/06/2022,0,0,3,3,11,8,16,35,2,2,1,5,13,1,15,29,3,0,0,3
5059,156286,2022,Netherlands,Korea,0,3,5,8,19/06/2022,0,0,3,3,7,3,6,16,0,3,2,5,9,0,9,18,8,1,3,12
5060,156286,2022,Serbia,Korea,1,1,1,3,16/06/2022,0,0,1,1,1,0,3,4,0,0,1,1,0,0,0,0,0,0,0,0
5061,156286,2022,Dominican Republic,Korea,0,3,3,6,15/06/2022,0,0,1,1,3,2,6,11,2,0,0,2,2,1,13,16,1,0,0,1
5062,156286,2022,Korea,Canada,1,1,5,7,05/06/2022,0,0,3,3,6,4,9,19,0,3,3,6,7,0,7,14,6,0,0,6
5063,156286,2022,Korea,Poland,0,0,0,0,04/06/2022,0,0,0,0,0,0,0,0,0,0,0,0,0,0,0,0,0,0,0,0
5064,156286,2022,Germany,Korea,1,1,8,10,03/06/2022,0,0,3,3,12,2,14,28,0,3,5,8,5,2,4,11,4,0,0,4
5065,156286,2022,Korea,Japan,0,1,6,7,02/06/2022,0,0,3,3,9,3,13,25,2,0,0,2,18,0,9,27,7,3,0,10
5066,168184,2022,Türkiye,Korea,1,1,14,16,19/06/2022,0,0,0,0,7,4,2,13,2,1,1,4,0,0,1,1,1,1,0,2
5067,168184,2022,Netherlands,Korea,0,0,5,5,19/06/2022,0,0,0,0,3,1,3,7,1,5,3,9,0,0,0,0,1,0,0,1
5068,168184,2022,Serbia,Korea,0,1,14,15,16/06/2022,0,0,2,2,7,1,4,12,1,5,10,16,0,0,0,0,1,0,0,1
5069,168184,2022,Dominican Republic,Korea,0,3,2,5,15/06/2022,0,0,3,3,5,0,6,11,5,2,1,8,0,0,0,0,1,0,0,1
5070,168184,2022,Korea,Canada,0,0,8,8,05/06/2022,0,1,2,3,0,1,3,4,0,5,2,7,0,1,0,1,4,0,1,5
5071,168184,2022,Korea,Poland,0,1,9,10,04/06/2022,0,0,1,1,2,0,4,6,1,2,2,5,0,0,0,0,0,0,0,0
5072,168184,2022,Germany,Korea,0,0,4,4,03/06/2022,0,0,1,1,6,1,5,12,0,3,5,8,0,0,0,0,2,1,0,3
5073,168184,2022,Korea,Japan,0,0,5,5,02/06/2022,0,0,1,1,2,1,8,11,2,1,4,7,0,0,0,0,3,0,0,3
5074,163760,2022,China,Korea,2,1,16,19,03/07/2022,0,0,0,0,6,3,8,17,2,4,3,9,0,0,1,1,2,0,0,2
5075,163760,2022,Italy,Korea,0,2,7,9,01/07/2022,0,0,0,0,4,4,15,23,3,3,2,8,0,0,0,0,2,0,1,3
5076,163760,2022,Korea,Brazil,0,1,5,6,30/06/2022,0,0,0,0,7,5,6,18,1,6,2,9,0,0,1,1,0,0,1,1
5077,163760,2022,Thailand,Korea,0,1,12,13,29/06/2022,1,0,0,1,6,2,5,13,2,3,0,5,0,0,0,0,2,1,0,3
5078,163760,2022,Serbia,Korea,0,0,4,4,16/06/2022,0,0,0,0,0,0,0,0,0,0,0,0,0,0,0,0,0,0,0,0
5079,163760,2022,Dominican Republic,Korea,0,2,4,6,15/06/2022,0,0,1,1,4,0,2,6,1,5,1,7,1,0,0,1,0,0,0,0
5080,163760,2022,Korea,Canada,0,0,7,7,05/06/2022,0,0,1,1,0,0,2,2,0,1,2,3,0,0,0,0,1,0,0,1
5081,163760,2022,Korea,Poland,0,1,5,6,04/06/2022,0,0,0,0,4,3,2,9,3,0,1,4,0,0,1,1,0,0,0,0
5082,163760,2022,Germany,Korea,0,0,0,0,03/06/2022,0,0,0,0,0,0,0,0,0,0,0,0,0,0,0,0,0,0,0,0
5083,163760,2022,Korea,Japan,0,0,1,1,02/06/2022,0,0,0,0,0,0,0,0,0,0,0,0,0,0,0,0,0,0,0,0
5084,147380,2022,China,Korea,0,0,0,0,03/07/2022,0,0,0,0,0,0,0,0,0,0,0,0,0,0,0,0,0,0,0,0
5085,147380,2022,Italy,Korea,0,0,2,2,01/07/2022,0,0,0,0,0,0,3,3,0,1,0,1,2,0,4,6,1,0,0,1
5086,147380,2022,Korea,Brazil,0,1,2,3,30/06/2022,1,1,1,3,0,2,2,4,0,2,0,2,1,2,19,22,5,0,2,7
5087,147380,2022,Thailand,Korea,0,0,0,0,29/06/2022,0,0,0,0,0,0,0,0,0,0,0,0,0,0,0,0,0,0,0,0
5088,147380,2022,Türkiye,Korea,0,0,1,1,19/06/2022,0,0,0,0,0,0,0,0,0,0,0,0,0,0,0,0,0,0,0,0
5089,147380,2022,Netherlands,Korea,0,1,3,4,19/06/2022,0,0,2,2,2,0,2,4,0,0,0,0,3,1,1,5,0,0,1,1
5090,147380,2022,Serbia,Korea,1,1,9,11,16/06/2022,0,0,2,2,16,6,13,35,0,2,1,3,9,2,15,26,7,2,1,10
5091,147380,2022,Dominican Republic,Korea,0,0,0,0,15/06/2022,0,0,0,0,0,0,0,0,0,0,0,0,0,0,0,0,0,0,0,0
5092,147380,2022,Korea,Canada,0,0,0,0,05/06/2022,0,0,0,0,0,0,0,0,0,0,0,0,0,0,0,0,0,0,0,0
5093,147380,2022,Korea,Poland,0,0,0,0,04/06/2022,0,0,0,0,0,1,1,2,0,0,0,0,0,0,0,0,0,1,0,1
5094,147380,2022,Germany,Korea,0,0,0,0,03/06/2022,0,0,0,0,0,0,0,0,0,0,0,0,0,0,0,0,0,0,0,0
5095,147380,2022,Korea,Japan,0,0,0,0,02/06/2022,0,0,0,0,0,0,0,0,0,0,0,0,0,0,0,0,0,0,0,0
5096,163836,2022,China,Korea,0,0,0,0,03/07/2022,0,0,0,0,0,0,0,0,0,0,0,0,0,0,0,0,0,0,0,0
5097,163836,2022,Italy,Korea,0,0,0,0,01/07/2022,0,0,0,0,0,0,0,0,0,0,0,0,0,0,1,1,0,0,0,0
5098,163836,2022,Korea,Brazil,0,0,0,0,30/06/2022,0,0,0,0,0,0,0,0,0,0,0,0,0,0,0,0,0,0,0,0
5099,163836,2022,Thailand,Korea,0,0,1,1,29/06/2022,0,0,0,0,0,3,5,8,0,0,1,1,0,0,2,2,0,0,0,0
5100,163836,2022,Türkiye,Korea,0,0,2,2,19/06/2022,0,0,0,0,0,0,0,0,0,0,0,0,1,2,4,7,0,0,0,0
5101,163836,2022,Netherlands,Korea,0,0,0,0,19/06/2022,0,0,0,0,0,0,0,0,0,0,0,0,0,0,0,0,0,0,0,0
5102,163836,2022,Serbia,Korea,0,0,0,0,16/06/2022,0,0,0,0,0,0,0,0,0,0,0,0,0,0,0,0,0,0,0,0
5103,163836,2022,Dominican Republic,Korea,0,0,0,0,15/06/2022,0,0,0,0,0,0,0,0,0,0,0,0,0,0,0,0,0,0,0,0
5104,163822,2022,China,Korea,1,1,8,10,03/07/2022,0,0,0,0,9,2,9,20,1,5,3,9,0,0,0,0,2,1,1,4
5105,163822,2022,Italy,Korea,0,1,9,10,01/07/2022,0,0,2,2,7,3,9,19,2,6,3,11,1,1,1,3,2,1,1,4
5106,163822,2022,Korea,Brazil,1,0,10,11,30/06/2022,0,0,0,0,4,5,8,17,0,4,0,4,0,0,0,0,2,0,1,3
5107,163822,2022,Thailand,Korea,0,0,5,5,29/06/2022,0,0,0,0,5,3,4,12,2,4,1,7,0,0,0,0,2,0,0,2
5108,163822,2022,Türkiye,Korea,1,0,8,9,19/06/2022,0,0,0,0,4,4,2,10,1,2,5,8,0,0,0,0,2,0,0,2
5109,163822,2022,Netherlands,Korea,0,1,3,4,19/06/2022,0,0,0,0,2,0,2,4,1,4,2,7,0,0,0,0,1,0,0,1
5110,163822,2022,Serbia,Korea,1,0,14,15,16/06/2022,0,0,0,0,7,0,6,13,1,7,1,9,0,0,0,0,3,0,0,3
5111,163822,2022,Dominican Republic,Korea,0,0,0,0,15/06/2022,0,0,0,0,0,0,0,0,0,0,0,0,0,0,0,0,0,0,0,0
5112,163822,2022,Korea,Canada,2,0,2,4,05/06/2022,0,0,1,1,1,2,1,4,0,0,1,1,0,0,1,1,0,0,0,0
5113,163822,2022,Korea,Poland,0,0,0,0,04/06/2022,0,0,0,0,0,0,0,0,0,0,0,0,0,0,0,0,0,0,0,0
5114,163822,2022,Germany,Korea,0,1,5,6,03/06/2022,0,0,1,1,2,1,6,9,2,1,0,3,1,0,1,2,4,0,0,4
5115,163822,2022,Korea,Japan,0,0,4,4,02/06/2022,0,0,2,2,4,0,6,10,1,2,3,6,0,0,0,0,0,0,1,1
5116,131893,2022,China,Korea,0,1,10,11,03/07/2022,0,0,2,2,11,10,21,42,0,3,0,3,0,0,1,1,4,0,4,8
5117,131893,2022,Italy,Korea,0,1,15,16,01/07/2022,1,1,1,3,12,8,20,40,1,2,3,6,0,0,2,2,0,1,1,2
5118,131893,2022,Korea,Brazil,1,2,5,8,30/06/2022,0,1,0,1,13,6,14,33,3,2,0,5,0,0,0,0,3,1,3,7
5119,131893,2022,Thailand,Korea,0,1,4,5,29/06/2022,0,0,0,0,11,3,14,28,1,0,0,1,4,1,10,15,4,0,0,4
5120,131893,2022,Türkiye,Korea,0,0,9,9,19/06/2022,0,0,3,3,10,7,20,37,0,3,0,3,4,1,21,26,2,4,0,6
5121,131893,2022,Netherlands,Korea,0,2,5,7,19/06/2022,0,0,0,0,8,3,13,24,1,0,0,1,2,0,13,15,2,1,0,3
5122,131893,2022,Serbia,Korea,0,0,0,0,16/06/2022,0,0,0,0,0,0,0,0,0,0,0,0,0,0,0,0,0,0,0,0
5123,131893,2022,Dominican Republic,Korea,0,1,5,6,15/06/2022,0,0,1,1,3,1,17,21,0,1,0,1,3,1,8,12,1,1,1,3
5124,131893,2022,Korea,Canada,0,1,5,6,05/06/2022,0,0,0,0,4,3,12,19,1,1,0,2,7,2,13,22,2,2,0,4
5125,131893,2022,Korea,Poland,0,0,0,0,04/06/2022,0,0,0,0,0,1,1,2,0,0,0,0,3,0,1,4,0,1,0,1
5126,131893,2022,Germany,Korea,0,1,6,7,03/06/2022,0,0,2,2,5,5,8,18,0,2,2,4,20,1,8,29,11,2,0,13
5127,131893,2022,Korea,Japan,0,3,5,8,02/06/2022,0,0,2,2,6,2,15,23,1,0,0,1,14,2,12,28,6,4,0,10
5128,163832,2022,,,-,-,-,-,-,-,-,-,-,-,-,-,-,-,-,-,-,-,-,-,-,-,-,-,-
5129,119479,2022,China,Korea,0,0,0,0,03/07/2022,0,0,0,0,0,0,0,0,0,0,0,0,0,0,0,0,0,0,0,0
5130,119479,2022,Italy,Korea,0,0,0,0,01/07/2022,0,0,0,0,0,0,0,0,0,0,0,0,0,0,0,0,0,0,0,0
5131,119479,2022,Korea,Brazil,0,0,0,0,30/06/2022,0,0,0,0,0,0,0,0,0,0,0,0,0,0,0,0,0,0,0,0
5132,119479,2022,Thailand,Korea,0,0,0,0,29/06/2022,0,0,0,0,0,0,0,0,0,0,0,0,0,0,0,0,0,0,0,0
5133,119479,2022,Türkiye,Korea,0,0,1,1,19/06/2022,0,0,0,0,0,0,0,0,0,0,0,0,1,2,2,5,0,0,0,0
5134,119479,2022,Netherlands,Korea,0,0,2,2,19/06/2022,0,0,0,0,0,1,4,5,0,0,0,0,3,1,7,11,0,0,0,0
5135,119479,2022,Serbia,Korea,0,4,9,13,16/06/2022,0,0,1,1,12,7,17,36,1,2,0,3,16,0,19,35,6,2,0,8
5136,119479,2022,Dominican Republic,Korea,0,1,4,5,15/06/2022,0,0,0,0,3,0,2,5,0,0,0,0,4,0,2,6,1,0,0,1
5137,119479,2022,Korea,Canada,1,0,2,3,05/06/2022,0,0,0,0,2,0,1,3,0,0,0,0,4,0,3,7,3,0,1,4
5138,119479,2022,Korea,Poland,0,0,5,5,04/06/2022,0,0,4,4,2,3,5,10,0,1,1,2,13,2,5,20,1,0,0,1
5139,119479,2022,Germany,Korea,0,1,1,2,03/06/2022,0,0,0,0,0,0,0,0,0,0,0,0,0,0,0,0,0,0,0,0
5140,119479,2022,Korea,Japan,0,0,2,2,02/06/2022,0,0,1,1,0,0,5,5,1,0,2,3,1,0,2,3,3,0,0,3
5141,189224,2022,China,Korea,0,2,9,11,03/07/2022,0,0,2,2,12,6,14,32,0,2,2,4,7,0,27,34,7,2,2,11
5142,189224,2022,Italy,Korea,0,3,8,11,01/07/2022,0,1,0,1,14,3,10,27,0,2,1,3,4,0,15,19,4,0,2,6
5143,189224,2022,Korea,Brazil,0,0,2,2,30/06/2022,0,0,0,0,0,1,1,2,0,0,0,0,1,0,4,5,1,0,0,1
5144,189224,2022,Thailand,Korea,0,1,2,3,29/06/2022,0,0,0,0,3,2,10,15,0,1,1,2,1,0,0,1,1,0,0,1
5145,189224,2022,Türkiye,Korea,0,0,0,0,19/06/2022,0,0,0,0,0,0,0,0,0,0,0,0,0,0,0,0,0,0,0,0
5146,189224,2022,Netherlands,Korea,0,0,0,0,19/06/2022,0,0,0,0,0,0,0,0,0,0,0,0,0,0,0,0,0,0,0,0
5147,189224,2022,Serbia,Korea,0,0,0,0,16/06/2022,0,0,0,0,0,0,0,0,0,0,0,0,0,0,0,0,0,0,0,0
5148,189224,2022,Dominican Republic,Korea,0,0,0,0,15/06/2022,0,0,0,0,0,0,0,0,0,0,0,0,0,0,0,0,0,0,0,0
5149,189224,2022,Korea,Canada,0,0,1,1,05/06/2022,0,0,0,0,2,4,6,12,0,0,0,0,2,0,1,3,0,0,0,0
5150,189224,2022,Korea,Poland,0,1,7,8,04/06/2022,0,0,0,0,4,7,6,17,1,0,0,1,9,0,7,16,6,2,0,8
5151,189224,2022,Germany,Korea,0,0,1,1,03/06/2022,0,0,0,0,1,0,1,2,0,1,0,1,6,1,4,11,1,0,0,1
5152,189224,2022,Korea,Japan,0,0,0,0,02/06/2022,0,0,0,0,0,0,0,0,0,0,0,0,0,0,0,0,0,0,0,0
5153,175165,2022,China,Korea,0,0,0,0,03/07/2022,0,0,0,0,0,0,0,0,0,0,0,0,0,0,0,0,0,0,0,0
5154,175165,2022,Italy,Korea,0,0,0,0,01/07/2022,0,0,0,0,0,0,0,0,0,0,0,0,0,1,0,1,0,0,0,0
5155,175165,2022,Korea,Brazil,0,0,0,0,30/06/2022,0,0,0,0,0,0,0,0,0,0,0,0,0,0,0,0,0,0,0,0
5156,175165,2022,Thailand,Korea,0,0,0,0,29/06/2022,0,0,0,0,0,0,0,0,0,0,0,0,0,0,0,0,0,0,0,0
5157,175165,2022,Korea,Canada,0,0,0,0,05/06/2022,2,0,21,23,0,0,1,1,0,0,1,1,0,0,0,0,1,0,1,2
5158,175165,2022,Korea,Poland,0,0,0,0,04/06/2022,0,1,16,17,0,0,0,0,0,0,0,0,0,0,0,0,0,0,0,0
5159,175165,2022,Germany,Korea,0,0,0,0,03/06/2022,1,1,14,16,0,0,0,0,0,0,0,0,0,0,0,0,0,0,0,0
5160,175165,2022,Korea,Japan,0,0,0,0,02/06/2022,0,1,8,9,0,0,0,0,0,0,0,0,0,0,0,0,0,0,0,0
5161,175176,2022,China,Korea,0,0,0,0,03/07/2022,0,0,0,0,0,0,0,0,0,0,0,0,0,0,0,0,0,0,0,0
5162,175176,2022,Italy,Korea,0,0,0,0,01/07/2022,0,0,0,0,0,0,0,0,0,0,0,0,0,0,0,0,0,0,0,0
5163,175176,2022,Korea,Brazil,0,0,0,0,30/06/2022,0,0,0,0,0,0,0,0,0,0,0,0,0,0,0,0,0,0,0,0
5164,175176,2022,Thailand,Korea,0,0,0,0,29/06/2022,0,0,0,0,0,0,0,0,0,0,0,0,0,0,0,0,0,0,0,0
5165,175176,2022,Türkiye,Korea,0,0,0,0,19/06/2022,0,0,0,0,0,0,0,0,0,0,0,0,0,0,0,0,0,0,0,0
5166,175176,2022,Netherlands,Korea,0,0,0,0,19/06/2022,0,0,0,0,0,0,0,0,0,0,0,0,0,0,0,0,0,0,0,0
5167,175176,2022,Serbia,Korea,0,0,0,0,16/06/2022,0,0,0,0,0,0,0,0,0,0,0,0,0,0,0,0,0,0,0,0
5168,119484,2022,China,Korea,0,0,0,0,03/07/2022,0,0,0,0,0,0,0,0,0,0,0,0,0,0,0,0,0,0,0,0
5169,119484,2022,Italy,Korea,0,0,0,0,01/07/2022,0,0,0,0,0,0,0,0,0,0,0,0,0,0,0,0,0,0,0,0
5170,119484,2022,Korea,Brazil,0,0,0,0,30/06/2022,0,0,0,0,0,0,0,0,0,0,0,0,0,0,0,0,0,0,0,0
5171,119484,2022,Thailand,Korea,0,1,3,4,29/06/2022,0,0,0,0,3,5,8,16,0,3,1,4,0,0,0,0,0,0,0,0
5172,119484,2022,Türkiye,Korea,0,1,8,9,19/06/2022,0,0,1,1,10,6,13,29,1,4,3,8,0,0,0,0,4,3,1,8
5173,119484,2022,Netherlands,Korea,0,1,6,7,19/06/2022,0,0,0,0,10,1,14,25,2,1,1,4,0,0,0,0,3,0,1,4
5174,119484,2022,Serbia,Korea,0,0,0,0,16/06/2022,0,0,0,0,0,0,0,0,0,0,0,0,0,0,0,0,0,0,0,0
5175,119484,2022,Dominican Republic,Korea,0,5,4,9,15/06/2022,0,0,0,0,8,8,16,32,0,1,2,3,0,0,0,0,3,0,0,3
5176,119484,2022,Korea,Canada,0,1,4,5,05/06/2022,0,0,0,0,4,2,5,11,1,1,1,3,0,0,0,0,5,1,1,7
5177,119484,2022,Korea,Poland,1,2,5,8,04/06/2022,0,0,0,0,9,4,17,30,0,2,0,2,0,0,1,1,5,0,1,6
5178,119484,2022,Germany,Korea,0,0,0,0,03/06/2022,0,0,0,0,1,0,4,5,0,1,2,3,0,1,0,1,0,0,0,0
5179,119484,2022,Korea,Japan,0,1,3,4,02/06/2022,0,0,1,1,3,5,9,17,1,2,1,4,0,0,0,0,2,1,0,3
5180,151985,2022,,,-,-,-,-,-,-,-,-,-,-,-,-,-,-,-,-,-,-,-,-,-,-,-,-,-
5181,168183,2022,,,-,-,-,-,-,-,-,-,-,-,-,-,-,-,-,-,-,-,-,-,-,-,-,-,-
5182,151959,2022,China,Korea,0,0,0,0,03/07/2022,0,0,0,0,0,0,0,0,0,0,0,0,0,0,0,0,0,0,0,0
5183,151959,2022,Italy,Korea,0,1,6,7,01/07/2022,2,1,29,32,0,0,1,1,0,0,0,0,0,0,0,0,0,0,0,0
5184,151959,2022,Korea,Brazil,0,0,3,3,30/06/2022,22,0,0,22,0,0,0,0,0,0,0,0,0,0,0,0,0,0,0,0
5185,151959,2022,Thailand,Korea,0,0,3,3,29/06/2022,47,1,0,48,0,0,0,0,0,0,0,0,0,0,0,0,1,0,0,1
5186,168185,2022,,,-,-,-,-,-,-,-,-,-,-,-,-,-,-,-,-,-,-,-,-,-,-,-,-,-
5187,168182,2022,,,-,-,-,-,-,-,-,-,-,-,-,-,-,-,-,-,-,-,-,-,-,-,-,-,-
5188,153111,2022,,,-,-,-,-,-,-,-,-,-,-,-,-,-,-,-,-,-,-,-,-,-,-,-,-,-
5189,124071,2022,,,-,-,-,-,-,-,-,-,-,-,-,-,-,-,-,-,-,-,-,-,-,-,-,-,-
5190,150828,2022,Netherlands,Canada,3,2,15,20,03/07/2022,0,0,5,5,14,5,18,37,1,3,0,4,12,0,9,21,8,3,0,11
5191,150828,2022,Belgium,Netherlands,0,0,15,15,01/07/2022,0,0,4,4,15,4,20,39,3,2,0,5,13,1,19,33,15,0,0,15
5192,150828,2022,Türkiye,Netherlands,0,0,0,0,30/06/2022,0,0,0,0,0,0,0,0,0,0,0,0,0,0,0,0,0,0,0,0
5193,150828,2022,Japan,Netherlands,0,2,21,23,29/06/2022,0,0,2,2,17,3,20,40,3,2,1,6,6,1,9,16,8,3,0,11
5194,150828,2022,Netherlands,Korea,0,3,7,10,19/06/2022,0,0,1,1,4,1,5,10,1,0,1,2,2,1,8,11,7,1,1,9
5195,150828,2022,Netherlands,Dominican Republic,0,1,5,6,18/06/2022,0,0,2,2,12,5,13,30,1,0,0,1,10,0,11,21,3,2,1,6
5196,150828,2022,Netherlands,Brazil,0,0,0,0,17/06/2022,0,0,0,0,0,1,2,3,0,1,0,1,0,0,0,0,0,0,0,0
5197,150828,2022,Netherlands,Germany,2,2,5,9,14/06/2022,0,0,0,0,8,0,8,16,3,0,2,5,1,1,9,11,4,0,0,4
5198,150828,2022,Serbia,Netherlands,0,0,9,9,05/06/2022,0,0,3,3,5,4,8,17,0,1,1,2,6,3,20,29,2,2,4,8
5199,150828,2022,Netherlands,Italy,0,0,4,4,03/06/2022,0,0,0,0,3,5,10,18,1,0,1,2,1,0,10,11,1,1,0,2
5200,150828,2022,Bulgaria,Netherlands,1,0,8,9,02/06/2022,0,0,0,0,10,4,22,36,3,3,1,7,15,2,29,46,10,5,7,22
5201,150828,2022,China,Netherlands,0,0,17,17,01/06/2022,0,0,1,1,14,7,13,34,0,1,3,4,15,1,36,52,7,5,3,15
5202,189046,2022,,,-,-,-,-,-,-,-,-,-,-,-,-,-,-,-,-,-,-,-,-,-,-,-,-,-
5203,142880,2022,Netherlands,Canada,1,0,9,10,03/07/2022,0,0,3,3,16,7,19,42,2,2,1,5,0,0,0,0,13,1,0,14
5204,142880,2022,Belgium,Netherlands,0,1,3,4,01/07/2022,0,0,1,1,2,3,5,10,0,2,0,2,0,0,1,1,2,0,0,2
5205,142880,2022,Türkiye,Netherlands,0,1,7,8,30/06/2022,0,0,1,1,7,3,13,23,3,2,1,6,0,0,0,0,1,1,1,3
5206,142880,2022,Japan,Netherlands,0,0,17,17,29/06/2022,0,0,1,1,16,4,19,39,0,0,1,1,2,0,0,2,9,1,1,11
5207,142880,2022,Netherlands,Korea,0,0,12,12,19/06/2022,0,0,0,0,14,2,7,23,1,2,3,6,0,0,2,2,5,2,0,7
5208,142880,2022,Netherlands,Dominican Republic,0,0,3,3,18/06/2022,0,0,0,0,10,2,8,20,0,1,0,1,0,0,0,0,3,1,1,5
5209,142880,2022,Netherlands,Brazil,0,0,0,0,17/06/2022,0,0,0,0,0,0,0,0,0,0,0,0,0,0,0,0,0,0,0,0
5210,142880,2022,Netherlands,Germany,0,0,1,1,14/06/2022,0,0,0,0,0,2,1,3,0,0,0,0,1,0,0,1,2,0,0,2
5211,142880,2022,Serbia,Netherlands,0,3,9,12,05/06/2022,0,0,0,0,17,2,17,36,2,3,0,5,3,1,24,28,8,0,1,9
5212,142880,2022,Netherlands,Italy,1,0,4,5,03/06/2022,0,0,0,0,4,2,3,9,0,0,0,0,0,0,0,0,1,0,1,2
5213,142880,2022,Bulgaria,Netherlands,0,0,3,3,02/06/2022,0,0,0,0,3,3,6,12,0,2,0,2,0,0,1,1,1,0,0,1
5214,142880,2022,China,Netherlands,0,1,8,9,01/06/2022,0,2,2,4,22,5,17,44,2,1,7,10,0,0,0,0,3,6,4,13
5215,167482,2022,Netherlands,Canada,0,0,0,0,03/07/2022,0,0,0,0,0,0,0,0,0,0,0,0,0,0,0,0,0,0,0,0
5216,167482,2022,Belgium,Netherlands,0,0,0,0,01/07/2022,0,0,0,0,0,0,0,0,0,0,0,0,0,0,0,0,0,0,0,0
5217,167482,2022,Türkiye,Netherlands,0,0,0,0,30/06/2022,0,0,0,0,0,1,1,2,0,0,0,0,2,0,1,3,0,0,0,0
5218,167482,2022,Japan,Netherlands,0,0,0,0,29/06/2022,0,0,0,0,0,0,0,0,0,0,0,0,0,0,0,0,0,0,0,0
5219,167482,2022,Netherlands,Korea,0,0,0,0,19/06/2022,0,0,0,0,0,0,0,0,0,0,0,0,0,0,0,0,0,0,0,0
5220,167482,2022,Netherlands,Dominican Republic,0,0,6,6,18/06/2022,0,0,0,0,6,3,8,17,0,3,1,4,1,0,8,9,3,0,0,3
5221,167482,2022,Netherlands,Brazil,1,0,3,4,17/06/2022,0,0,0,0,9,3,12,24,2,0,0,2,7,1,9,17,4,0,1,5
5222,167482,2022,Netherlands,Germany,0,0,0,0,14/06/2022,0,0,0,0,0,0,0,0,0,0,0,0,0,0,0,0,0,0,0,0
5223,167482,2022,Serbia,Netherlands,0,0,0,0,05/06/2022,0,0,0,0,0,2,0,2,0,0,0,0,0,0,0,0,0,0,0,0
5224,167482,2022,Netherlands,Italy,0,0,4,4,03/06/2022,0,0,0,0,3,3,6,12,1,2,1,4,2,1,20,23,3,5,1,9
5225,167482,2022,Bulgaria,Netherlands,0,0,1,1,02/06/2022,0,0,0,0,3,0,3,6,0,0,1,1,1,2,1,4,0,2,0,2
5226,167482,2022,China,Netherlands,0,0,0,0,01/06/2022,0,0,0,0,0,0,1,1,0,0,0,0,0,0,1,1,0,0,0,0
5227,151194,2022,Netherlands,Canada,1,2,8,11,03/07/2022,0,0,2,2,4,2,10,16,1,5,3,9,0,0,0,0,2,0,0,2
5228,151194,2022,Belgium,Netherlands,3,0,13,16,01/07/2022,0,0,2,2,14,1,5,20,2,3,3,8,0,0,0,0,4,0,0,4
5229,151194,2022,Türkiye,Netherlands,0,0,5,5,30/06/2022,0,0,0,0,5,0,2,7,0,0,1,1,0,0,0,0,0,1,0,1
5230,151194,2022,Japan,Netherlands,3,2,13,18,29/06/2022,0,0,2,2,9,0,7,16,4,4,4,12,1,0,0,1,1,0,0,1
5231,151194,2022,Netherlands,Korea,1,0,12,13,19/06/2022,0,0,1,1,7,1,5,13,2,1,1,4,0,0,0,0,6,0,0,6
5232,151194,2022,Netherlands,Dominican Republic,0,1,18,19,18/06/2022,0,0,1,1,5,0,10,15,0,5,2,7,1,0,0,1,6,0,0,6
5233,151194,2022,Netherlands,Brazil,0,2,4,6,17/06/2022,0,0,0,0,3,1,4,8,3,5,3,11,0,0,0,0,0,0,0,0
5234,151194,2022,Netherlands,Germany,1,2,9,12,14/06/2022,0,0,0,0,3,1,5,9,4,6,3,13,0,0,0,0,2,0,0,2
5235,151194,2022,Serbia,Netherlands,0,0,12,12,05/06/2022,1,0,1,2,8,0,5,13,3,10,15,28,0,0,3,3,2,1,2,5
5236,151194,2022,Netherlands,Italy,1,1,5,7,03/06/2022,1,0,0,1,3,1,7,11,0,6,3,9,0,0,0,0,0,1,0,1
5237,151194,2022,Bulgaria,Netherlands,0,0,13,13,02/06/2022,0,0,6,6,5,1,6,12,3,3,10,16,0,0,0,0,3,2,1,6
5238,151194,2022,China,Netherlands,0,0,12,12,01/06/2022,0,0,2,2,9,1,3,13,3,2,5,10,1,0,1,2,0,0,0,0
5239,167777,2022,Netherlands,Canada,0,0,0,0,03/07/2022,0,0,0,0,0,0,0,0,0,0,0,0,0,0,0,0,0,0,0,0
5240,167777,2022,Belgium,Netherlands,0,0,0,0,01/07/2022,0,0,0,0,0,0,0,0,0,0,0,0,0,0,0,0,0,0,0,0
5241,167777,2022,Türkiye,Netherlands,0,0,0,0,30/06/2022,0,0,0,0,0,0,0,0,0,0,0,0,0,0,0,0,0,0,0,0
5242,167777,2022,Japan,Netherlands,0,0,0,0,29/06/2022,0,0,0,0,0,0,0,0,0,0,0,0,0,0,0,0,0,0,0,0
5243,123468,2022,Netherlands,Canada,0,0,0,0,03/07/2022,0,1,13,14,0,0,0,0,0,0,0,0,11,0,6,17,22,2,1,25
5244,123468,2022,Belgium,Netherlands,0,0,0,0,01/07/2022,0,1,8,9,0,0,0,0,0,0,0,0,8,0,9,17,23,3,0,26
5245,123468,2022,Türkiye,Netherlands,0,0,0,0,30/06/2022,0,0,10,10,0,0,0,0,0,0,0,0,9,1,4,14,8,3,0,11
5246,123468,2022,Japan,Netherlands,0,0,0,0,29/06/2022,0,0,6,6,0,0,0,0,0,0,0,0,10,1,6,17,18,3,0,21
5247,123468,2022,Netherlands,Korea,0,0,0,0,19/06/2022,0,0,2,2,0,0,0,0,0,0,0,0,9,1,8,18,10,3,0,13
5248,123468,2022,Netherlands,Dominican Republic,0,0,0,0,18/06/2022,0,0,7,7,0,0,0,0,0,0,0,0,13,2,10,25,11,3,2,16
5249,123468,2022,Netherlands,Brazil,0,0,0,0,17/06/2022,0,0,9,9,0,0,0,0,0,0,0,0,5,0,3,8,8,2,2,12
5250,123468,2022,Netherlands,Germany,0,0,0,0,14/06/2022,0,0,0,0,0,0,0,0,0,0,0,0,7,0,9,16,8,6,1,15
5251,123468,2022,Serbia,Netherlands,0,0,0,0,05/06/2022,1,0,10,11,0,0,0,0,0,0,0,0,0,0,15,15,20,3,5,28
5252,123468,2022,Netherlands,Italy,0,0,0,0,03/06/2022,1,0,3,4,0,0,0,0,0,0,0,0,5,1,14,20,10,7,3,20
5253,123468,2022,Bulgaria,Netherlands,0,0,0,0,02/06/2022,0,0,13,13,0,0,0,0,0,0,0,0,5,0,12,17,14,5,7,26
5254,123468,2022,China,Netherlands,0,0,0,0,01/06/2022,0,0,5,5,0,0,0,0,0,0,0,0,3,1,8,12,9,15,14,38
5255,162356,2022,Serbia,Netherlands,0,0,0,0,05/06/2022,0,0,0,0,0,0,0,0,0,0,0,0,0,0,0,0,0,0,0,0
5256,162356,2022,Netherlands,Italy,0,0,0,0,03/06/2022,0,0,9,9,0,0,0,0,0,0,0,0,0,0,0,0,1,0,0,1
5257,162356,2022,Bulgaria,Netherlands,0,0,2,2,02/06/2022,3,0,13,16,0,0,0,0,0,0,2,2,0,0,0,0,4,1,1,6
5258,162356,2022,China,Netherlands,0,0,1,1,01/06/2022,0,0,8,8,0,0,0,0,0,0,0,0,0,0,0,0,1,0,0,1
5259,120503,2022,Netherlands,Canada,1,0,18,19,03/07/2022,0,0,6,6,12,5,21,38,1,2,1,4,21,2,20,43,18,4,1,23
5260,120503,2022,Belgium,Netherlands,0,0,14,14,01/07/2022,0,0,3,3,11,4,23,38,0,3,4,7,13,0,9,22,11,1,0,12
5261,120503,2022,Türkiye,Netherlands,0,1,10,11,30/06/2022,0,0,0,0,7,2,16,25,0,0,0,0,14,3,22,39,4,1,0,5
5262,120503,2022,Japan,Netherlands,0,1,16,17,29/06/2022,0,0,1,1,19,4,21,44,3,2,3,8,33,2,18,53,10,3,0,13
5263,120503,2022,Netherlands,Korea,0,0,12,12,19/06/2022,0,0,1,1,15,1,10,26,0,1,3,4,4,0,2,6,7,2,0,9
5264,120503,2022,Netherlands,Dominican Republic,0,1,13,14,18/06/2022,0,0,0,0,19,5,23,47,0,2,3,5,17,0,13,30,8,0,2,10
5265,120503,2022,Netherlands,Brazil,0,1,6,7,17/06/2022,0,0,0,0,7,5,23,35,0,1,1,2,15,1,17,33,1,7,2,10
5266,120503,2022,Netherlands,Germany,0,0,14,14,14/06/2022,0,0,0,0,18,3,17,38,1,3,2,6,12,0,16,28,6,5,1,12
5267,147432,2022,Netherlands,Canada,1,0,17,18,03/07/2022,3,1,134,138,1,0,2,3,0,1,1,2,0,0,0,0,11,4,0,15
5268,147432,2022,Belgium,Netherlands,0,0,16,16,01/07/2022,8,1,119,128,2,0,2,4,0,5,1,6,0,0,0,0,15,0,0,15
5269,147432,2022,Türkiye,Netherlands,0,1,8,9,30/06/2022,4,0,77,81,0,0,1,1,0,0,0,0,0,0,0,0,2,1,0,3
5270,147432,2022,Japan,Netherlands,0,1,9,10,29/06/2022,24,0,114,138,2,0,1,3,1,3,0,4,0,0,0,0,1,1,0,2
5271,147432,2022,Netherlands,Korea,1,2,11,14,19/06/2022,23,1,53,77,0,0,0,0,0,1,3,4,0,1,0,1,5,0,1,6
5272,147432,2022,Netherlands,Dominican Republic,0,1,14,15,18/06/2022,44,1,100,145,1,2,2,5,0,2,3,5,0,0,0,0,8,3,2,13
5273,147432,2022,Netherlands,Brazil,1,0,7,8,17/06/2022,11,1,37,49,1,1,0,2,0,1,1,2,0,0,0,0,1,2,1,4
5274,147432,2022,Netherlands,Germany,0,0,12,12,14/06/2022,27,0,82,109,0,0,1,1,0,3,3,6,0,0,0,0,4,5,0,9
5275,147432,2022,Serbia,Netherlands,2,0,15,17,05/06/2022,64,1,71,136,0,0,4,4,1,1,6,8,0,1,0,1,9,5,4,18
5276,147432,2022,Netherlands,Italy,0,0,5,5,03/06/2022,22,0,45,67,0,0,2,2,1,4,5,10,0,0,0,0,4,2,3,9
5277,147432,2022,Bulgaria,Netherlands,0,1,19,20,02/06/2022,17,1,81,99,1,0,2,3,0,4,9,13,0,0,0,0,6,6,7,19
5278,147432,2022,China,Netherlands,0,1,12,13,01/06/2022,15,0,96,111,2,1,3,6,1,3,6,10,0,0,0,0,5,3,3,11
5279,176465,2022,,,-,-,-,-,-,-,-,-,-,-,-,-,-,-,-,-,-,-,-,-,-,-,-,-,-
5280,124070,2022,Netherlands,Canada,0,0,0,0,03/07/2022,0,0,1,1,0,0,0,0,0,0,0,0,0,0,0,0,0,0,0,0
5281,124070,2022,Belgium,Netherlands,0,0,3,3,01/07/2022,0,0,3,3,0,0,0,0,0,0,0,0,0,0,0,0,1,0,0,1
5282,124070,2022,Türkiye,Netherlands,0,0,0,0,30/06/2022,0,1,12,13,0,0,0,0,0,1,0,1,0,0,0,0,4,1,0,5
5283,124070,2022,Japan,Netherlands,0,0,6,6,29/06/2022,1,0,12,13,0,0,0,0,0,0,0,0,0,0,0,0,0,0,0,0
5284,124070,2022,Netherlands,Korea,0,0,0,0,19/06/2022,0,0,0,0,0,0,0,0,0,0,0,0,0,0,0,0,0,0,0,0
5285,124070,2022,Netherlands,Dominican Republic,0,0,0,0,18/06/2022,5,0,9,14,0,0,0,0,0,0,0,0,0,0,0,0,2,0,0,2
5286,124070,2022,Netherlands,Brazil,0,1,6,7,17/06/2022,14,1,30,45,0,0,0,0,0,0,0,0,0,0,0,0,2,2,1,5
5287,124070,2022,Netherlands,Germany,0,0,1,1,14/06/2022,1,0,7,8,0,0,0,0,0,0,0,0,0,0,0,0,0,0,0,0
5288,168148,2022,Netherlands,Canada,0,0,0,0,03/07/2022,0,0,0,0,0,0,0,0,0,0,0,0,0,0,0,0,0,0,0,0
5289,168148,2022,Belgium,Netherlands,0,0,0,0,01/07/2022,0,0,0,0,0,0,0,0,0,0,0,0,0,0,0,0,0,0,0,0
5290,168148,2022,Türkiye,Netherlands,0,2,2,4,30/06/2022,0,0,0,0,2,2,4,8,1,0,0,1,0,0,0,0,1,0,0,1
5291,168148,2022,Japan,Netherlands,0,0,0,0,29/06/2022,0,0,0,0,0,0,0,0,0,0,0,0,0,0,0,0,0,0,0,0
5292,168148,2022,Netherlands,Korea,0,0,0,0,19/06/2022,0,0,0,0,0,0,0,0,0,0,0,0,0,0,0,0,0,0,0,0
5293,168148,2022,Netherlands,Dominican Republic,0,0,0,0,18/06/2022,0,0,0,0,0,0,0,0,0,0,0,0,0,0,0,0,0,0,0,0
5294,168148,2022,Netherlands,Brazil,0,0,0,0,17/06/2022,0,0,0,0,0,0,0,0,0,0,0,0,0,0,0,0,0,0,0,0
5295,168148,2022,Netherlands,Germany,0,0,0,0,14/06/2022,0,0,0,0,0,0,0,0,0,0,0,0,0,0,0,0,0,0,0,0
5296,168148,2022,Serbia,Netherlands,0,0,0,0,05/06/2022,0,0,0,0,1,0,0,1,0,0,0,0,0,0,0,0,0,0,0,0
5297,168148,2022,Netherlands,Italy,0,0,0,0,03/06/2022,0,0,0,0,0,0,0,0,0,0,0,0,0,0,0,0,0,0,0,0
5298,168148,2022,Bulgaria,Netherlands,0,0,0,0,02/06/2022,0,0,0,0,0,0,0,0,0,0,0,0,0,0,0,0,0,0,0,0
5299,168148,2022,China,Netherlands,0,0,0,0,01/06/2022,0,0,0,0,0,0,0,0,0,0,0,0,0,0,0,0,0,0,0,0
5300,181648,2022,Serbia,Netherlands,0,0,0,0,05/06/2022,0,0,0,0,0,0,0,0,0,0,0,0,0,0,0,0,0,0,0,0
5301,181648,2022,Netherlands,Italy,0,0,0,0,03/06/2022,0,0,0,0,0,0,0,0,0,0,0,0,0,0,0,0,0,0,0,0
5302,181648,2022,Bulgaria,Netherlands,0,0,0,0,02/06/2022,0,0,0,0,0,0,0,0,0,0,0,0,0,0,0,0,0,0,0,0
5303,181648,2022,China,Netherlands,0,0,0,0,01/06/2022,0,0,0,0,0,0,0,0,0,0,0,0,0,0,0,0,0,0,0,0
5304,159904,2022,Netherlands,Canada,0,0,0,0,03/07/2022,0,0,1,1,0,0,0,0,0,0,0,0,1,0,2,3,4,0,0,4
5305,159904,2022,Belgium,Netherlands,0,1,1,2,01/07/2022,0,0,0,0,2,2,4,8,2,0,0,2,5,0,1,6,1,2,0,3
5306,159904,2022,Türkiye,Netherlands,0,0,10,10,30/06/2022,0,0,0,0,5,3,13,21,1,4,0,5,5,0,5,10,2,1,0,3
5307,159904,2022,Japan,Netherlands,0,0,0,0,29/06/2022,0,0,0,0,0,0,0,0,0,0,0,0,1,0,2,3,1,1,0,2
5308,159904,2022,Netherlands,Korea,0,0,1,1,19/06/2022,0,0,0,0,0,0,0,0,0,0,0,0,0,0,0,0,0,0,0,0
5309,159904,2022,Netherlands,Dominican Republic,0,0,2,2,18/06/2022,0,0,0,0,0,0,0,0,0,0,0,0,0,1,2,3,0,0,0,0
5310,159904,2022,Netherlands,Brazil,0,0,6,6,17/06/2022,0,0,0,0,0,0,0,0,0,0,0,0,2,0,4,6,4,0,0,4
5311,159904,2022,Netherlands,Germany,1,1,6,8,14/06/2022,0,0,0,0,1,3,5,9,0,0,1,1,5,0,10,15,1,2,1,4
5312,159904,2022,Serbia,Netherlands,0,1,19,20,05/06/2022,0,0,3,3,6,7,17,30,1,2,2,5,7,0,12,19,11,4,3,18
5313,159904,2022,Netherlands,Italy,0,1,7,8,03/06/2022,0,0,0,0,2,2,4,8,0,0,0,0,3,1,6,10,3,0,0,3
5314,159904,2022,Bulgaria,Netherlands,0,0,12,12,02/06/2022,0,0,5,5,10,5,12,27,0,1,0,1,4,2,12,18,15,9,3,27
5315,159904,2022,China,Netherlands,1,0,19,20,01/06/2022,0,0,2,2,11,1,9,21,0,2,5,7,4,1,14,19,11,5,9,25
5316,150809,2022,Netherlands,Korea,0,0,0,0,19/06/2022,0,0,0,0,0,0,0,0,0,0,0,0,0,0,0,0,0,0,0,0
5317,150809,2022,Netherlands,Dominican Republic,0,0,0,0,18/06/2022,0,0,0,0,0,0,0,0,0,0,0,0,0,0,0,0,0,0,0,0
5318,150809,2022,Netherlands,Brazil,0,0,0,0,17/06/2022,0,0,0,0,0,0,0,0,0,0,0,0,0,0,0,0,0,0,0,0
5319,150809,2022,Netherlands,Germany,0,0,0,0,14/06/2022,0,0,0,0,0,0,0,0,0,0,0,0,0,0,0,0,0,0,0,0
5320,150808,2022,,,-,-,-,-,-,-,-,-,-,-,-,-,-,-,-,-,-,-,-,-,-,-,-,-,-
5321,181647,2022,,,-,-,-,-,-,-,-,-,-,-,-,-,-,-,-,-,-,-,-,-,-,-,-,-,-
5322,172894,2022,Netherlands,Canada,0,1,17,18,03/07/2022,0,0,2,2,5,1,6,12,6,6,1,13,0,0,0,0,3,2,0,5
5323,172894,2022,Belgium,Netherlands,1,2,15,18,01/07/2022,0,0,2,2,5,2,6,13,4,7,8,19,0,0,0,0,5,1,0,6
5324,172894,2022,Türkiye,Netherlands,0,1,6,7,30/06/2022,0,1,0,1,5,1,4,10,3,5,1,9,1,0,1,2,2,0,0,2
5325,172894,2022,Japan,Netherlands,1,2,17,20,29/06/2022,0,0,1,1,12,1,7,20,3,4,1,8,1,1,1,3,1,1,0,2
5326,172894,2022,Netherlands,Korea,0,2,9,11,19/06/2022,0,0,2,2,7,0,3,10,2,6,3,11,2,0,0,2,1,0,0,1
5327,172894,2022,Netherlands,Dominican Republic,1,0,18,19,18/06/2022,0,0,1,1,6,1,9,16,5,5,6,16,3,0,0,3,8,1,1,10
5328,172894,2022,Netherlands,Brazil,1,2,8,11,17/06/2022,0,0,1,1,5,1,3,9,1,3,1,5,0,0,0,0,1,0,0,1
5329,172894,2022,Netherlands,Germany,0,2,13,15,14/06/2022,0,0,0,0,6,1,6,13,1,10,6,17,0,0,1,1,2,1,0,3
5330,172894,2022,Serbia,Netherlands,2,1,14,17,05/06/2022,0,0,3,3,11,3,8,22,5,12,17,34,0,0,1,1,4,1,1,6
5331,172894,2022,Netherlands,Italy,0,2,7,9,03/06/2022,0,0,1,1,2,1,4,7,0,3,0,3,1,0,0,1,1,0,1,2
5332,172894,2022,Bulgaria,Netherlands,1,0,11,12,02/06/2022,0,0,2,2,8,0,4,12,3,9,7,19,0,0,0,0,3,4,1,8
5333,172894,2022,China,Netherlands,0,0,19,19,01/06/2022,0,0,1,1,6,1,6,13,3,9,6,18,0,0,0,0,4,5,4,13
5334,162357,2022,Serbia,Netherlands,0,0,0,0,05/06/2022,0,0,0,0,0,0,0,0,0,0,0,0,0,0,0,0,0,0,0,0
5335,162357,2022,Netherlands,Italy,0,0,0,0,03/06/2022,0,0,0,0,0,0,0,0,0,0,0,0,0,0,0,0,0,0,0,0
5336,162357,2022,Bulgaria,Netherlands,0,0,0,0,02/06/2022,0,0,0,0,0,0,0,0,0,0,0,0,0,0,0,0,0,0,0,0
5337,162357,2022,China,Netherlands,0,0,0,0,01/06/2022,0,0,0,0,0,0,0,0,0,0,0,0,0,0,0,0,0,0,0,0
5338,148581,2022,Netherlands,Canada,0,0,0,0,03/07/2022,0,0,0,0,0,0,0,0,0,0,0,0,0,0,0,0,0,0,0,0
5339,148581,2022,Belgium,Netherlands,0,0,0,0,01/07/2022,0,0,0,0,0,0,0,0,0,0,0,0,0,0,0,0,0,0,0,0
5340,148581,2022,Türkiye,Netherlands,0,0,0,0,30/06/2022,0,0,0,0,0,0,0,0,0,0,0,0,0,0,0,0,0,0,0,0
5341,148581,2022,Japan,Netherlands,0,0,0,0,29/06/2022,0,0,0,0,0,0,0,0,0,0,0,0,0,0,0,0,0,0,0,0
5342,148581,2022,Netherlands,Korea,0,0,0,0,19/06/2022,0,0,0,0,0,0,0,0,0,0,0,0,0,0,0,0,0,0,0,0
5343,148581,2022,Netherlands,Dominican Republic,0,0,0,0,18/06/2022,0,0,0,0,0,0,0,0,0,0,0,0,0,0,0,0,0,0,0,0
5344,148581,2022,Netherlands,Brazil,0,0,0,0,17/06/2022,0,0,1,1,0,0,0,0,0,0,0,0,0,0,1,1,1,2,1,4
5345,148581,2022,Netherlands,Germany,0,0,0,0,14/06/2022,0,0,0,0,1,0,0,1,0,0,0,0,0,0,0,0,0,0,0,0
5346,148581,2022,Serbia,Netherlands,0,0,0,0,05/06/2022,0,0,0,0,0,0,0,0,0,0,0,0,0,0,0,0,0,0,0,0
5347,148581,2022,Netherlands,Italy,0,0,0,0,03/06/2022,0,0,0,0,0,0,0,0,0,0,0,0,0,0,0,0,0,0,0,0
5348,148581,2022,Bulgaria,Netherlands,0,0,0,0,02/06/2022,0,0,0,0,0,0,1,1,0,0,0,0,0,0,0,0,1,0,1,2
5349,148581,2022,China,Netherlands,0,0,0,0,01/06/2022,0,0,0,0,0,0,1,1,0,0,0,0,0,0,0,0,0,0,0,0
5350,181248,2022,Netherlands,Canada,0,1,2,3,03/07/2022,0,1,0,1,2,1,4,7,0,1,0,1,0,0,0,0,1,0,0,1
5351,181248,2022,Belgium,Netherlands,1,2,5,8,01/07/2022,0,0,5,5,8,3,9,20,3,2,2,7,0,0,0,0,7,1,0,8
5352,181248,2022,Türkiye,Netherlands,0,1,1,2,30/06/2022,0,0,0,0,0,0,4,4,0,0,0,0,0,0,0,0,0,0,0,0
5353,181248,2022,Japan,Netherlands,0,0,0,0,29/06/2022,0,0,1,1,0,0,1,1,2,0,2,4,0,0,0,0,0,0,0,0
5354,181248,2022,Netherlands,Korea,0,0,0,0,19/06/2022,0,0,0,0,0,0,0,0,0,0,0,0,0,0,0,0,0,0,0,0
5355,181248,2022,Netherlands,Dominican Republic,1,5,9,15,18/06/2022,0,0,1,1,8,2,19,29,0,3,3,6,0,0,1,1,6,3,2,11
5356,181248,2022,Netherlands,Brazil,0,2,5,7,17/06/2022,0,0,0,0,1,9,9,19,1,3,0,4,0,0,1,1,4,0,0,4
5357,181248,2022,Netherlands,Germany,1,3,11,15,14/06/2022,0,0,0,0,14,3,19,36,0,1,1,2,0,0,0,0,1,2,1,4
5358,181248,2022,Serbia,Netherlands,1,3,13,17,05/06/2022,2,0,1,3,17,6,13,36,1,5,3,9,0,0,0,0,14,2,2,18
5359,181248,2022,Netherlands,Italy,0,0,9,9,03/06/2022,0,0,1,1,11,4,5,20,0,0,1,1,0,0,0,0,4,3,2,9
5360,181248,2022,Bulgaria,Netherlands,0,4,10,14,02/06/2022,0,0,2,2,13,5,16,34,1,1,4,6,0,0,0,0,7,3,3,13
5361,181248,2022,China,Netherlands,0,0,2,2,01/06/2022,0,0,0,0,5,0,3,8,0,0,0,0,0,0,0,0,0,1,1,2
5362,162372,2022,,,-,-,-,-,-,-,-,-,-,-,-,-,-,-,-,-,-,-,-,-,-,-,-,-,-
5363,181249,2022,,,-,-,-,-,-,-,-,-,-,-,-,-,-,-,-,-,-,-,-,-,-,-,-,-,-
5364,152233,2022,Poland,Bulgaria,0,0,0,0,03/07/2022,0,1,2,3,0,0,0,0,0,0,0,0,8,0,16,24,6,2,2,10
5365,152233,2022,Dominican Republic,Poland,0,0,0,0,02/07/2022,0,0,4,4,0,0,0,0,0,0,0,0,18,2,29,49,16,4,4,24
5366,152233,2022,Poland,China,0,0,0,0,30/06/2022,0,0,7,7,0,0,0,0,0,0,0,0,9,2,16,27,8,1,4,13
5367,152233,2022,Italy,Poland,0,0,0,0,29/06/2022,7,0,0,7,0,0,0,0,0,0,0,0,5,0,20,25,17,3,1,21
5368,152233,2022,Belgium,Poland,0,0,0,0,18/06/2022,0,0,12,12,0,0,0,0,0,0,0,0,6,1,21,28,27,4,2,33
5369,152233,2022,Poland,USA,0,0,0,0,17/06/2022,0,0,10,10,0,0,0,0,0,0,0,0,9,0,16,25,9,1,0,10
5370,152233,2022,Poland,Thailand,0,0,0,0,16/06/2022,1,0,16,17,0,0,0,0,0,0,0,0,10,3,16,29,27,2,2,31
5371,152233,2022,Japan,Poland,0,0,0,0,14/06/2022,1,0,7,8,0,0,0,0,0,0,0,0,11,0,7,18,13,3,0,16
5372,152233,2022,Poland,Germany,0,0,0,0,05/06/2022,0,0,8,8,0,0,0,0,0,0,0,0,18,1,12,31,14,3,1,18
5373,152233,2022,Korea,Poland,0,0,0,0,04/06/2022,0,0,2,2,0,0,0,0,0,0,0,0,4,0,1,5,4,1,0,5
5374,152233,2022,Brazil,Poland,0,0,0,0,02/06/2022,0,0,11,11,0,0,0,0,0,0,0,0,15,2,4,21,12,2,0,14
5375,152233,2022,Poland,Canada,0,0,0,0,01/06/2022,0,0,13,13,0,0,0,0,0,0,0,0,19,0,4,23,23,1,1,25
5376,172984,2022,Poland,Bulgaria,0,0,0,0,03/07/2022,0,0,0,0,0,1,0,1,0,0,0,0,0,0,0,0,0,0,0,0
5377,172984,2022,Dominican Republic,Poland,1,3,18,22,02/07/2022,0,0,0,0,5,1,6,12,2,8,2,12,0,0,0,0,3,0,0,3
5378,172984,2022,Poland,China,0,0,0,0,30/06/2022,0,0,0,0,0,3,0,3,0,0,1,1,0,0,0,0,0,0,0,0
5379,172984,2022,Italy,Poland,1,2,16,19,29/06/2022,0,0,0,0,5,5,4,14,0,7,2,9,0,0,0,0,1,1,1,3
5380,162398,2022,Belgium,Poland,0,2,14,16,18/06/2022,0,0,1,1,4,3,4,11,3,4,3,10,0,0,0,0,6,2,0,8
5381,162398,2022,Poland,USA,0,0,2,2,17/06/2022,0,0,1,1,1,0,0,1,1,2,1,4,0,0,0,0,1,1,0,2
5382,162398,2022,Poland,Thailand,0,2,8,10,16/06/2022,1,0,2,3,11,2,7,20,2,4,5,11,0,0,0,0,1,0,3,4
5383,162398,2022,Japan,Poland,0,0,2,2,14/06/2022,0,0,1,1,2,0,0,2,0,0,1,1,0,0,1,1,1,0,0,1
5384,162398,2022,Poland,Germany,0,0,0,0,05/06/2022,0,0,0,0,0,0,0,0,0,0,0,0,0,0,0,0,0,0,0,0
5385,162398,2022,Korea,Poland,1,0,15,16,04/06/2022,0,0,4,4,4,1,3,8,3,0,5,8,0,0,0,0,2,0,0,2
5386,162398,2022,Brazil,Poland,0,0,0,0,02/06/2022,0,0,0,0,0,0,0,0,0,0,0,0,0,0,0,0,0,0,0,0
5387,162398,2022,Poland,Canada,0,1,7,8,01/06/2022,0,0,1,1,0,1,1,2,0,3,3,6,0,0,0,0,1,0,0,1
5388,136317,2022,Poland,Bulgaria,0,2,7,9,03/07/2022,0,0,0,0,3,0,3,6,4,4,2,10,0,0,0,0,1,1,0,2
5389,136317,2022,Dominican Republic,Poland,2,1,15,18,02/07/2022,0,1,1,2,7,3,8,18,8,7,6,21,1,0,1,2,3,1,2,6
5390,136317,2022,Poland,China,0,1,4,5,30/06/2022,0,0,2,2,1,3,0,4,1,0,0,1,0,0,0,0,0,0,0,0
5391,136317,2022,Italy,Poland,1,0,10,11,29/06/2022,0,0,0,0,4,2,6,12,2,7,7,16,0,2,1,3,1,0,2,3
5392,136317,2022,Poland,Germany,2,3,20,25,05/06/2022,0,0,3,3,10,2,6,18,0,7,8,15,0,0,0,0,1,0,0,1
5393,136317,2022,Korea,Poland,0,0,0,0,04/06/2022,0,0,0,0,0,0,0,0,0,0,0,0,0,0,0,0,0,0,0,0
5394,136317,2022,Brazil,Poland,1,2,9,12,02/06/2022,0,0,0,0,6,0,3,9,2,3,1,6,0,0,0,0,2,0,0,2
5395,136317,2022,Poland,Canada,2,2,11,15,01/06/2022,0,0,0,0,9,1,6,16,3,4,6,13,0,0,0,0,4,1,0,5
5396,156479,2022,Belgium,Poland,1,1,12,14,18/06/2022,0,0,3,3,7,0,5,12,3,5,3,11,0,0,0,0,2,1,1,4
5397,156479,2022,Poland,USA,0,0,1,1,17/06/2022,0,0,0,0,1,0,0,1,0,0,0,0,0,0,0,0,0,0,0,0
5398,156479,2022,Poland,Thailand,0,1,22,23,16/06/2022,0,0,0,0,13,3,5,21,2,3,3,8,0,0,0,0,4,2,0,6
5399,156479,2022,Japan,Poland,0,0,0,0,14/06/2022,0,0,0,0,0,0,0,0,0,0,0,0,0,0,0,0,0,0,0,0
5400,156479,2022,Poland,Germany,0,0,3,3,05/06/2022,0,0,0,0,2,0,2,4,1,1,2,4,0,0,0,0,0,0,0,0
5401,156479,2022,Korea,Poland,0,0,1,1,04/06/2022,0,0,0,0,1,0,1,2,2,1,1,4,0,0,0,0,1,0,0,1
5402,156479,2022,Brazil,Poland,0,0,0,0,02/06/2022,0,0,0,0,0,0,0,0,0,0,0,0,0,0,0,0,0,0,0,0
5403,156479,2022,Poland,Canada,0,0,4,4,01/06/2022,0,0,0,0,0,1,2,3,1,6,0,7,0,0,0,0,0,1,0,1
5404,173996,2022,,,-,-,-,-,-,-,-,-,-,-,-,-,-,-,-,-,-,-,-,-,-,-,-,-,-
5405,152223,2022,Poland,Bulgaria,0,1,5,6,03/07/2022,0,0,0,0,2,2,2,6,0,0,1,1,4,1,10,15,1,2,1,4
5406,152223,2022,Dominican Republic,Poland,0,0,2,2,02/07/2022,0,0,0,0,0,0,1,1,1,0,0,1,0,0,2,2,1,2,0,3
5407,152223,2022,Poland,China,0,1,6,7,30/06/2022,0,0,0,0,4,3,6,13,0,0,0,0,1,0,13,14,2,1,2,5
5408,152223,2022,Italy,Poland,0,0,3,3,29/06/2022,1,0,0,1,1,0,0,1,0,0,0,0,0,1,0,1,2,1,0,3
5409,152223,2022,Belgium,Poland,0,0,0,0,18/06/2022,0,0,0,0,0,0,0,0,0,0,0,0,0,0,0,0,0,0,0,0
5410,152223,2022,Poland,USA,0,2,10,12,17/06/2022,0,0,1,1,6,3,14,23,0,6,2,8,3,0,3,6,3,1,0,4
5411,152223,2022,Poland,Thailand,1,0,4,5,16/06/2022,0,0,3,3,1,0,1,2,0,0,1,1,2,2,8,12,3,1,0,4
5412,152223,2022,Japan,Poland,0,1,6,7,14/06/2022,0,0,0,0,3,2,4,9,0,2,1,3,3,2,11,16,2,1,0,3
5413,152223,2022,Poland,Germany,0,2,9,11,05/06/2022,0,0,3,3,11,3,14,28,0,4,3,7,20,1,6,27,12,4,0,16
5414,152223,2022,Korea,Poland,0,0,2,2,04/06/2022,0,0,1,1,1,0,3,4,0,0,0,0,3,0,1,4,7,0,1,8
5415,152223,2022,Brazil,Poland,0,2,8,10,02/06/2022,0,0,4,4,10,4,9,23,1,2,0,3,10,1,8,19,5,0,0,5
5416,152223,2022,Poland,Canada,1,3,16,20,01/06/2022,0,0,1,1,7,5,5,17,1,2,0,3,14,2,6,22,12,1,0,13
5417,152217,2022,,,-,-,-,-,-,-,-,-,-,-,-,-,-,-,-,-,-,-,-,-,-,-,-,-,-
5418,152231,2022,Poland,Bulgaria,0,2,10,12,03/07/2022,0,0,1,1,9,3,8,20,0,2,4,6,5,0,23,28,6,0,1,7
5419,152231,2022,Dominican Republic,Poland,0,0,2,2,02/07/2022,0,0,0,0,1,0,0,1,0,0,0,0,0,0,0,0,1,0,0,1
5420,152231,2022,Poland,China,0,0,1,1,30/06/2022,0,0,0,0,1,0,1,2,0,0,0,0,0,0,1,1,0,0,0,0
5421,152231,2022,Italy,Poland,0,0,1,1,29/06/2022,1,0,0,1,1,0,2,3,0,0,1,1,0,0,5,5,0,0,1,1
5422,152231,2022,Belgium,Poland,0,0,0,0,18/06/2022,0,0,0,0,0,0,0,0,0,0,0,0,0,0,0,0,0,0,0,0
5423,152231,2022,Poland,USA,0,0,0,0,17/06/2022,0,0,0,0,0,0,0,0,0,0,0,0,0,0,0,0,0,0,0,0
5424,152231,2022,Poland,Thailand,0,0,0,0,16/06/2022,0,0,0,0,0,0,0,0,0,0,0,0,0,0,0,0,0,0,0,0
5425,152231,2022,Japan,Poland,0,0,6,6,14/06/2022,0,0,0,0,1,1,2,4,0,0,0,0,0,0,4,4,0,3,0,3
5426,152231,2022,Poland,Germany,0,2,0,2,05/06/2022,0,0,0,0,0,2,2,4,0,0,0,0,0,0,2,2,1,0,0,1
5427,152231,2022,Korea,Poland,0,2,12,14,04/06/2022,0,0,1,1,7,4,11,22,2,2,1,5,6,1,2,9,3,0,0,3
5428,152231,2022,Brazil,Poland,0,1,2,3,02/06/2022,0,0,0,0,0,0,0,0,0,0,0,0,0,0,0,0,0,0,0,0
5429,152231,2022,Poland,Canada,0,0,2,2,01/06/2022,0,0,0,0,0,0,0,0,0,0,0,0,0,0,0,0,0,1,0,1
5430,163098,2022,Poland,Bulgaria,0,0,0,0,03/07/2022,0,0,0,0,0,0,0,0,0,0,0,0,0,0,0,0,0,0,0,0
5431,163098,2022,Dominican Republic,Poland,0,0,0,0,02/07/2022,0,0,0,0,0,0,0,0,0,0,0,0,0,0,0,0,0,0,0,0
5432,163098,2022,Poland,China,0,0,0,0,30/06/2022,0,0,0,0,0,0,0,0,0,0,0,0,0,0,0,0,0,0,0,0
5433,163098,2022,Italy,Poland,0,0,0,0,29/06/2022,0,0,0,0,0,0,0,0,0,0,0,0,0,0,0,0,0,0,0,0
5434,163098,2022,Belgium,Poland,2,2,16,20,18/06/2022,1,0,2,3,22,9,17,48,1,2,2,5,8,2,12,22,16,2,0,18
5435,163098,2022,Poland,USA,0,0,6,6,17/06/2022,0,0,0,0,8,2,10,20,0,2,0,2,5,0,27,32,4,5,1,10
5436,163098,2022,Poland,Thailand,0,0,0,0,16/06/2022,0,0,0,0,0,1,1,2,0,1,2,3,0,0,0,0,0,0,0,0
5437,163098,2022,Japan,Poland,1,2,6,9,14/06/2022,0,0,0,0,2,1,11,14,0,0,0,0,3,0,12,15,1,3,1,5
5438,163098,2022,Poland,Germany,1,1,15,17,05/06/2022,0,0,2,2,13,5,10,28,2,1,4,7,23,2,5,30,8,3,2,13
5439,163098,2022,Korea,Poland,0,0,10,10,04/06/2022,0,0,0,0,1,1,0,2,0,0,0,0,2,0,2,4,2,0,0,2
5440,163098,2022,Brazil,Poland,0,2,10,12,02/06/2022,0,0,1,1,10,7,8,25,0,1,1,2,12,0,11,23,8,3,0,11
5441,163098,2022,Poland,Canada,0,3,9,12,01/06/2022,0,0,0,0,17,4,15,36,0,5,1,6,13,1,11,25,8,1,0,9
5442,185609,2022,Poland,Bulgaria,0,0,0,0,03/07/2022,0,0,2,2,0,0,0,0,0,0,0,0,0,0,1,1,1,0,1,2
5443,185609,2022,Dominican Republic,Poland,0,0,0,0,02/07/2022,0,0,0,0,0,0,0,0,0,0,0,0,0,0,2,2,1,0,0,1
5444,185609,2022,Poland,China,0,0,0,0,30/06/2022,0,0,0,0,0,0,0,0,0,0,0,0,0,0,0,0,0,0,0,0
5445,185609,2022,Italy,Poland,0,0,0,0,29/06/2022,0,0,0,0,0,0,0,0,0,0,0,0,0,0,0,0,0,0,0,0
5446,185609,2022,Belgium,Poland,0,0,0,0,18/06/2022,0,0,0,0,0,0,0,0,0,0,0,0,0,0,0,0,0,0,0,0
5447,185609,2022,Poland,USA,0,0,0,0,17/06/2022,0,0,0,0,0,0,0,0,0,0,0,0,0,0,0,0,0,0,0,0
5448,185609,2022,Poland,Thailand,0,0,0,0,16/06/2022,0,0,0,0,0,0,0,0,0,0,0,0,0,0,0,0,0,0,0,0
5449,185609,2022,Japan,Poland,0,0,0,0,14/06/2022,0,0,0,0,0,0,0,0,0,0,0,0,0,0,0,0,0,0,0,0
5450,185609,2022,Poland,Germany,0,0,0,0,05/06/2022,0,0,0,0,0,0,0,0,0,0,0,0,0,0,0,0,0,0,0,0
5451,185609,2022,Korea,Poland,0,0,0,0,04/06/2022,0,0,4,4,0,0,0,0,0,0,0,0,7,0,0,7,7,0,0,7
5452,185609,2022,Brazil,Poland,0,0,0,0,02/06/2022,0,0,0,0,0,0,0,0,0,0,0,0,0,0,0,0,0,0,0,0
5453,185609,2022,Poland,Canada,0,0,0,0,01/06/2022,0,0,0,0,0,0,0,0,0,0,0,0,0,0,0,0,0,0,0,0
5454,118591,2022,Poland,Bulgaria,0,0,5,5,03/07/2022,2,0,19,21,0,0,0,0,0,0,0,0,0,0,0,0,2,2,0,4
5455,118591,2022,Dominican Republic,Poland,2,0,18,20,02/07/2022,24,0,121,145,0,0,0,0,0,3,3,6,0,0,0,0,11,2,1,14
5456,118591,2022,Poland,China,0,0,7,7,30/06/2022,0,2,70,72,0,0,0,0,0,5,0,5,0,0,0,0,3,2,5,10
5457,118591,2022,Italy,Poland,1,0,15,16,29/06/2022,109,1,2,112,1,0,2,3,2,3,2,7,0,0,0,0,5,2,2,9
5458,118591,2022,Belgium,Poland,0,1,20,21,18/06/2022,37,2,97,136,0,0,2,2,0,4,8,12,0,0,0,0,10,5,1,16
5459,118591,2022,Poland,USA,0,0,0,0,17/06/2022,1,0,2,3,0,0,0,0,0,0,0,0,0,0,0,0,1,1,0,2
5460,118591,2022,Poland,Thailand,1,1,17,19,16/06/2022,52,1,90,143,2,0,2,4,4,0,6,10,0,0,1,1,14,3,1,18
5461,118591,2022,Japan,Poland,0,1,10,11,14/06/2022,36,0,47,83,2,0,1,3,0,1,6,7,0,1,0,1,7,1,0,8
5462,118591,2022,Poland,Germany,2,0,16,18,05/06/2022,30,1,80,111,0,2,2,4,2,3,2,7,0,0,1,1,10,3,0,13
5463,118591,2022,Korea,Poland,1,1,4,6,04/06/2022,14,0,22,36,1,0,1,2,0,0,0,0,0,0,0,0,4,1,0,5
5464,118591,2022,Brazil,Poland,0,0,0,0,02/06/2022,0,0,0,0,0,0,0,0,0,0,0,0,0,0,0,0,0,0,0,0
5465,118591,2022,Poland,Canada,0,0,0,0,01/06/2022,0,0,0,0,0,0,0,0,0,0,0,0,0,0,0,0,0,0,0,0
5466,181268,2022,Poland,Bulgaria,0,0,8,8,03/07/2022,0,0,1,1,5,4,9,18,2,0,0,2,0,0,6,6,5,1,0,6
5467,181268,2022,Dominican Republic,Poland,3,2,27,32,02/07/2022,0,0,2,2,22,8,29,59,2,2,2,6,1,1,2,4,6,2,4,12
5468,181268,2022,Poland,China,0,3,4,7,30/06/2022,0,0,0,0,9,6,20,35,0,1,0,1,0,0,4,4,7,2,3,12
5469,181268,2022,Italy,Poland,0,2,9,11,29/06/2022,3,0,0,3,10,8,16,34,2,4,0,6,2,0,7,9,7,2,1,10
5470,181268,2022,Belgium,Poland,3,4,9,16,18/06/2022,0,0,0,0,18,2,13,33,0,0,2,2,1,0,0,1,4,4,0,8
5471,181268,2022,Poland,USA,1,2,5,8,17/06/2022,0,1,0,1,10,8,12,30,1,0,2,3,0,0,0,0,4,1,0,5
5472,181268,2022,Poland,Thailand,2,3,16,21,16/06/2022,1,0,2,3,16,3,30,49,0,3,4,7,0,0,3,3,11,3,1,15
5473,181268,2022,Japan,Poland,0,1,1,2,14/06/2022,1,0,0,1,6,3,3,12,1,1,1,3,0,0,0,0,0,1,0,1
5474,152232,2022,,,-,-,-,-,-,-,-,-,-,-,-,-,-,-,-,-,-,-,-,-,-,-,-,-,-
5475,173994,2022,,,-,-,-,-,-,-,-,-,-,-,-,-,-,-,-,-,-,-,-,-,-,-,-,-,-
5476,163097,2022,Poland,Bulgaria,1,2,11,14,03/07/2022,0,0,0,0,9,5,3,17,0,6,2,8,0,0,1,1,0,2,0,2
5477,163097,2022,Dominican Republic,Poland,0,0,0,0,02/07/2022,0,0,0,0,0,0,0,0,0,0,0,0,0,0,0,0,0,0,0,0
5478,163097,2022,Poland,China,1,2,3,6,30/06/2022,0,0,0,0,0,1,0,1,0,0,1,1,0,0,0,0,0,0,0,0
5479,163097,2022,Italy,Poland,0,0,0,0,29/06/2022,0,0,0,0,1,0,0,1,0,0,0,0,0,0,0,0,0,0,0,0
5480,163097,2022,Belgium,Poland,0,0,0,0,18/06/2022,0,0,0,0,0,0,0,0,0,0,0,0,0,0,0,0,0,0,0,0
5481,163097,2022,Poland,USA,0,0,4,4,17/06/2022,0,0,3,3,2,1,7,10,0,1,2,3,0,0,0,0,2,0,0,2
5482,163097,2022,Poland,Thailand,0,0,0,0,16/06/2022,0,0,0,0,0,0,0,0,0,0,0,0,0,0,0,0,0,0,0,0
5483,163097,2022,Japan,Poland,0,0,7,7,14/06/2022,0,0,2,2,7,1,8,16,1,5,5,11,0,0,0,0,2,0,0,2
5484,163097,2022,Poland,Germany,1,1,10,12,05/06/2022,0,0,2,2,6,2,5,13,3,2,3,8,0,0,1,1,3,1,0,4
5485,163097,2022,Korea,Poland,0,1,2,3,04/06/2022,0,0,2,2,4,1,0,5,1,1,1,3,1,0,0,1,2,0,0,2
5486,163097,2022,Brazil,Poland,1,3,5,9,02/06/2022,0,0,2,2,9,2,2,13,0,4,2,6,0,0,0,0,5,0,0,5
5487,163097,2022,Poland,Canada,0,0,0,0,01/06/2022,0,0,0,0,0,0,0,0,0,0,0,0,0,0,0,0,0,0,0,0
5488,136321,2022,,,-,-,-,-,-,-,-,-,-,-,-,-,-,-,-,-,-,-,-,-,-,-,-,-,-
5489,156480,2022,Poland,Bulgaria,1,1,8,10,03/07/2022,7,0,93,100,0,0,1,1,2,1,4,7,0,0,0,0,4,2,3,9
5490,156480,2022,Dominican Republic,Poland,0,1,1,2,02/07/2022,1,0,4,5,0,0,0,0,0,0,0,0,0,0,0,0,0,0,0,0
5491,156480,2022,Poland,China,0,0,0,0,30/06/2022,0,0,5,5,0,0,0,0,0,1,0,1,0,0,0,0,0,0,0,0
5492,156480,2022,Italy,Poland,0,0,0,0,29/06/2022,0,0,0,0,0,0,0,0,0,0,0,0,0,0,0,0,0,0,0,0
5493,156480,2022,Poland,Germany,0,0,1,1,05/06/2022,0,0,0,0,0,0,0,0,0,0,0,0,0,0,0,0,0,0,0,0
5494,156480,2022,Korea,Poland,0,0,0,0,04/06/2022,0,0,0,0,0,0,0,0,0,0,0,0,0,0,0,0,0,0,0,0
5495,156480,2022,Brazil,Poland,0,1,11,12,02/06/2022,18,1,68,87,1,0,1,2,2,0,5,7,0,0,0,0,10,1,0,11
5496,156480,2022,Poland,Canada,0,1,3,4,01/06/2022,1,0,14,15,0,0,0,0,0,0,0,0,0,0,0,0,1,0,0,1
5497,164107,2022,Poland,Bulgaria,0,0,2,2,03/07/2022,0,0,0,0,1,3,1,5,0,2,0,2,0,0,3,3,1,0,0,1
5498,164107,2022,Dominican Republic,Poland,0,1,8,9,02/07/2022,0,0,0,0,10,4,7,21,2,3,0,5,12,1,24,37,6,4,3,13
5499,164107,2022,Poland,China,0,1,2,3,30/06/2022,0,0,0,0,2,2,3,7,0,1,0,1,2,1,4,7,1,0,0,1
5500,164107,2022,Italy,Poland,1,2,14,17,29/06/2022,2,0,1,3,6,4,16,26,1,4,0,5,2,0,29,31,1,1,1,3
5501,164107,2022,Belgium,Poland,0,3,7,10,18/06/2022,0,0,3,3,9,6,10,25,2,7,7,16,11,0,23,34,8,5,0,13
5502,164107,2022,Poland,USA,0,0,0,0,17/06/2022,0,0,0,0,0,0,0,0,0,0,0,0,2,1,2,5,0,1,0,1
5503,164107,2022,Poland,Thailand,2,6,9,17,16/06/2022,2,0,4,6,13,3,14,30,3,0,0,3,9,0,24,33,7,5,1,13
5504,164107,2022,Japan,Poland,0,0,2,2,14/06/2022,0,0,0,0,2,2,3,7,0,1,0,1,0,1,3,4,2,0,0,2
5505,164107,2022,Poland,Germany,0,0,0,0,05/06/2022,0,0,1,1,2,2,4,8,0,0,0,0,0,0,0,0,1,0,0,1
5506,164107,2022,Korea,Poland,2,1,8,11,04/06/2022,0,0,1,1,4,1,12,17,1,1,1,3,4,0,3,7,3,0,1,4
5507,164107,2022,Brazil,Poland,0,0,3,3,02/06/2022,0,0,1,1,4,2,7,13,1,1,2,4,2,1,2,5,0,0,0,0
5508,164107,2022,Poland,Canada,0,1,1,2,01/06/2022,0,0,0,0,3,2,4,9,2,0,3,5,0,0,0,0,0,0,0,0
5509,181267,2022,,,-,-,-,-,-,-,-,-,-,-,-,-,-,-,-,-,-,-,-,-,-,-,-,-,-
5510,164104,2022,,,-,-,-,-,-,-,-,-,-,-,-,-,-,-,-,-,-,-,-,-,-,-,-,-,-
5511,152222,2022,,,-,-,-,-,-,-,-,-,-,-,-,-,-,-,-,-,-,-,-,-,-,-,-,-,-
5512,181263,2022,Belgium,Poland,0,0,0,0,18/06/2022,0,0,0,0,0,0,0,0,0,0,0,0,0,0,0,0,0,0,0,0
5513,181263,2022,Poland,USA,0,2,9,11,17/06/2022,3,0,75,78,0,0,1,1,0,2,1,3,0,0,1,1,7,3,1,11
5514,181263,2022,Poland,Thailand,0,0,3,3,16/06/2022,1,0,7,8,0,0,0,0,0,0,0,0,0,0,0,0,1,1,0,2
5515,181263,2022,Japan,Poland,0,0,1,1,14/06/2022,0,0,0,0,0,0,0,0,0,0,0,0,0,0,0,0,0,0,0,0
5516,181263,2022,Poland,Germany,0,0,1,1,05/06/2022,0,0,7,7,0,0,0,0,0,0,0,0,0,0,0,0,0,0,0,0
5517,181263,2022,Korea,Poland,0,0,3,3,04/06/2022,3,0,17,20,1,0,0,1,1,0,0,1,0,0,0,0,1,1,0,2
5518,181263,2022,Brazil,Poland,0,0,0,0,02/06/2022,0,0,0,0,0,0,0,0,0,0,0,0,0,0,0,0,0,0,0,0
5519,181263,2022,Poland,Canada,2,1,14,17,01/06/2022,7,0,82,89,1,0,0,1,0,1,2,3,0,0,1,1,6,3,1,10
5520,151231,2022,Poland,Bulgaria,0,2,5,7,03/07/2022,1,0,3,4,19,7,20,46,0,3,1,4,2,0,5,7,5,1,0,6
5521,151231,2022,Dominican Republic,Poland,0,5,3,8,02/07/2022,0,0,0,0,19,8,24,51,2,9,5,16,1,0,2,3,11,2,1,14
5522,151231,2022,Poland,China,0,2,5,7,30/06/2022,0,0,3,3,8,2,12,22,1,3,1,5,2,0,10,12,4,2,2,8
5523,151231,2022,Italy,Poland,0,5,8,13,29/06/2022,2,0,0,2,17,6,21,44,2,1,1,4,2,1,7,10,11,1,2,14
5524,151231,2022,Belgium,Poland,0,1,4,5,18/06/2022,0,1,1,2,10,2,20,32,3,1,5,9,1,1,7,9,6,1,1,8
5525,151231,2022,Poland,USA,0,0,1,1,17/06/2022,0,0,0,0,5,1,2,8,0,0,2,2,0,0,0,0,1,0,0,1
5526,151231,2022,Poland,Thailand,1,4,9,14,16/06/2022,0,0,2,2,17,10,28,55,2,4,2,8,6,0,7,13,16,0,0,16
5527,151231,2022,Japan,Poland,0,1,7,8,14/06/2022,1,0,1,2,8,5,12,25,1,0,2,3,0,0,2,2,1,3,0,4
5528,151231,2022,Poland,Germany,0,3,10,13,05/06/2022,0,0,1,1,18,2,23,43,4,3,3,10,0,0,0,0,10,1,2,13
5529,151231,2022,Korea,Poland,0,3,3,6,04/06/2022,0,0,1,1,9,0,9,18,2,0,3,5,0,0,0,0,4,0,0,4
5530,151231,2022,Brazil,Poland,0,1,5,6,02/06/2022,0,0,0,0,9,9,8,26,0,4,2,6,0,0,0,0,6,2,0,8
5531,151231,2022,Poland,Canada,1,1,8,10,01/06/2022,0,1,0,1,9,10,23,42,2,0,0,2,0,0,0,0,6,0,0,6
5532,185611,2022,Poland,Bulgaria,0,0,5,5,03/07/2022,0,0,0,0,0,0,0,0,0,2,1,3,0,1,0,1,0,0,0,0
5533,185611,2022,Dominican Republic,Poland,0,0,0,0,02/07/2022,0,0,0,0,0,0,0,0,0,0,0,0,0,0,0,0,0,0,0,0
5534,185611,2022,Poland,China,0,1,9,10,30/06/2022,0,0,0,0,5,0,0,5,2,1,0,3,0,0,0,0,1,1,0,2
5535,185611,2022,Italy,Poland,0,0,1,1,29/06/2022,0,0,0,0,0,0,0,0,0,0,0,0,0,0,0,0,1,0,0,1
5536,185611,2022,Belgium,Poland,0,0,3,3,18/06/2022,0,0,1,1,1,0,0,1,0,1,1,2,0,1,0,1,1,0,0,1
5537,185611,2022,Poland,USA,0,1,5,6,17/06/2022,0,0,2,2,2,0,3,5,1,4,2,7,0,0,1,1,1,0,0,1
5538,185611,2022,Poland,Thailand,0,0,2,2,16/06/2022,0,0,0,0,0,2,2,4,0,0,0,0,0,0,0,0,0,0,0,0
5539,185611,2022,Japan,Poland,0,0,10,10,14/06/2022,0,0,0,0,8,0,3,11,1,5,5,11,1,0,1,2,2,2,0,4
5540,136024,2022,Türkiye,Serbia,1,0,13,14,17/07/2022,0,0,1,1,12,7,12,31,1,1,3,5,8,2,9,19,14,0,0,14
5541,136024,2022,Serbia,Brazil,0,2,5,7,16/07/2022,0,0,0,0,2,0,4,6,0,0,2,2,4,0,3,7,2,1,0,3
5542,136024,2022,USA,Serbia,0,0,0,0,13/07/2022,0,0,0,0,0,0,0,0,0,0,0,0,0,0,0,0,0,0,0,0
5543,136024,2022,Japan,Serbia,0,1,10,11,02/07/2022,0,0,0,0,5,2,6,13,0,1,0,1,4,0,3,7,7,3,0,10
5544,136024,2022,Serbia,Canada,2,4,10,16,02/07/2022,0,1,1,2,4,7,8,19,1,0,0,1,1,1,17,19,2,1,0,3
5545,136024,2022,USA,Serbia,2,1,9,12,01/07/2022,0,0,0,0,12,3,11,26,0,1,3,4,14,3,16,33,6,0,0,6
5546,136024,2022,Serbia,Germany,1,1,12,14,28/06/2022,0,0,2,2,11,2,13,26,1,1,1,3,8,3,23,34,7,1,1,9
5547,136024,2022,Brazil,Serbia,0,0,1,1,19/06/2022,0,0,0,0,1,3,3,7,0,1,0,1,0,1,0,1,0,1,0,1
5548,136024,2022,Serbia,Türkiye,0,0,7,7,17/06/2022,0,0,2,2,5,5,8,18,2,1,3,6,6,2,16,24,4,0,1,5
5549,136024,2022,Serbia,Korea,0,1,13,14,16/06/2022,0,0,2,2,9,4,17,30,0,2,3,5,4,2,15,21,1,3,2,6
5550,136024,2022,Serbia,Italy,0,0,1,1,15/06/2022,0,0,0,0,2,0,6,8,0,0,1,1,2,0,4,6,3,0,0,3
5551,152168,2022,Türkiye,Serbia,0,0,3,3,17/07/2022,0,0,0,0,0,0,0,0,0,0,0,0,0,0,0,0,0,0,0,0
5552,152168,2022,Serbia,Brazil,1,0,2,3,16/07/2022,0,0,0,0,1,1,0,2,0,1,0,1,0,1,2,3,0,2,0,2
5553,152168,2022,USA,Serbia,1,1,7,9,13/07/2022,0,0,0,0,0,0,0,0,0,0,0,0,0,0,1,1,0,0,0,0
5554,152168,2022,Japan,Serbia,0,1,17,18,02/07/2022,0,1,1,2,20,1,26,47,2,2,1,5,21,2,16,39,14,4,0,18
5555,152168,2022,Serbia,Canada,0,0,6,6,02/07/2022,0,0,2,2,5,0,5,10,1,0,0,1,1,0,3,4,2,0,2,4
5556,152168,2022,USA,Serbia,0,0,3,3,01/07/2022,0,0,0,0,2,2,6,10,0,0,1,1,2,1,3,6,4,0,0,4
5557,152168,2022,Serbia,Germany,0,3,9,12,28/06/2022,0,0,4,4,11,3,12,26,0,1,2,3,4,1,10,15,7,0,1,8
5558,152168,2022,Brazil,Serbia,0,0,2,2,19/06/2022,0,0,0,0,0,0,0,0,0,0,0,0,0,0,0,0,0,0,0,0
5559,152168,2022,Serbia,Türkiye,0,0,10,10,17/06/2022,0,0,1,1,3,8,7,18,0,1,1,2,2,0,6,8,3,2,3,8
5560,152168,2022,Serbia,Korea,1,1,3,5,16/06/2022,0,0,0,0,0,2,0,2,0,1,0,1,2,0,4,6,2,1,0,3
5561,152168,2022,Serbia,Italy,1,1,11,13,15/06/2022,0,0,0,0,10,4,13,27,2,0,3,5,5,2,15,22,5,0,2,7
5562,152168,2022,Serbia,Netherlands,1,0,16,17,05/06/2022,1,0,2,3,17,4,13,34,0,1,2,3,12,3,23,38,8,2,5,15
5563,152168,2022,Serbia,Bulgaria,1,0,11,12,03/06/2022,0,0,2,2,11,4,4,19,0,4,1,5,7,0,13,20,8,2,2,12
5564,152168,2022,Thailand,Serbia,1,0,9,10,02/06/2022,0,0,3,3,4,2,7,13,0,3,1,4,0,0,9,9,4,1,2,7
5565,152168,2022,Belgium,Serbia,0,1,10,11,01/06/2022,0,0,1,1,12,4,17,33,1,4,4,9,6,1,10,17,10,6,1,17
5566,163120,2022,,,-,-,-,-,-,-,-,-,-,-,-,-,-,-,-,-,-,-,-,-,-,-,-,-,-
5567,120326,2022,Türkiye,Serbia,1,0,15,16,17/07/2022,9,2,88,99,0,2,1,3,1,2,2,5,0,0,1,1,6,1,1,8
5568,120326,2022,Serbia,Brazil,0,0,9,9,16/07/2022,25,2,62,89,1,0,3,4,2,4,6,12,0,0,1,1,7,5,4,16
5569,120326,2022,USA,Serbia,0,1,14,15,13/07/2022,12,2,91,105,3,0,0,3,1,6,1,8,0,0,1,1,11,9,0,20
5570,120326,2022,Serbia,Netherlands,1,3,14,18,05/06/2022,56,0,56,112,4,1,4,9,1,2,3,6,0,0,0,0,13,4,4,21
5571,120326,2022,Serbia,Bulgaria,1,1,10,12,03/06/2022,14,0,62,76,1,0,1,2,0,3,0,3,0,0,1,1,5,3,3,11
5572,120326,2022,Thailand,Serbia,0,0,6,6,02/06/2022,3,0,21,24,1,0,0,1,0,0,0,0,0,0,0,0,4,0,0,4
5573,120326,2022,Belgium,Serbia,1,0,16,17,01/06/2022,22,1,71,94,1,0,3,4,0,1,1,2,0,0,0,0,8,1,4,13
5574,136030,2022,Türkiye,Serbia,0,0,0,0,17/07/2022,0,0,0,0,0,0,0,0,0,0,0,0,0,0,0,0,0,0,0,0
5575,136030,2022,Serbia,Brazil,0,0,2,2,16/07/2022,0,0,0,0,1,0,0,1,0,0,0,0,0,0,0,0,0,1,0,1
5576,136030,2022,USA,Serbia,0,0,0,0,13/07/2022,0,0,0,0,0,0,0,0,0,0,0,0,0,0,0,0,0,0,0,0
5577,152169,2022,Japan,Serbia,0,0,2,2,02/07/2022,1,0,4,5,0,0,0,0,0,0,0,0,0,0,0,0,0,0,0,0
5578,152169,2022,Serbia,Canada,0,0,0,0,02/07/2022,0,0,0,0,0,0,0,0,0,0,0,0,0,0,0,0,0,0,0,0
5579,152169,2022,USA,Serbia,0,1,0,1,01/07/2022,0,0,13,13,0,0,0,0,0,0,0,0,0,0,0,0,1,1,0,2
5580,152169,2022,Serbia,Germany,0,0,1,1,28/06/2022,0,0,2,2,0,0,0,0,0,0,0,0,0,0,0,0,1,0,0,1
5581,152169,2022,Brazil,Serbia,0,0,0,0,19/06/2022,2,0,3,5,0,0,0,0,0,0,0,0,0,0,0,0,0,0,0,0
5582,152169,2022,Serbia,Türkiye,0,0,0,0,17/06/2022,3,0,7,10,0,0,0,0,0,1,0,1,0,0,0,0,0,0,0,0
5583,152169,2022,Serbia,Korea,0,0,3,3,16/06/2022,3,1,19,23,0,0,2,2,0,0,1,1,0,0,0,0,1,1,0,2
5584,152169,2022,Serbia,Italy,0,0,1,1,15/06/2022,0,3,3,6,0,0,0,0,0,0,0,0,0,0,0,0,1,0,0,1
5585,136812,2022,Türkiye,Serbia,0,0,0,0,17/07/2022,0,0,0,0,0,0,0,0,0,0,0,0,0,0,0,0,0,0,0,0
5586,136812,2022,Serbia,Brazil,0,1,4,5,16/07/2022,1,1,11,13,2,0,1,3,0,0,0,0,0,0,0,0,1,4,1,6
5587,136812,2022,USA,Serbia,0,1,2,3,13/07/2022,1,0,18,19,0,0,0,0,0,0,0,0,0,0,0,0,1,2,1,4
5588,136812,2022,Japan,Serbia,1,1,13,15,02/07/2022,9,1,120,130,1,1,7,9,1,1,6,8,0,0,0,0,16,1,0,17
5589,136812,2022,Serbia,Canada,0,2,11,13,02/07/2022,2,0,73,75,5,1,2,8,0,0,0,0,0,0,3,3,3,0,0,3
5590,136812,2022,USA,Serbia,0,2,7,9,01/07/2022,6,1,62,69,1,1,4,6,0,0,1,1,0,0,0,0,4,2,0,6
5591,136812,2022,Serbia,Germany,1,0,19,20,28/06/2022,16,0,79,95,6,0,2,8,0,2,0,2,0,0,0,0,8,0,0,8
5592,136812,2022,Brazil,Serbia,0,1,9,10,19/06/2022,19,1,76,96,3,0,1,4,0,2,3,5,0,0,0,0,4,3,1,8
5593,136812,2022,Serbia,Türkiye,0,1,13,14,17/06/2022,18,1,101,120,0,1,2,3,1,9,1,11,0,0,0,0,4,2,1,7
5594,136812,2022,Serbia,Korea,0,3,8,11,16/06/2022,21,1,60,82,2,0,0,2,0,2,4,6,0,0,0,0,1,0,0,1
5595,136812,2022,Serbia,Italy,0,0,12,12,15/06/2022,0,2,66,68,2,1,1,4,0,0,3,3,0,0,1,1,4,0,2,6
5596,136812,2022,Serbia,Netherlands,0,0,4,4,05/06/2022,8,0,10,18,0,0,0,0,0,0,0,0,0,0,0,0,2,0,0,2
5597,136812,2022,Serbia,Bulgaria,1,1,2,4,03/06/2022,4,0,15,19,0,0,0,0,0,0,0,0,0,0,0,0,2,1,0,3
5598,136812,2022,Thailand,Serbia,1,0,16,17,02/06/2022,15,0,98,113,4,0,1,5,1,0,2,3,0,0,0,0,0,2,2,4
5599,136812,2022,Belgium,Serbia,0,0,6,6,01/06/2022,4,0,16,20,0,0,0,0,0,0,0,0,0,0,0,0,1,1,1,3
5600,121593,2022,Türkiye,Serbia,0,0,0,0,17/07/2022,0,0,0,0,0,0,0,0,0,0,0,0,0,0,0,0,0,0,0,0
5601,121593,2022,Serbia,Brazil,0,0,1,1,16/07/2022,0,0,0,0,3,1,6,10,2,2,0,4,0,0,0,0,1,0,0,1
5602,121593,2022,USA,Serbia,0,0,1,1,13/07/2022,0,0,0,0,7,4,2,13,0,0,0,0,0,0,0,0,0,0,0,0
5603,121593,2022,Serbia,Netherlands,0,0,4,4,05/06/2022,0,0,1,1,3,0,6,9,0,2,0,2,0,0,2,2,2,1,0,3
5604,121593,2022,Serbia,Bulgaria,0,0,0,0,03/06/2022,0,0,0,0,0,0,0,0,0,0,0,0,0,0,0,0,0,0,0,0
5605,121593,2022,Thailand,Serbia,0,1,2,3,02/06/2022,0,1,0,1,5,2,8,15,1,2,2,5,1,0,5,6,2,0,2,4
5606,121593,2022,Belgium,Serbia,0,0,0,0,01/06/2022,0,0,0,0,0,1,3,4,1,0,0,1,0,1,1,2,1,0,0,1
5607,123709,2022,Türkiye,Serbia,0,0,0,0,17/07/2022,0,0,10,10,0,0,0,0,0,0,0,0,6,0,10,16,7,6,0,13
5608,123709,2022,Serbia,Brazil,0,0,0,0,16/07/2022,1,0,12,13,0,0,0,0,0,0,0,0,6,0,11,17,12,6,3,21
5609,123709,2022,USA,Serbia,0,0,0,0,13/07/2022,0,0,5,5,0,0,0,0,0,0,0,0,21,2,25,48,15,2,0,17
5610,123709,2022,Japan,Serbia,0,0,0,0,02/07/2022,0,0,19,19,0,0,1,1,0,0,0,0,6,1,8,15,15,2,0,17
5611,123709,2022,Serbia,Canada,0,0,0,0,02/07/2022,0,0,6,6,0,0,0,0,0,0,0,0,4,0,26,30,4,0,0,4
5612,123709,2022,USA,Serbia,0,0,0,0,01/07/2022,0,0,7,7,0,0,0,0,0,0,0,0,6,0,3,9,4,1,0,5
5613,123709,2022,Serbia,Germany,0,0,0,0,28/06/2022,0,0,7,7,0,0,0,0,0,0,0,0,3,0,16,19,13,6,1,20
5614,123709,2022,Brazil,Serbia,0,0,0,0,19/06/2022,0,0,8,8,0,0,0,0,0,0,0,0,4,0,4,8,11,5,2,18
5615,123709,2022,Serbia,Türkiye,0,0,0,0,17/06/2022,0,0,13,13,0,0,0,0,0,0,0,0,7,0,10,17,16,2,4,22
5616,123709,2022,Serbia,Korea,0,0,0,0,16/06/2022,0,0,7,7,0,0,0,0,0,0,0,0,11,0,12,23,10,3,1,14
5617,123709,2022,Serbia,Italy,0,0,0,0,15/06/2022,0,0,0,0,0,0,0,0,0,0,0,0,12,3,15,30,15,1,5,21
5618,123709,2022,Serbia,Netherlands,0,0,0,0,05/06/2022,2,0,12,14,0,0,0,0,0,0,0,0,5,0,15,20,16,4,3,23
5619,123709,2022,Serbia,Bulgaria,0,0,0,0,03/06/2022,0,0,4,4,0,0,0,0,0,0,0,0,4,1,12,17,19,1,0,20
5620,123709,2022,Thailand,Serbia,0,0,0,0,02/06/2022,0,0,9,9,0,0,0,0,0,0,0,0,5,2,17,24,12,5,1,18
5621,123709,2022,Belgium,Serbia,0,0,0,0,01/06/2022,0,0,10,10,0,0,0,0,0,0,0,0,5,1,21,27,11,3,3,17
5622,123694,2022,Türkiye,Serbia,0,0,10,10,17/07/2022,0,0,4,4,11,6,14,31,1,2,2,5,0,0,0,0,8,1,1,10
5623,123694,2022,Serbia,Brazil,1,1,10,12,16/07/2022,0,0,1,1,15,7,18,40,1,0,1,2,0,0,0,0,3,1,3,7
5624,123694,2022,USA,Serbia,0,1,8,9,13/07/2022,0,0,0,0,17,8,23,48,3,4,1,8,0,0,1,1,3,1,0,4
5625,123694,2022,Japan,Serbia,0,0,0,0,02/07/2022,0,0,0,0,0,0,0,0,0,0,0,0,0,0,0,0,0,0,0,0
5626,123694,2022,Serbia,Canada,1,1,12,14,02/07/2022,0,0,2,2,26,6,30,62,0,0,0,0,0,0,0,0,4,0,0,4
5627,123694,2022,USA,Serbia,0,1,6,7,01/07/2022,0,0,2,2,12,11,12,35,1,2,2,5,0,0,0,0,1,0,0,1
5628,123694,2022,Serbia,Germany,0,3,11,14,28/06/2022,0,0,3,3,12,8,15,35,3,2,1,6,0,0,0,0,4,1,1,6
5629,123694,2022,Brazil,Serbia,0,2,8,10,19/06/2022,0,0,1,1,8,9,22,39,0,1,2,3,0,0,0,0,5,1,2,8
5630,123694,2022,Serbia,Türkiye,2,3,13,18,17/06/2022,0,0,0,0,15,5,27,47,2,5,0,7,0,0,0,0,6,3,1,10
5631,123694,2022,Serbia,Korea,0,0,12,12,16/06/2022,0,0,0,0,19,2,12,33,4,2,6,12,0,0,0,0,3,1,0,4
5632,123694,2022,Serbia,Italy,0,2,8,10,15/06/2022,0,0,2,2,16,6,14,36,1,0,6,7,0,0,0,0,6,0,0,6
5633,123694,2022,Serbia,Netherlands,1,0,12,13,05/06/2022,0,0,2,2,15,8,22,45,1,3,4,8,0,0,0,0,14,1,2,17
5634,123694,2022,Serbia,Bulgaria,0,1,5,6,03/06/2022,0,0,0,0,16,5,18,39,1,3,4,8,0,0,0,0,3,1,1,5
5635,123694,2022,Thailand,Serbia,0,0,3,3,02/06/2022,0,0,0,0,5,1,14,20,1,0,0,1,0,0,0,0,1,0,0,1
5636,123694,2022,Belgium,Serbia,0,0,9,9,01/06/2022,0,0,0,0,21,4,21,46,0,2,4,6,0,0,0,0,5,3,1,9
5637,143548,2022,Türkiye,Serbia,0,0,9,9,17/07/2022,0,0,1,1,5,1,2,8,3,2,7,12,1,0,0,1,4,1,1,6
5638,143548,2022,Serbia,Brazil,1,1,16,18,16/07/2022,0,0,1,1,5,2,2,9,2,5,7,14,0,0,0,0,3,1,2,6
5639,143548,2022,USA,Serbia,0,2,19,21,13/07/2022,0,0,2,2,12,2,2,16,2,12,7,21,1,0,1,2,4,1,1,6
5640,143548,2022,Japan,Serbia,1,2,14,17,02/07/2022,0,0,0,0,12,1,6,19,4,6,6,16,0,0,2,2,4,0,0,4
5641,143548,2022,Serbia,Canada,0,0,4,4,02/07/2022,0,0,2,2,2,2,4,8,2,3,1,6,0,0,0,0,1,0,0,1
5642,143548,2022,USA,Serbia,0,1,7,8,01/07/2022,0,0,2,2,4,1,1,6,3,6,3,12,0,0,0,0,1,0,0,1
5643,143548,2022,Serbia,Germany,1,1,12,14,28/06/2022,1,0,1,2,10,1,3,14,2,6,5,13,0,0,2,2,3,0,0,3
5644,143548,2022,Brazil,Serbia,0,0,6,6,19/06/2022,0,0,2,2,2,2,2,6,1,4,3,8,0,0,0,0,2,1,0,3
5645,143548,2022,Serbia,Türkiye,1,1,14,16,17/06/2022,0,0,1,1,7,2,4,13,4,4,4,12,1,0,1,2,3,1,0,4
5646,143548,2022,Serbia,Korea,0,2,11,13,16/06/2022,0,0,2,2,2,2,8,12,3,7,8,18,0,0,0,0,1,0,0,1
5647,143548,2022,Serbia,Italy,1,3,14,18,15/06/2022,0,0,0,0,2,0,6,8,3,1,11,15,0,0,0,0,4,0,1,5
5648,143548,2022,Serbia,Netherlands,0,2,14,16,05/06/2022,0,0,2,2,6,2,5,13,1,3,5,9,0,0,0,0,4,0,3,7
5649,143548,2022,Serbia,Bulgaria,0,1,12,13,03/06/2022,0,0,2,2,3,0,4,7,4,3,10,17,0,0,0,0,4,1,0,5
5650,143548,2022,Thailand,Serbia,1,2,12,15,02/06/2022,0,0,1,1,11,1,5,17,6,6,4,16,0,0,1,1,5,0,0,5
5651,143548,2022,Belgium,Serbia,1,2,13,16,01/06/2022,0,0,1,1,3,2,1,6,7,4,11,22,0,0,1,1,1,0,1,2
5652,123700,2022,Türkiye,Serbia,0,2,8,10,17/07/2022,0,0,1,1,6,1,6,13,3,8,6,17,0,0,0,0,5,2,0,7
5653,123700,2022,Serbia,Brazil,2,0,11,13,16/07/2022,0,0,3,3,9,2,3,14,4,11,7,22,0,0,1,1,3,1,1,5
5654,123700,2022,USA,Serbia,2,1,13,16,13/07/2022,0,0,0,0,5,4,3,12,2,8,4,14,0,0,0,0,3,2,0,5
5655,123700,2022,Japan,Serbia,0,2,7,9,02/07/2022,0,0,3,3,9,0,11,20,3,7,6,16,2,0,1,3,5,1,0,6
5656,123700,2022,Serbia,Canada,0,2,6,8,02/07/2022,0,0,1,1,5,2,3,10,3,1,3,7,0,0,0,0,0,0,0,0
5657,123700,2022,USA,Serbia,1,0,11,12,01/07/2022,0,0,2,2,4,2,5,11,0,8,3,11,2,0,0,2,2,0,0,2
5658,123700,2022,Serbia,Germany,0,1,11,12,28/06/2022,0,0,1,1,7,4,2,13,2,4,7,13,0,0,0,0,4,0,0,4
5659,123700,2022,Brazil,Serbia,0,1,4,5,19/06/2022,0,0,0,0,4,3,4,11,3,2,5,10,0,0,0,0,0,0,0,0
5660,123700,2022,Serbia,Türkiye,0,3,11,14,17/06/2022,0,0,0,0,3,3,4,10,9,7,5,21,1,0,1,2,0,0,0,0
5661,123700,2022,Serbia,Korea,1,2,11,14,16/06/2022,0,0,0,0,6,1,5,12,1,4,4,9,1,0,1,2,4,2,1,7
5662,123700,2022,Serbia,Italy,0,3,7,10,15/06/2022,0,0,1,1,3,4,5,12,1,0,9,10,0,0,0,0,6,0,3,9
5663,123700,2022,Serbia,Netherlands,1,2,15,18,05/06/2022,1,0,0,1,4,1,5,10,5,17,10,32,0,0,0,0,3,0,1,4
5664,123700,2022,Serbia,Bulgaria,1,1,12,14,03/06/2022,0,0,3,3,3,1,3,7,1,5,6,12,0,0,0,0,1,0,1,2
5665,123700,2022,Thailand,Serbia,2,0,14,16,02/06/2022,0,0,1,1,4,3,13,20,3,8,10,21,0,0,0,0,1,0,0,1
5666,123700,2022,Belgium,Serbia,0,0,11,11,01/06/2022,0,0,1,1,4,1,6,11,0,8,12,20,0,0,0,0,6,1,0,7
5667,152173,2022,,,-,-,-,-,-,-,-,-,-,-,-,-,-,-,-,-,-,-,-,-,-,-,-,-,-
5668,142478,2022,Türkiye,Serbia,0,0,0,0,17/07/2022,0,0,0,0,0,0,0,0,0,0,0,0,1,0,2,3,2,0,1,3
5669,142478,2022,Serbia,Brazil,0,0,8,8,16/07/2022,0,0,4,4,4,4,9,17,1,0,0,1,5,1,15,21,1,4,2,7
5670,142478,2022,USA,Serbia,0,0,12,12,13/07/2022,0,0,2,2,8,5,15,28,2,4,1,7,14,1,20,35,9,4,0,13
5671,142478,2022,Japan,Serbia,0,1,9,10,02/07/2022,1,0,4,5,5,1,14,20,0,0,1,1,6,1,7,14,12,3,0,15
5672,142478,2022,Serbia,Canada,2,1,20,23,02/07/2022,0,0,3,3,9,6,12,27,2,2,2,6,3,0,15,18,4,0,0,4
5673,142478,2022,USA,Serbia,0,1,9,10,01/07/2022,0,0,0,0,7,1,8,16,1,0,2,3,13,0,12,25,4,1,0,5
5674,142478,2022,Serbia,Germany,0,0,0,0,28/06/2022,0,0,0,0,1,0,2,3,0,0,0,0,2,1,1,4,0,0,0,0
5675,142478,2022,Brazil,Serbia,0,0,8,8,19/06/2022,0,0,2,2,8,6,17,31,0,2,2,4,4,0,13,17,9,3,0,12
5676,142478,2022,Serbia,Türkiye,0,0,0,0,17/06/2022,0,0,0,0,0,0,3,3,0,0,0,0,0,1,0,1,0,0,0,0
5677,142478,2022,Serbia,Korea,0,0,0,0,16/06/2022,0,0,0,0,0,0,0,0,0,0,0,0,0,0,0,0,0,0,0,0
5678,142478,2022,Serbia,Italy,0,0,0,0,15/06/2022,0,0,0,0,0,0,0,0,0,0,0,0,0,0,0,0,0,0,0,0
5679,183533,2022,Serbia,Netherlands,0,0,0,0,05/06/2022,0,0,0,0,2,1,6,9,0,0,2,2,0,0,0,0,1,0,0,1
5680,183533,2022,Serbia,Bulgaria,0,0,0,0,03/06/2022,0,0,1,1,2,3,1,6,0,0,0,0,0,0,0,0,0,0,0,0
5681,183533,2022,Thailand,Serbia,2,2,10,14,02/06/2022,0,0,0,0,18,6,26,50,2,3,2,7,0,0,0,0,3,0,2,5
5682,183533,2022,Belgium,Serbia,0,0,0,0,01/06/2022,0,0,0,0,3,0,4,7,1,2,2,5,0,0,0,0,0,1,0,1
5683,152167,2022,Türkiye,Serbia,0,0,0,0,17/07/2022,0,0,0,0,0,0,0,0,0,0,0,0,0,0,0,0,0,0,0,0
5684,152167,2022,Serbia,Brazil,0,0,0,0,16/07/2022,0,0,0,0,0,0,0,0,0,0,0,0,0,0,0,0,0,0,0,0
5685,152167,2022,USA,Serbia,0,0,0,0,13/07/2022,0,0,0,0,0,0,0,0,0,0,0,0,0,0,0,0,0,0,0,0
5686,152167,2022,Japan,Serbia,0,0,0,0,02/07/2022,0,0,0,0,0,0,0,0,0,0,0,0,0,0,0,0,0,0,0,0
5687,152167,2022,Serbia,Canada,0,0,4,4,02/07/2022,0,0,0,0,0,0,0,0,0,0,0,0,0,0,0,0,2,0,0,2
5688,152167,2022,USA,Serbia,0,0,0,0,01/07/2022,0,0,0,0,0,0,0,0,0,0,0,0,0,0,0,0,0,0,0,0
5689,152167,2022,Serbia,Germany,0,0,0,0,28/06/2022,0,0,0,0,0,0,0,0,0,0,0,0,0,0,0,0,0,0,0,0
5690,152167,2022,Brazil,Serbia,0,0,0,0,19/06/2022,0,0,0,0,0,0,0,0,0,0,0,0,0,0,0,0,0,0,0,0
5691,152167,2022,Serbia,Türkiye,0,0,0,0,17/06/2022,0,0,0,0,0,0,0,0,0,0,0,0,0,0,0,0,0,0,0,0
5692,152167,2022,Serbia,Korea,0,0,0,0,16/06/2022,0,0,0,0,0,0,0,0,0,0,0,0,0,0,0,0,0,0,0,0
5693,152167,2022,Serbia,Italy,0,0,0,0,15/06/2022,0,0,0,0,0,0,0,0,0,0,0,0,0,0,0,0,0,0,0,0
5694,152167,2022,Serbia,Netherlands,0,0,0,0,05/06/2022,0,0,0,0,0,0,0,0,0,0,0,0,0,0,0,0,0,0,0,0
5695,152167,2022,Serbia,Bulgaria,0,0,0,0,03/06/2022,0,0,0,0,0,0,0,0,0,0,0,0,0,0,0,0,0,0,0,0
5696,152167,2022,Thailand,Serbia,0,0,0,0,02/06/2022,0,0,0,0,0,0,0,0,0,0,0,0,0,0,0,0,0,0,0,0
5697,152167,2022,Belgium,Serbia,0,0,0,0,01/06/2022,0,0,0,0,0,0,0,0,0,0,0,0,0,0,0,0,0,0,0,0
5698,142479,2022,Türkiye,Serbia,0,3,11,14,17/07/2022,0,0,2,2,18,2,9,29,1,4,0,5,6,1,20,27,5,0,0,5
5699,142479,2022,Serbia,Brazil,0,1,8,9,16/07/2022,0,0,4,4,10,3,9,22,0,0,0,0,10,0,24,34,9,2,1,12
5700,142479,2022,USA,Serbia,3,2,18,23,13/07/2022,0,0,2,2,15,9,14,38,4,4,3,11,11,0,6,17,10,2,0,12
5701,142479,2022,Brazil,Serbia,0,1,10,11,19/06/2022,0,0,0,0,6,4,5,15,0,0,0,0,17,0,26,43,5,1,1,7
5702,142479,2022,Serbia,Türkiye,1,0,19,20,17/06/2022,0,0,1,1,17,5,15,37,0,2,1,3,10,0,30,40,7,1,0,8
5703,142479,2022,Serbia,Korea,0,0,16,16,16/06/2022,0,0,2,2,7,4,7,18,1,0,0,1,6,1,12,19,11,2,2,15
5704,142479,2022,Serbia,Italy,0,2,8,10,15/06/2022,0,0,0,0,6,5,7,18,1,0,3,4,8,2,14,24,3,0,0,3
5705,142479,2022,Serbia,Netherlands,1,3,12,16,05/06/2022,0,0,3,3,16,4,16,36,4,5,4,13,3,2,30,35,14,1,5,20
5706,142479,2022,Serbia,Bulgaria,0,1,12,13,03/06/2022,0,1,3,4,13,2,13,28,2,4,2,8,3,2,14,19,6,1,4,11
5707,142479,2022,Thailand,Serbia,0,1,17,18,02/06/2022,0,0,0,0,11,3,19,33,2,3,3,8,16,2,31,49,4,3,0,7
5708,142479,2022,Belgium,Serbia,1,1,16,18,01/06/2022,0,0,0,0,18,4,15,37,0,2,4,6,9,2,15,26,8,5,0,13
5709,163056,2022,,,-,-,-,-,-,-,-,-,-,-,-,-,-,-,-,-,-,-,-,-,-,-,-,-,-
5710,153452,2022,,,-,-,-,-,-,-,-,-,-,-,-,-,-,-,-,-,-,-,-,-,-,-,-,-,-
5711,173974,2022,,,-,-,-,-,-,-,-,-,-,-,-,-,-,-,-,-,-,-,-,-,-,-,-,-,-
5712,163967,2022,Japan,Serbia,0,0,0,0,02/07/2022,0,0,0,0,0,0,0,0,0,0,0,0,0,0,0,0,0,0,0,0
5713,163967,2022,Serbia,Canada,0,0,0,0,02/07/2022,0,0,0,0,0,0,0,0,0,0,0,0,0,0,0,0,0,0,0,0
5714,163967,2022,USA,Serbia,0,0,0,0,01/07/2022,0,0,0,0,0,0,0,0,0,0,0,0,0,0,0,0,0,0,0,0
5715,163967,2022,Serbia,Germany,0,0,0,0,28/06/2022,0,0,0,0,0,0,0,0,0,0,0,0,0,0,0,0,0,0,0,0
5716,163967,2022,Brazil,Serbia,0,0,0,0,19/06/2022,0,0,0,0,0,0,0,0,0,0,0,0,0,0,0,0,0,0,0,0
5717,163967,2022,Serbia,Türkiye,0,0,0,0,17/06/2022,0,0,0,0,0,0,0,0,0,0,0,0,0,0,0,0,0,0,0,0
5718,163967,2022,Serbia,Korea,0,0,0,0,16/06/2022,0,0,0,0,0,0,0,0,0,0,0,0,0,0,0,0,0,0,0,0
5719,163967,2022,Serbia,Italy,0,0,0,0,15/06/2022,0,0,0,0,0,0,0,0,0,0,0,0,0,0,0,0,0,0,0,0
5720,163967,2022,Serbia,Netherlands,0,0,0,0,05/06/2022,0,0,0,0,0,0,0,0,0,0,0,0,0,0,0,0,0,0,0,0
5721,163967,2022,Serbia,Bulgaria,0,0,0,0,03/06/2022,0,0,0,0,0,0,0,0,0,0,0,0,0,0,0,0,0,0,0,0
5722,163967,2022,Thailand,Serbia,0,0,0,0,02/06/2022,0,0,0,0,0,0,0,0,0,0,0,0,0,0,0,0,0,0,0,0
5723,163967,2022,Belgium,Serbia,0,0,0,0,01/06/2022,0,0,0,0,0,0,0,0,0,0,0,0,0,0,0,0,0,0,0,0
5724,163117,2022,Türkiye,Serbia,0,0,0,0,17/07/2022,0,0,0,0,0,0,0,0,0,0,0,0,0,0,0,0,0,0,0,0
5725,163117,2022,Serbia,Brazil,0,0,0,0,16/07/2022,0,0,0,0,0,0,0,0,0,0,0,0,0,0,0,0,0,0,0,0
5726,163117,2022,USA,Serbia,0,0,0,0,13/07/2022,0,0,0,0,0,0,0,0,0,0,0,0,0,0,0,0,0,0,0,0
5727,163117,2022,Japan,Serbia,0,0,0,0,02/07/2022,0,0,0,0,0,0,0,0,0,0,0,0,0,0,0,0,0,0,0,0
5728,163117,2022,Serbia,Canada,0,0,0,0,02/07/2022,0,0,0,0,0,0,0,0,0,0,0,0,0,0,0,0,0,0,0,0
5729,163117,2022,USA,Serbia,0,0,0,0,01/07/2022,0,0,0,0,0,0,0,0,0,0,0,0,0,0,0,0,0,0,0,0
5730,163117,2022,Serbia,Germany,0,0,0,0,28/06/2022,0,0,0,0,0,0,0,0,0,0,0,0,0,0,0,0,0,0,0,0
5731,163117,2022,Brazil,Serbia,0,0,0,0,19/06/2022,0,0,0,0,0,0,0,0,0,0,0,0,0,0,0,0,0,0,0,0
5732,163117,2022,Serbia,Türkiye,0,0,0,0,17/06/2022,0,0,0,0,0,0,0,0,0,0,0,0,0,0,0,0,0,0,0,0
5733,163117,2022,Serbia,Korea,0,0,0,0,16/06/2022,0,0,0,0,0,0,0,0,0,0,0,0,0,0,0,0,0,0,0,0
5734,163117,2022,Serbia,Italy,0,0,0,0,15/06/2022,0,0,0,0,0,0,0,0,0,0,0,0,0,0,0,0,0,0,0,0
5735,163117,2022,Serbia,Netherlands,0,0,0,0,05/06/2022,0,0,0,0,0,0,0,0,0,0,0,0,0,0,0,0,0,0,0,0
5736,163117,2022,Serbia,Bulgaria,0,0,0,0,03/06/2022,0,0,0,0,0,0,0,0,0,0,0,0,0,0,0,0,0,0,0,0
5737,163117,2022,Thailand,Serbia,0,0,0,0,02/06/2022,0,0,0,0,0,0,0,0,0,0,0,0,0,0,0,0,0,0,0,0
5738,163117,2022,Belgium,Serbia,0,0,0,0,01/06/2022,0,0,0,0,0,0,0,0,0,0,0,0,0,0,0,0,0,0,0,0
5739,173979,2022,,,-,-,-,-,-,-,-,-,-,-,-,-,-,-,-,-,-,-,-,-,-,-,-,-,-
5740,163119,2022,Japan,Serbia,0,0,8,8,02/07/2022,0,1,1,2,8,2,8,18,0,0,1,1,0,0,0,0,11,3,0,14
5741,163119,2022,Serbia,Canada,0,1,5,6,02/07/2022,0,0,0,0,0,0,0,0,0,0,0,0,0,0,0,0,0,0,0,0
5742,163119,2022,USA,Serbia,1,0,2,3,01/07/2022,0,0,0,0,0,0,0,0,0,0,0,0,0,0,0,0,0,0,0,0
5743,163119,2022,Serbia,Germany,0,0,4,4,28/06/2022,0,0,0,0,0,0,0,0,0,0,0,0,0,0,0,0,0,0,0,0
5744,163119,2022,Brazil,Serbia,0,0,0,0,19/06/2022,0,0,0,0,0,0,1,1,0,1,0,1,0,0,0,0,0,0,0,0
5745,163119,2022,Serbia,Türkiye,0,0,1,1,17/06/2022,0,0,0,0,1,0,3,4,0,0,0,0,0,0,0,0,0,0,1,1
5746,163119,2022,Serbia,Korea,0,0,0,0,16/06/2022,0,0,0,0,1,0,1,2,0,0,0,0,0,0,0,0,0,0,0,0
5747,163119,2022,Serbia,Italy,0,0,0,0,15/06/2022,0,0,0,0,0,1,3,4,0,0,0,0,0,0,0,0,0,0,0,0
5748,163119,2022,Serbia,Netherlands,0,0,0,0,05/06/2022,0,0,0,0,0,0,0,0,0,0,0,0,0,0,1,1,0,0,0,0
5749,163119,2022,Serbia,Bulgaria,0,0,2,2,03/06/2022,0,0,0,0,1,0,1,2,0,1,1,2,0,0,2,2,0,1,0,1
5750,163119,2022,Thailand,Serbia,1,0,4,5,02/06/2022,0,0,0,0,4,0,4,8,1,0,0,1,2,0,12,14,1,2,0,3
5751,163119,2022,Belgium,Serbia,0,0,0,0,01/06/2022,0,0,0,0,0,0,0,0,0,0,0,0,0,0,0,0,0,0,0,0
5752,173179,2022,Japan,Serbia,0,1,5,6,02/07/2022,0,0,1,1,4,3,10,17,0,1,3,4,0,0,0,0,3,0,1,4
5753,173179,2022,Serbia,Canada,0,0,0,0,02/07/2022,0,0,0,0,0,0,0,0,0,0,0,0,0,0,0,0,0,0,0,0
5754,173179,2022,USA,Serbia,0,1,0,1,01/07/2022,0,0,0,0,2,0,2,4,0,0,0,0,0,0,0,0,0,0,0,0
5755,173179,2022,Serbia,Germany,0,0,0,0,28/06/2022,0,0,0,0,1,0,1,2,0,0,0,0,0,0,0,0,0,0,0,0
5756,151120,2022,Thailand,USA,0,0,0,0,19/06/2022,0,0,0,0,0,0,0,0,0,0,0,0,0,0,0,0,0,0,0,0
5757,151120,2022,Japan,Thailand,0,0,0,0,17/06/2022,0,0,0,0,0,0,0,0,0,0,0,0,0,0,0,0,0,0,0,0
5758,151120,2022,Poland,Thailand,0,0,3,3,16/06/2022,0,0,1,1,0,1,0,1,0,0,0,0,1,0,1,2,1,1,0,2
5759,131866,2022,Türkiye,Thailand,0,0,0,0,14/07/2022,0,0,6,6,0,0,0,0,0,0,0,0,5,1,10,16,2,1,4,7
5760,131866,2022,Thailand,Italy,0,0,0,0,03/07/2022,0,0,2,2,0,0,0,0,0,0,0,0,5,0,2,7,2,1,0,3
5761,131866,2022,Brazil,Thailand,0,0,0,0,02/07/2022,0,0,5,5,0,0,0,0,0,0,0,0,6,0,9,15,7,3,6,16
5762,131866,2022,Thailand,Dominican Republic,0,0,0,0,30/06/2022,6,0,0,6,0,0,0,0,0,0,0,0,5,1,9,15,5,1,7,13
5763,131866,2022,Thailand,Korea,0,0,0,0,29/06/2022,1,0,0,1,0,0,0,0,0,0,0,0,1,0,10,11,3,0,0,3
5764,131866,2022,Thailand,USA,0,0,0,0,19/06/2022,1,1,12,14,0,0,0,0,0,0,0,0,4,1,12,17,7,3,2,12
5765,131866,2022,Japan,Thailand,0,0,0,0,17/06/2022,0,2,8,10,0,0,0,0,0,0,0,0,2,0,2,4,6,0,1,7
5766,131866,2022,Thailand,China,0,0,0,0,05/06/2022,2,1,7,10,0,0,0,0,0,0,0,0,11,1,10,22,6,1,3,10
5767,131866,2022,Thailand,Belgium,0,0,0,0,04/06/2022,9,1,6,16,0,0,0,0,0,0,0,0,4,1,11,16,12,2,4,18
5768,131866,2022,Thailand,Serbia,0,0,0,0,02/06/2022,0,0,4,4,0,0,0,0,0,0,0,0,8,1,9,18,9,3,4,16
5769,131866,2022,Thailand,Bulgaria,0,0,0,0,31/05/2022,0,0,2,2,0,0,0,0,0,0,0,0,4,0,9,13,3,1,1,5
5770,123019,2022,Türkiye,Thailand,0,1,8,9,14/07/2022,28,0,74,102,2,0,1,3,2,1,3,6,0,1,0,1,4,6,3,13
5771,123019,2022,Thailand,Italy,0,0,8,8,03/07/2022,7,1,70,78,0,0,0,0,0,0,0,0,0,0,1,1,1,1,1,3
5772,123019,2022,Brazil,Thailand,0,1,13,14,02/07/2022,19,2,108,129,1,0,2,3,1,7,4,12,0,0,0,0,3,1,0,4
5773,123019,2022,Thailand,Dominican Republic,0,2,6,8,30/06/2022,93,0,1,94,0,1,3,4,0,6,1,7,0,0,0,0,6,4,6,16
5774,123019,2022,Thailand,Korea,0,1,16,17,29/06/2022,66,0,2,68,3,0,0,3,2,0,4,6,0,0,0,0,3,0,1,4
5775,123019,2022,Thailand,USA,1,0,10,11,19/06/2022,22,0,85,107,2,0,0,2,0,4,3,7,0,0,1,1,14,3,2,19
5776,123019,2022,Japan,Thailand,0,1,8,9,17/06/2022,31,2,56,89,1,0,2,3,1,3,5,9,0,0,0,0,4,5,1,10
5777,123019,2022,Poland,Thailand,1,0,21,22,16/06/2022,19,1,97,117,0,1,3,4,0,2,6,8,0,0,0,0,10,2,0,12
5778,123019,2022,Canada,Thailand,0,0,5,5,14/06/2022,6,0,11,17,0,0,0,0,0,0,0,0,0,0,0,0,0,1,0,1
5779,123019,2022,Thailand,China,0,2,9,11,05/06/2022,64,2,42,108,1,0,2,3,0,2,2,4,0,0,0,0,8,5,2,15
5780,123019,2022,Thailand,Belgium,0,1,16,17,04/06/2022,80,1,52,133,3,0,0,3,0,1,6,7,0,1,0,1,6,0,3,9
5781,123019,2022,Thailand,Serbia,2,0,14,16,02/06/2022,40,0,117,157,0,1,2,3,1,1,2,4,0,0,0,0,1,4,3,8
5782,123019,2022,Thailand,Bulgaria,0,2,8,10,31/05/2022,28,0,53,81,0,0,2,2,1,3,4,8,0,0,0,0,3,2,2,7
5783,142172,2022,Thailand,Belgium,0,2,1,3,04/06/2022,0,0,0,0,1,0,2,3,0,1,2,3,0,0,0,0,3,0,0,3
5784,142172,2022,Thailand,Serbia,1,1,18,20,02/06/2022,0,0,2,2,6,2,4,12,3,6,2,11,0,0,0,0,0,1,1,2
5785,142172,2022,Thailand,Bulgaria,0,1,9,10,31/05/2022,0,0,0,0,5,0,1,6,0,3,2,5,0,0,1,1,1,1,0,2
5786,147187,2022,Thailand,USA,0,0,0,0,19/06/2022,0,0,0,0,0,0,0,0,0,0,0,0,0,0,0,0,0,0,0,0
5787,147187,2022,Japan,Thailand,0,0,0,0,17/06/2022,0,0,0,0,0,0,0,0,0,0,0,0,0,0,0,0,0,0,0,0
5788,147187,2022,Poland,Thailand,0,0,2,2,16/06/2022,0,0,0,0,1,0,1,2,1,0,0,1,0,0,0,0,1,1,0,2
5789,143051,2022,,,-,-,-,-,-,-,-,-,-,-,-,-,-,-,-,-,-,-,-,-,-,-,-,-,-
5790,142178,2022,,,-,-,-,-,-,-,-,-,-,-,-,-,-,-,-,-,-,-,-,-,-,-,-,-,-
5791,143002,2022,Türkiye,Thailand,0,1,9,10,14/07/2022,0,1,1,2,0,1,1,2,0,5,3,8,0,0,0,0,1,1,0,2
5792,143002,2022,Thailand,Italy,0,0,4,4,03/07/2022,0,0,0,0,1,0,1,2,0,0,0,0,0,0,0,0,0,0,0,0
5793,143002,2022,Brazil,Thailand,0,1,1,2,02/07/2022,0,0,0,0,1,2,0,3,0,1,0,1,0,0,0,0,0,0,0,0
5794,143002,2022,Thailand,Dominican Republic,1,1,15,17,30/06/2022,1,0,1,2,4,0,1,5,2,2,2,6,1,0,0,1,0,1,0,1
5795,143002,2022,Thailand,Korea,0,0,12,12,29/06/2022,0,0,0,0,4,2,1,7,2,3,2,7,0,0,1,1,1,0,0,1
5796,143002,2022,Thailand,USA,0,0,17,17,19/06/2022,0,0,4,4,0,2,7,9,0,6,2,8,0,0,0,0,2,1,1,4
5797,143002,2022,Japan,Thailand,0,0,10,10,17/06/2022,0,0,1,1,5,1,2,8,0,5,4,9,0,0,1,1,0,0,0,0
5798,143002,2022,Poland,Thailand,2,0,16,18,16/06/2022,0,0,1,1,4,1,3,8,3,4,5,12,0,2,0,2,1,0,1,2
5799,152206,2022,,,-,-,-,-,-,-,-,-,-,-,-,-,-,-,-,-,-,-,-,-,-,-,-,-,-
5800,142180,2022,Thailand,USA,0,0,0,0,19/06/2022,0,0,0,0,0,0,0,0,0,0,0,0,0,0,0,0,0,0,0,0
5801,142180,2022,Japan,Thailand,0,0,0,0,17/06/2022,0,0,0,0,0,1,2,3,0,0,0,0,0,0,0,0,1,0,0,1
5802,142180,2022,Poland,Thailand,0,0,0,0,16/06/2022,0,0,1,1,0,0,0,0,0,0,0,0,0,0,1,1,1,0,1,2
5803,145244,2022,Türkiye,Thailand,1,3,8,12,14/07/2022,0,0,0,0,4,2,4,10,1,4,4,9,0,0,0,0,4,0,3,7
5804,145244,2022,Thailand,Italy,0,0,10,10,03/07/2022,0,0,0,0,5,1,7,13,0,3,3,6,0,0,0,0,3,0,1,4
5805,145244,2022,Brazil,Thailand,0,2,13,15,02/07/2022,0,0,0,0,8,2,6,16,2,5,6,13,0,0,0,0,1,1,1,3
5806,145244,2022,Thailand,Dominican Republic,0,1,9,10,30/06/2022,0,1,0,1,3,1,4,8,2,11,2,15,0,0,0,0,2,0,2,4
5807,145244,2022,Thailand,Korea,0,2,9,11,29/06/2022,2,0,0,2,3,0,2,5,2,3,2,7,0,0,0,0,1,1,0,2
5808,145244,2022,Canada,Thailand,0,1,9,10,14/06/2022,0,0,2,2,4,0,4,8,1,2,3,6,0,0,0,0,4,0,0,4
5809,145244,2022,Thailand,China,1,1,14,16,05/06/2022,1,0,1,2,2,0,4,6,1,8,6,15,0,0,2,2,6,0,3,9
5810,145244,2022,Thailand,Belgium,0,0,20,20,04/06/2022,0,0,2,2,5,2,5,12,3,7,10,20,0,0,1,1,7,1,2,10
5811,145244,2022,Thailand,Serbia,0,2,11,13,02/06/2022,0,0,0,0,9,1,13,23,1,2,8,11,1,0,1,2,3,3,1,7
5812,145244,2022,Thailand,Bulgaria,1,1,9,11,31/05/2022,0,0,0,0,7,2,2,11,1,4,3,8,1,0,0,1,0,1,1,2
5813,152179,2022,Canada,Thailand,0,0,0,0,14/06/2022,0,0,0,0,0,0,0,0,0,0,0,0,0,0,0,0,0,0,0,0
5814,122866,2022,Türkiye,Thailand,0,0,0,0,14/07/2022,0,0,0,0,0,0,0,0,0,0,0,0,0,0,0,0,0,0,0,0
5815,122866,2022,Thailand,Italy,0,0,1,1,03/07/2022,0,0,0,0,0,0,1,1,0,0,0,0,0,0,0,0,1,1,1,3
5816,122866,2022,Brazil,Thailand,0,0,0,0,02/07/2022,0,0,0,0,0,0,0,0,0,0,0,0,0,0,0,0,0,0,0,0
5817,122866,2022,Thailand,Dominican Republic,0,1,1,2,30/06/2022,0,0,0,0,0,0,0,0,0,0,0,0,1,0,1,2,1,1,3,5
5818,122866,2022,Thailand,Korea,0,0,0,0,29/06/2022,0,0,0,0,0,0,0,0,0,0,0,0,0,0,0,0,0,0,0,0
5819,122866,2022,Thailand,China,0,0,0,0,05/06/2022,0,0,0,0,0,0,0,0,0,0,0,0,0,0,0,0,0,0,0,0
5820,122866,2022,Thailand,Belgium,0,0,1,1,04/06/2022,0,0,2,2,0,0,0,0,0,0,0,0,0,0,1,1,1,0,0,1
5821,122866,2022,Thailand,Serbia,0,0,0,0,02/06/2022,0,0,0,0,0,0,0,0,0,0,0,0,0,0,3,3,0,0,0,0
5822,122866,2022,Thailand,Bulgaria,0,0,0,0,31/05/2022,0,0,0,0,0,0,0,0,0,0,0,0,0,0,0,0,0,0,0,0
5823,142185,2022,Türkiye,Thailand,0,0,3,3,14/07/2022,0,0,0,0,0,0,2,2,0,3,1,4,1,0,0,1,1,2,0,3
5824,142185,2022,Thailand,Italy,0,0,3,3,03/07/2022,0,0,0,0,2,0,1,3,0,0,0,0,0,0,0,0,1,0,0,1
5825,142185,2022,Brazil,Thailand,1,2,9,12,02/07/2022,0,0,0,0,5,0,3,8,1,3,3,7,0,0,0,0,2,1,1,4
5826,142185,2022,Thailand,Dominican Republic,0,0,0,0,30/06/2022,0,0,0,0,0,0,0,0,0,0,0,0,0,0,0,0,0,0,0,0
5827,142185,2022,Thailand,Korea,0,0,0,0,29/06/2022,0,0,0,0,0,0,0,0,0,0,0,0,0,0,0,0,0,0,0,0
5828,142185,2022,Thailand,USA,0,2,7,9,19/06/2022,1,0,0,1,3,0,5,8,0,3,7,10,1,0,0,1,2,0,2,4
5829,142185,2022,Japan,Thailand,0,0,8,8,17/06/2022,1,0,0,1,3,0,14,17,1,3,10,14,1,0,1,2,6,0,0,6
5830,142185,2022,Poland,Thailand,0,2,11,13,16/06/2022,1,0,3,4,1,2,6,9,0,11,13,24,0,0,1,1,2,2,1,5
5831,142185,2022,Canada,Thailand,0,0,14,14,14/06/2022,0,0,0,0,0,1,1,2,0,4,3,7,0,0,0,0,2,0,0,2
5832,142185,2022,Thailand,China,0,1,18,19,05/06/2022,2,0,2,4,1,0,4,5,2,4,8,14,0,2,1,3,1,3,4,8
5833,142185,2022,Thailand,Belgium,0,1,4,5,04/06/2022,0,0,2,2,0,0,4,4,0,2,2,4,0,0,0,0,0,0,1,1
5834,142185,2022,Thailand,Serbia,0,0,0,0,02/06/2022,0,0,0,0,0,0,0,0,0,0,0,0,0,0,0,0,0,0,0,0
5835,142185,2022,Thailand,Bulgaria,0,0,0,0,31/05/2022,0,0,0,0,0,0,0,0,0,0,0,0,0,0,0,0,0,0,0,0
5836,151121,2022,Türkiye,Thailand,1,1,12,14,14/07/2022,0,0,2,2,8,5,12,25,1,0,1,2,0,0,0,0,5,6,3,14
5837,151121,2022,Thailand,Italy,0,1,4,5,03/07/2022,0,0,2,2,8,7,14,29,0,0,0,0,0,0,1,1,3,0,2,5
5838,151121,2022,Brazil,Thailand,0,0,16,16,02/07/2022,0,1,0,1,22,7,16,45,1,5,0,6,0,0,0,0,4,0,2,6
5839,151121,2022,Thailand,Dominican Republic,3,1,17,21,30/06/2022,2,2,1,5,26,4,17,47,1,3,2,6,0,0,0,0,4,1,3,8
5840,151121,2022,Thailand,Korea,0,0,11,11,29/06/2022,1,0,0,1,7,2,11,20,4,2,3,9,0,0,0,0,3,1,0,4
5841,151121,2022,Thailand,USA,0,0,11,11,19/06/2022,0,0,0,0,8,8,15,31,0,4,2,6,1,0,6,7,8,1,3,12
5842,151121,2022,Japan,Thailand,0,1,9,10,17/06/2022,0,0,1,1,8,6,15,29,0,3,3,6,3,0,3,6,14,1,1,16
5843,151121,2022,Poland,Thailand,1,2,12,15,16/06/2022,0,1,2,3,12,3,15,30,0,1,7,8,0,0,0,0,12,0,1,13
5844,151121,2022,Canada,Thailand,1,0,14,15,14/06/2022,0,0,2,2,19,1,13,33,0,2,4,6,0,0,0,0,4,1,2,7
5845,151121,2022,Thailand,China,1,3,10,14,05/06/2022,2,0,1,3,27,5,23,55,1,2,6,9,3,0,4,7,6,0,2,8
5846,151121,2022,Thailand,Belgium,1,1,19,21,04/06/2022,1,0,2,3,21,9,21,51,2,1,2,5,0,0,0,0,15,3,3,21
5847,151121,2022,Thailand,Serbia,1,0,17,18,02/06/2022,0,0,0,0,31,7,19,57,0,2,4,6,0,0,2,2,6,3,5,14
5848,151121,2022,Thailand,Bulgaria,3,2,16,21,31/05/2022,0,0,0,0,7,2,12,21,2,0,6,8,0,0,0,0,7,6,2,15
5849,143053,2022,Türkiye,Thailand,0,0,0,0,14/07/2022,0,0,0,0,0,0,0,0,0,0,0,0,0,0,0,0,0,0,0,0
5850,143053,2022,Thailand,USA,0,0,0,0,19/06/2022,0,0,0,0,0,0,0,0,0,0,0,0,0,0,0,0,0,0,0,0
5851,143053,2022,Japan,Thailand,0,0,0,0,17/06/2022,3,0,4,7,0,0,0,0,0,0,0,0,0,0,0,0,0,0,0,0
5852,143053,2022,Poland,Thailand,0,0,0,0,16/06/2022,0,0,0,0,0,0,0,0,0,0,0,0,0,0,0,0,0,0,0,0
5853,143053,2022,Thailand,China,0,1,0,1,05/06/2022,4,0,5,9,0,0,0,0,0,1,0,1,0,0,0,0,1,0,0,1
5854,143053,2022,Thailand,Belgium,0,0,0,0,04/06/2022,4,0,4,8,0,0,0,0,0,0,0,0,0,0,0,0,0,0,0,0
5855,143053,2022,Thailand,Serbia,0,1,0,1,02/06/2022,0,0,0,0,0,0,0,0,0,0,0,0,0,0,0,0,0,0,0,0
5856,143053,2022,Thailand,Bulgaria,0,0,0,0,31/05/2022,0,0,0,0,0,0,0,0,0,0,0,0,0,0,0,0,0,0,0,0
5857,133511,2022,Türkiye,Thailand,1,0,18,19,14/07/2022,0,0,1,1,20,6,18,44,0,2,3,5,1,1,14,16,5,2,5,12
5858,133511,2022,Thailand,Italy,0,0,6,6,03/07/2022,0,0,1,1,4,1,15,20,0,2,0,2,2,1,12,15,5,1,1,7
5859,133511,2022,Brazil,Thailand,2,0,12,14,02/07/2022,0,0,1,1,14,6,19,39,0,0,0,0,13,0,31,44,9,1,2,12
5860,133511,2022,Thailand,Dominican Republic,0,1,9,10,30/06/2022,1,0,0,1,14,4,17,35,1,2,1,4,5,3,19,27,7,1,3,11
5861,133511,2022,Thailand,Korea,0,1,7,8,29/06/2022,1,0,0,1,11,3,12,26,2,3,3,8,0,0,11,11,7,3,1,11
5862,133511,2022,Thailand,USA,0,0,10,10,19/06/2022,0,0,0,0,24,7,21,52,1,1,6,8,3,1,12,16,11,3,3,17
5863,133511,2022,Japan,Thailand,0,1,7,8,17/06/2022,0,0,1,1,8,2,21,31,2,0,1,3,6,0,9,15,9,7,1,17
5864,133511,2022,Poland,Thailand,0,0,8,8,16/06/2022,0,0,5,5,9,7,24,40,0,0,2,2,6,0,9,15,15,2,4,21
5865,133511,2022,Canada,Thailand,0,2,10,12,14/06/2022,0,0,0,0,6,3,18,27,1,2,1,4,8,2,13,23,5,2,0,7
5866,133511,2022,Thailand,China,0,0,5,5,05/06/2022,1,0,0,1,8,1,7,16,0,1,2,3,1,0,11,12,6,0,1,7
5867,133511,2022,Thailand,Belgium,0,2,14,16,04/06/2022,2,0,1,3,16,3,21,40,0,2,6,8,8,2,21,31,21,2,0,23
5868,133511,2022,Thailand,Serbia,0,1,24,25,02/06/2022,0,0,0,0,11,9,17,37,3,3,3,9,12,5,43,60,9,1,0,10
5869,133511,2022,Thailand,Bulgaria,1,1,11,13,31/05/2022,0,0,0,0,17,2,13,32,2,4,1,7,2,1,10,13,7,3,0,10
5870,147213,2022,Türkiye,Thailand,0,3,8,11,14/07/2022,0,0,0,0,16,8,14,38,0,2,1,3,17,3,31,51,6,3,3,12
5871,147213,2022,Thailand,Italy,0,2,4,6,03/07/2022,0,0,0,0,10,4,6,20,0,3,0,3,7,5,22,34,6,2,3,11
5872,147213,2022,Brazil,Thailand,0,4,11,15,02/07/2022,0,0,0,0,12,4,13,29,2,1,1,4,12,1,22,35,14,2,2,18
5873,147213,2022,Thailand,Dominican Republic,2,3,15,20,30/06/2022,3,0,1,4,7,4,19,30,0,2,0,2,9,0,31,40,7,3,1,11
5874,147213,2022,Thailand,Korea,1,2,12,15,29/06/2022,3,0,1,4,8,3,9,20,5,4,1,10,6,1,13,20,4,0,1,5
5875,147213,2022,Thailand,USA,2,2,18,22,19/06/2022,0,1,4,5,10,3,22,35,1,4,1,6,12,3,22,37,12,3,2,17
5876,147213,2022,Japan,Thailand,0,3,5,8,17/06/2022,0,0,2,2,9,3,13,25,2,1,2,5,13,0,25,38,10,3,0,13
5877,147213,2022,Poland,Thailand,1,3,11,15,16/06/2022,0,0,2,2,20,5,27,52,5,4,3,12,15,2,42,59,11,1,3,15
5878,147213,2022,Canada,Thailand,2,3,9,14,14/06/2022,0,0,1,1,16,2,14,32,0,2,1,3,5,2,15,22,5,1,2,8
5879,147213,2022,Thailand,China,0,2,15,17,05/06/2022,2,0,5,7,16,5,18,39,2,2,4,8,8,2,33,43,11,3,3,17
5880,147213,2022,Thailand,Belgium,1,1,14,16,04/06/2022,0,0,1,1,21,7,23,51,6,3,4,13,12,2,33,47,13,5,0,18
5881,147213,2022,Thailand,Serbia,0,2,15,17,02/06/2022,0,0,1,1,24,4,21,49,4,4,2,10,4,2,10,16,8,3,3,14
5882,147213,2022,Thailand,Bulgaria,0,1,7,8,31/05/2022,0,0,1,1,11,3,10,24,2,2,0,4,5,0,20,25,8,4,2,14
5883,162681,2022,Türkiye,Thailand,0,0,0,0,14/07/2022,0,0,5,5,0,0,0,0,0,0,0,0,0,0,0,0,7,9,3,19
5884,162681,2022,Thailand,Italy,0,0,0,0,03/07/2022,0,0,0,0,0,0,0,0,0,0,0,0,0,0,0,0,1,3,0,4
5885,162681,2022,Brazil,Thailand,0,0,0,0,02/07/2022,0,0,1,1,0,0,0,0,0,0,0,0,0,0,0,0,1,2,1,4
5886,162681,2022,Thailand,Dominican Republic,0,0,0,0,30/06/2022,3,0,0,3,0,0,0,0,0,0,0,0,0,0,0,0,11,1,0,12
5887,162681,2022,Thailand,Korea,0,0,0,0,29/06/2022,0,0,1,1,0,0,0,0,0,0,0,0,0,0,0,0,5,2,3,10
5888,162681,2022,Thailand,China,0,0,0,0,05/06/2022,1,0,0,1,0,0,0,0,0,0,0,0,0,0,0,0,7,1,1,9
5889,162681,2022,Thailand,Belgium,0,0,0,0,04/06/2022,0,0,0,0,0,0,0,0,0,0,0,0,0,0,0,0,2,2,0,4
5890,162681,2022,Thailand,Serbia,0,0,0,0,02/06/2022,0,0,0,0,0,0,0,0,0,0,0,0,0,0,0,0,3,1,0,4
5891,162681,2022,Thailand,Bulgaria,0,0,0,0,31/05/2022,0,0,4,4,0,0,0,0,0,0,0,0,0,0,0,0,7,6,1,14
5892,152205,2022,Türkiye,Thailand,0,0,1,1,14/07/2022,0,0,0,0,1,0,0,1,0,0,0,0,0,0,0,0,0,0,0,0
5893,152205,2022,Thailand,Italy,0,0,1,1,03/07/2022,0,0,0,0,2,0,1,3,0,1,0,1,0,0,0,0,0,0,0,0
5894,152205,2022,Brazil,Thailand,0,1,0,1,02/07/2022,0,0,1,1,0,2,0,2,0,0,0,0,0,0,0,0,0,0,0,0
5895,152205,2022,Thailand,Dominican Republic,0,0,2,2,30/06/2022,1,0,0,1,2,0,1,3,0,1,0,1,0,0,0,0,0,1,0,1
5896,152205,2022,Thailand,Korea,0,0,0,0,29/06/2022,0,0,0,0,0,0,0,0,0,0,0,0,0,0,0,0,0,0,0,0
5897,152205,2022,Thailand,USA,0,0,0,0,19/06/2022,0,0,0,0,0,0,0,0,0,0,0,0,0,0,0,0,0,0,0,0
5898,152205,2022,Japan,Thailand,0,1,0,1,17/06/2022,0,0,0,0,0,0,2,2,0,1,0,1,0,0,0,0,0,0,0,0
5899,152205,2022,Poland,Thailand,0,1,2,3,16/06/2022,0,0,2,2,5,4,4,13,0,1,0,1,0,0,1,1,2,2,0,4
5900,152205,2022,Canada,Thailand,0,0,0,0,14/06/2022,0,0,0,0,0,0,1,1,0,0,0,0,0,0,0,0,0,0,0,0
5901,152205,2022,Thailand,China,0,0,0,0,05/06/2022,0,0,0,0,2,0,0,2,0,1,0,1,0,0,1,1,0,0,0,0
5902,152205,2022,Thailand,Belgium,0,1,0,1,04/06/2022,1,0,0,1,2,0,1,3,0,0,2,2,0,0,0,0,0,0,0,0
5903,152205,2022,Thailand,Serbia,0,0,0,0,02/06/2022,0,0,0,0,0,0,0,0,0,0,0,0,0,0,0,0,0,0,0,0
5904,152205,2022,Thailand,Bulgaria,0,0,0,0,31/05/2022,0,0,0,0,0,0,0,0,0,0,0,0,0,0,0,0,0,0,0,0
5905,148711,2022,Thailand,USA,0,0,0,0,19/06/2022,0,0,7,7,0,0,0,0,0,0,0,0,0,0,0,0,9,1,1,11
5906,148711,2022,Japan,Thailand,0,0,0,0,17/06/2022,0,0,4,4,0,0,0,0,0,0,0,0,0,0,0,0,3,0,1,4
5907,148711,2022,Poland,Thailand,0,0,0,0,16/06/2022,0,0,11,11,0,0,0,0,0,0,0,0,1,3,12,16,11,3,3,17
5908,148711,2022,Canada,Thailand,0,0,0,0,14/06/2022,1,0,5,6,0,0,0,0,0,0,0,0,2,1,5,8,5,0,1,6
5909,181410,2022,Türkiye,Thailand,0,0,0,0,14/07/2022,0,0,3,3,0,0,0,0,0,0,0,0,0,0,0,0,0,1,0,1
5910,181410,2022,Thailand,Italy,0,0,2,2,03/07/2022,1,0,13,14,0,0,0,0,0,0,0,0,0,0,0,0,1,0,0,1
5911,181410,2022,Brazil,Thailand,1,0,1,2,02/07/2022,0,0,2,2,0,0,0,0,0,0,0,0,0,0,0,0,0,0,0,0
5912,181410,2022,Thailand,Dominican Republic,0,0,1,1,30/06/2022,4,0,0,4,0,0,0,0,0,0,0,0,0,0,0,0,0,0,0,0
5913,181410,2022,Thailand,Korea,0,0,0,0,29/06/2022,0,0,0,0,0,0,0,0,0,0,0,0,0,0,0,0,0,0,0,0
5914,181410,2022,Thailand,USA,0,0,0,0,19/06/2022,0,0,1,1,0,0,0,0,0,0,0,0,0,0,0,0,0,0,1,1
5915,181410,2022,Poland,Thailand,0,0,0,0,16/06/2022,1,0,5,6,0,0,0,0,0,0,0,0,0,0,0,0,2,0,0,2
5916,181410,2022,Canada,Thailand,0,0,6,6,14/06/2022,12,2,60,74,0,0,0,0,0,2,3,5,0,1,0,1,4,3,1,8
5917,163495,2022,Thailand,Italy,0,0,3,3,03/07/2022,0,0,0,0,0,0,2,2,0,1,1,2,0,0,0,0,1,1,0,2
5918,163495,2022,Brazil,Thailand,0,0,0,0,02/07/2022,0,0,0,0,0,0,0,0,0,0,0,0,0,0,0,0,0,0,0,0
5919,163495,2022,Thailand,Dominican Republic,0,1,1,2,30/06/2022,1,0,0,1,0,0,0,0,0,0,0,0,0,0,0,0,0,0,0,0
5920,163495,2022,Thailand,Korea,0,0,0,0,29/06/2022,0,0,0,0,0,0,0,0,0,0,0,0,0,0,0,0,0,0,0,0
5921,163495,2022,Canada,Thailand,0,0,0,0,14/06/2022,0,0,0,0,0,0,0,0,0,0,0,0,0,0,0,0,0,0,0,0
5922,163495,2022,Thailand,China,0,0,2,2,05/06/2022,0,0,0,0,1,1,2,4,0,1,0,1,0,0,0,0,1,0,0,1
5923,163495,2022,Thailand,Belgium,0,1,5,6,04/06/2022,0,0,0,0,1,0,1,2,0,3,5,8,0,0,1,1,1,0,1,2
5924,163495,2022,Thailand,Serbia,0,0,0,0,02/06/2022,0,0,0,0,0,0,0,0,0,0,0,0,0,0,0,0,0,0,0,0
5925,163495,2022,Thailand,Bulgaria,0,0,0,0,31/05/2022,0,0,0,0,0,0,0,0,0,0,0,0,0,0,0,0,0,0,0,0
5926,180383,2022,Türkiye,Thailand,0,0,1,1,14/07/2022,0,0,0,0,0,1,2,3,0,0,0,0,0,0,1,1,1,0,1,2
5927,180383,2022,Thailand,Italy,0,0,1,1,03/07/2022,0,0,0,0,2,1,1,4,0,0,0,0,2,1,5,8,1,0,0,1
5928,180383,2022,Brazil,Thailand,0,0,0,0,02/07/2022,0,0,0,0,0,0,0,0,0,0,0,0,0,0,0,0,0,0,0,0
5929,180383,2022,Thailand,Dominican Republic,0,0,0,0,30/06/2022,0,0,0,0,0,0,0,0,0,0,0,0,0,0,0,0,0,0,0,0
5930,180383,2022,Thailand,Korea,0,0,0,0,29/06/2022,0,0,0,0,0,0,0,0,0,0,0,0,0,0,0,0,0,0,0,0
5931,180383,2022,Canada,Thailand,0,0,0,0,14/06/2022,0,0,0,0,0,0,0,0,0,0,0,0,0,0,0,0,0,0,0,0
5932,180383,2022,Thailand,China,0,3,3,6,05/06/2022,2,0,2,4,6,2,8,16,0,1,1,2,3,2,10,15,3,5,3,11
5933,180383,2022,Thailand,Belgium,0,0,0,0,04/06/2022,0,0,0,0,0,0,0,0,0,0,0,0,0,0,0,0,0,0,0,0
5934,180383,2022,Thailand,Serbia,0,0,0,0,02/06/2022,0,0,0,0,0,0,0,0,0,0,0,0,0,0,0,0,0,0,0,0
5935,180383,2022,Thailand,Bulgaria,0,0,0,0,31/05/2022,0,0,0,0,0,0,0,0,0,0,0,0,0,0,0,0,0,0,0,0
5936,183330,2022,,,-,-,-,-,-,-,-,-,-,-,-,-,-,-,-,-,-,-,-,-,-,-,-,-,-
5937,163178,2022,Türkiye,Serbia,0,0,0,0,17/07/2022,0,0,0,0,0,0,0,0,0,0,0,0,0,0,0,0,0,0,0,0
5938,163178,2022,Türkiye,Italy,0,0,0,0,16/07/2022,0,0,0,0,0,0,0,0,0,0,0,0,0,0,0,0,0,0,0,0
5939,163178,2022,Türkiye,Thailand,0,0,0,0,14/07/2022,0,0,0,0,0,0,0,0,0,0,0,0,0,0,0,0,0,0,0,0
5940,163178,2022,Türkiye,Korea,0,0,4,4,19/06/2022,0,0,0,0,0,1,3,4,0,2,1,3,0,0,0,0,0,0,0,0
5941,163178,2022,Germany,Türkiye,0,0,0,0,18/06/2022,0,0,0,0,0,0,0,0,0,0,0,0,0,0,0,0,0,0,0,0
5942,163178,2022,Serbia,Türkiye,0,1,3,4,17/06/2022,0,0,1,1,0,0,1,1,2,5,4,11,0,0,0,0,0,1,0,1
5943,163178,2022,Brazil,Türkiye,0,0,0,0,16/06/2022,0,0,0,0,0,0,0,0,0,0,0,0,0,0,0,0,0,0,0,0
5944,163178,2022,Türkiye,Belgium,0,0,0,0,05/06/2022,0,0,0,0,0,0,0,0,0,0,0,0,0,0,0,0,0,0,0,0
5945,163178,2022,Bulgaria,Türkiye,0,0,0,0,04/06/2022,0,0,0,0,0,0,0,0,0,0,0,0,0,0,0,0,0,0,0,0
5946,163178,2022,Türkiye,China,0,0,0,0,03/06/2022,0,0,0,0,0,0,0,0,0,0,0,0,0,0,0,0,0,0,0,0
5947,163178,2022,Türkiye,Italy,0,0,0,0,31/05/2022,0,0,0,0,0,0,0,0,0,0,0,0,0,0,0,0,0,0,0,0
5948,158840,2022,Türkiye,Serbia,0,0,0,0,17/07/2022,0,0,10,10,0,0,0,0,0,0,0,0,5,0,4,9,6,4,0,10
5949,158840,2022,Türkiye,Italy,0,0,0,0,16/07/2022,0,0,9,9,0,0,0,0,0,0,0,0,3,2,1,6,11,1,1,13
5950,158840,2022,Türkiye,Thailand,0,0,0,0,14/07/2022,0,1,4,5,0,0,0,0,0,0,0,0,8,0,13,21,13,6,2,21
5951,158840,2022,Türkiye,USA,0,0,0,0,02/07/2022,0,0,3,3,0,0,0,0,0,0,0,0,0,0,0,0,0,0,0,0
5952,158840,2022,Türkiye,Japan,0,0,0,0,01/07/2022,0,0,7,7,0,0,0,0,0,0,0,0,24,1,8,33,7,2,0,9
5953,158840,2022,Türkiye,Netherlands,0,0,0,0,30/06/2022,0,0,4,4,0,0,0,0,0,0,0,0,6,0,2,8,8,1,0,9
5954,158840,2022,Canada,Türkiye,0,0,0,0,29/06/2022,0,0,2,2,0,0,0,0,0,0,0,0,8,0,6,14,6,1,0,7
5955,158840,2022,Türkiye,Korea,0,0,0,0,19/06/2022,0,0,0,0,0,0,0,0,0,0,0,0,0,0,0,0,0,0,0,0
5956,158840,2022,Germany,Türkiye,0,0,0,0,18/06/2022,0,0,4,4,0,0,0,0,0,0,0,0,5,2,6,13,10,2,2,14
5957,158840,2022,Serbia,Türkiye,0,0,1,1,17/06/2022,0,0,0,0,0,0,0,0,0,0,0,0,3,0,0,3,1,1,1,3
5958,158840,2022,Brazil,Türkiye,0,0,0,0,16/06/2022,0,0,0,0,0,0,0,0,0,0,0,0,0,0,0,0,0,0,0,0
5959,158840,2022,Türkiye,Belgium,0,0,0,0,05/06/2022,0,1,10,11,0,0,0,0,0,0,0,0,5,1,9,15,15,1,5,21
5960,158840,2022,Bulgaria,Türkiye,0,0,0,0,04/06/2022,0,0,0,0,0,0,0,0,0,0,0,0,0,0,0,0,0,0,0,0
5961,158840,2022,Türkiye,China,0,0,0,0,03/06/2022,2,0,10,12,0,0,0,0,0,0,0,0,8,0,3,11,14,6,2,22
5962,158840,2022,Türkiye,Italy,0,0,0,0,31/05/2022,0,0,6,6,0,0,0,0,0,0,0,0,3,0,7,10,7,2,2,11
5963,143590,2022,Türkiye,Serbia,0,0,6,6,17/07/2022,6,0,51,57,0,0,1,1,0,3,1,4,0,0,0,0,5,0,0,5
5964,143590,2022,Türkiye,Italy,0,1,9,10,16/07/2022,11,1,56,68,0,0,1,1,0,2,2,4,0,0,0,0,7,2,1,10
5965,143590,2022,Türkiye,Thailand,1,3,10,14,14/07/2022,31,1,67,99,3,0,0,3,2,6,3,11,0,0,0,0,6,1,4,11
5966,143590,2022,Türkiye,USA,0,2,20,22,02/07/2022,8,1,113,122,1,0,4,5,1,5,1,7,0,0,1,1,8,1,0,9
5967,143590,2022,Türkiye,Japan,0,2,19,21,01/07/2022,7,1,104,112,1,1,1,3,2,1,0,3,0,0,0,0,8,1,0,9
5968,143590,2022,Türkiye,Netherlands,1,0,12,13,30/06/2022,7,1,81,89,1,0,0,1,2,2,0,4,0,0,0,0,1,0,0,1
5969,143590,2022,Canada,Türkiye,0,0,9,9,29/06/2022,0,0,78,78,0,0,0,0,1,3,1,5,0,0,0,0,7,1,0,8
5970,143590,2022,Türkiye,Korea,2,0,9,11,19/06/2022,18,0,65,83,0,0,0,0,1,2,1,4,0,0,0,0,4,1,0,5
5971,143590,2022,Germany,Türkiye,1,2,22,25,18/06/2022,26,0,51,77,3,0,1,4,0,3,3,6,0,0,0,0,4,1,1,6
5972,143590,2022,Serbia,Türkiye,1,1,13,15,17/06/2022,14,3,120,137,1,0,0,1,2,1,6,9,0,0,1,1,7,1,2,10
5973,143590,2022,Brazil,Türkiye,0,1,11,12,16/06/2022,22,0,77,99,0,0,0,0,3,4,0,7,0,0,1,1,3,0,0,3
5974,143590,2022,Türkiye,Belgium,1,0,13,14,05/06/2022,36,0,61,97,0,1,3,4,5,4,4,13,0,0,0,0,8,2,3,13
5975,143590,2022,Bulgaria,Türkiye,0,0,10,10,04/06/2022,29,1,40,70,0,1,2,3,0,1,3,4,0,0,0,0,6,1,1,8
5976,143590,2022,Türkiye,China,0,1,7,8,03/06/2022,25,0,40,65,0,0,1,1,1,0,1,2,0,0,0,0,4,2,2,8
5977,143590,2022,Türkiye,Italy,0,2,6,8,31/05/2022,14,1,58,73,1,0,2,3,0,4,1,5,0,0,0,0,6,0,1,7
5978,152311,2022,Türkiye,Serbia,0,0,8,8,17/07/2022,0,0,0,0,5,6,6,17,0,0,2,2,2,0,21,23,9,3,0,12
5979,152311,2022,Türkiye,Italy,0,0,0,0,16/07/2022,0,0,0,0,0,0,0,0,0,0,0,0,0,0,0,0,0,0,0,0
5980,152311,2022,Türkiye,Thailand,0,1,1,2,14/07/2022,0,0,0,0,0,0,0,0,0,0,0,0,1,0,0,1,0,0,0,0
5981,152311,2022,Türkiye,USA,0,0,0,0,02/07/2022,0,0,0,0,0,0,0,0,0,0,0,0,0,0,0,0,0,0,0,0
5982,152311,2022,Türkiye,Japan,0,0,13,13,01/07/2022,0,1,0,1,3,4,2,9,2,1,2,5,6,0,10,16,6,0,0,6
5983,152311,2022,Türkiye,Netherlands,2,0,15,17,30/06/2022,0,0,2,2,4,2,7,13,1,4,2,7,4,0,8,12,7,0,0,7
5984,152311,2022,Canada,Türkiye,0,0,2,2,29/06/2022,0,0,0,0,3,0,7,10,0,2,1,3,4,0,3,7,0,0,0,0
5985,152311,2022,Türkiye,Korea,0,0,5,5,19/06/2022,0,0,0,0,1,1,4,6,1,1,0,2,5,1,5,11,3,1,0,4
5986,152311,2022,Germany,Türkiye,0,0,14,14,18/06/2022,0,0,0,0,5,3,4,12,1,2,0,3,4,3,12,19,6,0,0,6
5987,152311,2022,Serbia,Türkiye,0,0,4,4,17/06/2022,0,0,0,0,4,3,2,9,0,0,1,1,2,0,2,4,1,0,0,1
5988,152311,2022,Brazil,Türkiye,0,1,10,11,16/06/2022,0,0,0,0,9,6,8,23,1,1,1,3,7,3,13,23,5,1,0,6
5989,189139,2022,Türkiye,USA,0,0,0,0,02/07/2022,0,0,0,0,0,0,0,0,0,0,0,0,0,0,0,0,0,0,0,0
5990,189139,2022,Türkiye,Japan,0,0,0,0,01/07/2022,0,0,0,0,0,0,0,0,0,0,0,0,0,0,0,0,0,0,0,0
5991,189139,2022,Türkiye,Netherlands,0,0,0,0,30/06/2022,0,0,0,0,0,0,0,0,0,0,0,0,0,0,0,0,0,0,0,0
5992,189139,2022,Canada,Türkiye,0,0,0,0,29/06/2022,0,0,0,0,0,0,0,0,0,0,0,0,0,0,0,0,0,0,0,0
5993,189139,2022,Türkiye,Korea,0,0,0,0,19/06/2022,0,0,0,0,0,0,0,0,0,0,0,0,0,0,0,0,0,0,0,0
5994,189139,2022,Germany,Türkiye,0,0,0,0,18/06/2022,0,0,0,0,0,0,0,0,0,0,0,0,0,0,0,0,0,0,0,0
5995,189139,2022,Serbia,Türkiye,0,0,0,0,17/06/2022,0,0,0,0,0,0,0,0,0,0,0,0,0,0,0,0,0,0,0,0
5996,189139,2022,Brazil,Türkiye,0,0,0,0,16/06/2022,0,0,0,0,0,0,0,0,0,0,0,0,0,0,0,0,0,0,0,0
5997,189139,2022,Türkiye,Belgium,0,0,0,0,05/06/2022,0,0,0,0,0,0,0,0,0,0,0,0,0,0,0,0,0,0,0,0
5998,189139,2022,Bulgaria,Türkiye,0,0,0,0,04/06/2022,0,0,0,0,0,0,0,0,0,0,0,0,0,0,0,0,0,0,0,0
5999,189139,2022,Türkiye,China,0,0,0,0,03/06/2022,0,0,0,0,0,0,0,0,0,0,0,0,0,0,0,0,0,0,0,0
6000,189139,2022,Türkiye,Italy,0,0,0,0,31/05/2022,0,0,0,0,0,0,0,0,0,0,0,0,0,0,0,0,0,0,0,0
6001,152312,2022,Türkiye,Serbia,0,0,1,1,17/07/2022,0,0,0,0,0,1,1,2,0,0,0,0,0,0,5,5,3,0,0,3
6002,152312,2022,Türkiye,Italy,0,0,3,3,16/07/2022,0,0,2,2,4,1,5,10,1,2,1,4,2,0,6,8,2,0,0,2
6003,152312,2022,Türkiye,Thailand,1,2,12,15,14/07/2022,0,0,2,2,9,6,4,19,0,2,3,5,7,3,11,21,3,1,2,6
6004,152312,2022,Türkiye,USA,1,1,19,21,02/07/2022,0,0,2,2,15,1,10,26,1,1,2,4,12,0,3,15,4,1,0,5
6005,152312,2022,Türkiye,Japan,1,0,7,8,01/07/2022,0,1,0,1,1,0,7,8,2,2,0,4,5,1,3,9,11,0,0,11
6006,152312,2022,Türkiye,Netherlands,0,0,0,0,30/06/2022,0,0,0,0,0,0,0,0,0,0,0,0,0,0,0,0,0,0,0,0
6007,152312,2022,Canada,Türkiye,0,0,4,4,29/06/2022,0,0,0,0,2,1,0,3,0,0,0,0,2,0,1,3,1,0,0,1
6008,152312,2022,Türkiye,Belgium,0,0,0,0,05/06/2022,0,0,0,0,0,0,0,0,0,0,0,0,0,0,0,0,0,0,0,0
6009,152312,2022,Bulgaria,Türkiye,0,1,9,10,04/06/2022,0,0,1,1,6,6,10,22,2,2,1,5,10,0,11,21,2,2,1,5
6010,152312,2022,Türkiye,China,1,2,11,14,03/06/2022,0,0,0,0,4,4,13,21,1,2,0,3,8,2,17,27,1,1,1,3
6011,152312,2022,Türkiye,Italy,0,0,11,11,31/05/2022,0,1,0,1,8,3,5,16,0,1,1,2,7,1,16,24,4,0,0,4
6012,143585,2022,Türkiye,Serbia,1,1,6,8,17/07/2022,0,0,1,1,3,5,4,12,1,2,2,5,10,2,12,24,6,3,0,9
6013,143585,2022,Türkiye,Italy,0,2,7,9,16/07/2022,0,0,1,1,5,5,9,19,2,1,3,6,11,0,17,28,4,3,0,7
6014,143585,2022,Türkiye,Thailand,0,2,18,20,14/07/2022,0,0,6,6,8,1,5,14,2,3,1,6,9,0,12,21,5,6,5,16
6015,143585,2022,Türkiye,USA,0,0,0,0,02/07/2022,0,0,0,0,0,0,0,0,0,0,0,0,0,0,0,0,0,0,0,0
6016,143585,2022,Türkiye,Japan,0,2,8,10,01/07/2022,0,0,1,1,17,3,18,38,1,1,1,3,7,0,5,12,8,1,0,9
6017,143585,2022,Türkiye,Netherlands,0,2,5,7,30/06/2022,0,0,1,1,17,5,11,33,0,1,1,2,14,0,10,24,10,0,0,10
6018,143585,2022,Canada,Türkiye,1,1,10,12,29/06/2022,0,0,1,1,8,2,8,18,0,2,0,2,8,3,14,25,3,0,0,3
6019,143585,2022,Türkiye,Korea,0,0,10,10,19/06/2022,0,0,0,0,9,6,4,19,1,2,1,4,8,1,16,25,4,1,0,5
6020,143585,2022,Germany,Türkiye,1,0,10,11,18/06/2022,0,0,2,2,8,3,11,22,2,3,3,8,6,1,13,20,0,1,0,1
6021,143585,2022,Serbia,Türkiye,0,1,16,17,17/06/2022,0,0,2,2,17,7,13,37,1,1,3,5,16,2,22,40,6,2,0,8
6022,143585,2022,Brazil,Türkiye,0,1,3,4,16/06/2022,0,0,0,0,8,1,2,11,1,0,1,2,4,0,7,11,0,1,1,2
6023,143585,2022,Türkiye,Belgium,0,0,1,1,05/06/2022,0,0,0,0,0,1,3,4,0,0,0,0,1,0,4,5,0,0,0,0
6024,143585,2022,Bulgaria,Türkiye,0,0,14,14,04/06/2022,1,0,2,3,6,5,3,14,1,3,2,6,5,1,12,18,8,0,2,10
6025,143585,2022,Türkiye,China,0,2,9,11,03/06/2022,0,0,0,0,3,6,3,12,0,0,1,1,4,0,16,20,5,0,0,5
6026,143585,2022,Türkiye,Italy,3,2,10,15,31/05/2022,0,0,2,2,12,3,9,24,1,1,1,3,8,0,8,16,2,2,1,5
6027,153618,2022,,,-,-,-,-,-,-,-,-,-,-,-,-,-,-,-,-,-,-,-,-,-,-,-,-,-
6028,148070,2022,Türkiye,Serbia,0,0,0,0,17/07/2022,0,0,0,0,0,0,0,0,0,0,0,0,1,0,1,2,0,1,0,1
6029,148070,2022,Türkiye,Italy,0,0,0,0,16/07/2022,0,0,0,0,0,0,0,0,0,0,0,0,0,0,0,0,0,0,0,0
6030,148070,2022,Türkiye,Thailand,0,0,4,4,14/07/2022,0,0,0,0,0,0,0,0,0,0,0,0,2,0,4,6,1,0,0,1
6031,148070,2022,Türkiye,USA,0,2,18,20,02/07/2022,0,0,1,1,5,2,7,14,0,4,1,5,25,1,22,48,9,2,0,11
6032,148070,2022,Türkiye,Japan,0,0,0,0,01/07/2022,0,0,0,0,0,0,0,0,0,0,0,0,0,0,0,0,0,0,0,0
6033,148070,2022,Türkiye,Netherlands,0,0,0,0,30/06/2022,0,0,1,1,0,0,0,0,0,0,0,0,1,0,2,3,2,1,0,3
6034,148070,2022,Canada,Türkiye,1,0,11,12,29/06/2022,0,0,3,3,3,2,2,7,0,2,0,2,15,1,13,29,4,0,0,4
6035,148070,2022,Türkiye,Korea,0,0,0,0,19/06/2022,0,0,0,0,0,0,0,0,0,0,0,0,1,0,2,3,1,0,1,2
6036,148070,2022,Germany,Türkiye,0,0,0,0,18/06/2022,0,0,0,0,0,0,0,0,0,0,0,0,3,0,1,4,0,0,0,0
6037,148070,2022,Serbia,Türkiye,2,1,15,18,17/06/2022,0,0,0,0,10,7,10,27,1,0,3,4,11,2,24,37,7,2,3,12
6038,148070,2022,Brazil,Türkiye,1,0,25,26,16/06/2022,0,0,1,1,3,4,2,9,1,1,0,2,15,2,23,40,7,1,2,10
6039,148070,2022,Türkiye,Belgium,0,2,19,21,05/06/2022,1,0,3,4,3,1,11,15,0,3,2,5,4,3,16,23,10,1,0,11
6040,148070,2022,Bulgaria,Türkiye,0,0,0,0,04/06/2022,0,0,0,0,0,0,0,0,0,0,0,0,0,0,0,0,0,0,0,0
6041,148070,2022,Türkiye,China,0,0,6,6,03/06/2022,0,0,0,0,3,2,1,6,0,1,0,1,7,1,11,19,5,1,1,7
6042,148070,2022,Türkiye,Italy,0,0,0,0,31/05/2022,0,0,0,0,0,0,0,0,0,0,0,0,0,0,0,0,0,0,0,0
6043,143592,2022,Türkiye,Serbia,0,0,0,0,17/07/2022,0,0,0,0,0,0,0,0,0,0,0,0,0,0,0,0,0,1,0,1
6044,143592,2022,Türkiye,Italy,0,0,0,0,16/07/2022,0,0,0,0,0,0,0,0,0,0,0,0,0,0,0,0,0,0,0,0
6045,143592,2022,Türkiye,Thailand,0,0,0,0,14/07/2022,0,0,0,0,0,0,0,0,0,0,0,0,0,0,0,0,0,0,0,0
6046,143592,2022,Türkiye,USA,0,0,0,0,02/07/2022,0,1,7,8,0,0,0,0,0,0,0,0,10,3,10,23,13,1,0,14
6047,143592,2022,Türkiye,Japan,0,0,0,0,01/07/2022,0,0,0,0,0,0,0,0,0,0,0,0,0,0,0,0,0,0,0,0
6048,143592,2022,Türkiye,Netherlands,0,0,0,0,30/06/2022,0,0,0,0,0,0,0,0,0,0,0,0,0,0,0,0,0,0,0,0
6049,143592,2022,Canada,Türkiye,0,0,0,0,29/06/2022,0,0,0,0,0,0,0,0,0,0,0,0,0,0,0,0,0,0,0,0
6050,143592,2022,Türkiye,Korea,0,0,0,0,19/06/2022,0,0,6,6,0,0,0,0,0,0,0,0,10,1,5,16,9,2,2,13
6051,143592,2022,Germany,Türkiye,0,0,0,0,18/06/2022,0,0,0,0,0,0,0,0,0,0,0,0,0,0,0,0,0,0,0,0
6052,143592,2022,Serbia,Türkiye,0,0,0,0,17/06/2022,0,0,8,8,0,0,0,0,0,0,0,0,1,0,6,7,18,4,4,26
6053,143592,2022,Brazil,Türkiye,0,0,0,0,16/06/2022,0,1,12,13,0,0,0,0,0,0,0,0,3,1,4,8,9,4,3,16
6054,143592,2022,Türkiye,Belgium,0,0,0,0,05/06/2022,0,0,0,0,0,0,0,0,0,0,0,0,0,0,0,0,0,0,0,0
6055,143592,2022,Bulgaria,Türkiye,0,0,0,0,04/06/2022,0,0,3,3,0,0,0,0,0,0,0,0,2,0,8,10,12,2,2,16
6056,143592,2022,Türkiye,China,0,0,0,0,03/06/2022,0,0,0,0,0,0,0,0,0,0,0,0,0,0,0,0,0,0,0,0
6057,143592,2022,Türkiye,Italy,0,0,0,0,31/05/2022,0,0,0,0,0,0,1,1,0,0,0,0,0,0,0,0,0,0,0,0
6058,163094,2022,Türkiye,Korea,0,0,16,16,19/06/2022,0,0,0,0,11,4,8,23,1,7,2,10,10,0,2,12,7,0,2,9
6059,163094,2022,Germany,Türkiye,0,0,0,0,18/06/2022,0,0,0,0,0,0,0,0,0,0,0,0,0,0,0,0,0,0,0,0
6060,163094,2022,Serbia,Türkiye,0,0,0,0,17/06/2022,0,0,0,0,0,0,0,0,0,0,0,0,0,0,0,0,0,0,0,0
6061,163094,2022,Brazil,Türkiye,0,0,0,0,16/06/2022,0,0,0,0,1,1,1,3,1,0,0,1,1,0,1,2,0,0,1,1
6062,163975,2022,Türkiye,Serbia,0,0,3,3,17/07/2022,1,0,17,18,0,0,1,1,0,2,0,2,0,0,0,0,0,1,0,1
6063,163975,2022,Türkiye,Italy,0,0,2,2,16/07/2022,3,0,9,12,1,0,1,2,0,0,0,0,0,0,0,0,0,0,0,0
6064,163975,2022,Türkiye,Thailand,0,0,0,0,14/07/2022,0,0,0,0,0,0,0,0,0,0,0,0,0,0,0,0,0,1,0,1
6065,163975,2022,Türkiye,Korea,1,0,5,6,19/06/2022,4,0,15,19,0,0,0,0,1,0,1,2,0,0,0,0,0,0,0,0
6066,163975,2022,Germany,Türkiye,0,0,0,0,18/06/2022,0,0,0,0,0,0,0,0,0,0,0,0,0,0,0,0,0,0,0,0
6067,163975,2022,Serbia,Türkiye,0,0,3,3,17/06/2022,2,0,14,16,0,0,0,0,0,0,0,0,0,0,0,0,0,0,0,0
6068,163975,2022,Brazil,Türkiye,0,0,2,2,16/06/2022,0,0,5,5,0,0,0,0,0,0,0,0,0,0,0,0,0,0,1,1
6069,151195,2022,Türkiye,Serbia,0,0,1,1,17/07/2022,0,0,0,0,1,0,3,4,0,0,1,1,0,0,0,0,0,0,0,0
6070,151195,2022,Türkiye,Italy,0,0,2,2,16/07/2022,0,0,0,0,1,0,2,3,0,0,0,0,0,0,0,0,0,0,0,0
6071,151195,2022,Türkiye,Thailand,0,0,2,2,14/07/2022,0,0,0,0,0,0,0,0,0,0,0,0,0,0,0,0,0,0,0,0
6072,151195,2022,Türkiye,USA,0,0,0,0,02/07/2022,0,0,1,1,2,0,1,3,0,0,1,1,0,0,0,0,0,0,0,0
6073,151195,2022,Türkiye,Japan,0,1,6,7,01/07/2022,0,0,1,1,8,5,15,28,1,2,5,8,0,0,0,0,5,0,0,5
6074,151195,2022,Türkiye,Netherlands,1,0,14,15,30/06/2022,0,0,0,0,11,4,7,22,0,4,2,6,0,0,0,0,5,0,0,5
6075,151195,2022,Canada,Türkiye,0,0,3,3,29/06/2022,0,0,1,1,0,0,0,0,0,0,0,0,0,0,0,0,0,0,0,0
6076,151195,2022,Türkiye,Korea,1,0,3,4,19/06/2022,0,0,0,0,1,0,2,3,2,1,4,7,0,0,0,0,0,0,0,0
6077,151195,2022,Germany,Türkiye,0,0,0,0,18/06/2022,0,0,0,0,0,2,0,2,0,0,0,0,0,0,0,0,0,0,0,0
6078,151195,2022,Serbia,Türkiye,0,2,4,6,17/06/2022,0,0,0,0,6,3,9,18,0,0,0,0,0,0,0,0,3,0,0,3
6079,151195,2022,Brazil,Türkiye,0,0,0,0,16/06/2022,0,0,1,1,0,0,0,0,0,0,0,0,0,0,0,0,0,0,0,0
6080,138782,2022,Türkiye,Serbia,2,0,13,15,17/07/2022,0,0,3,3,5,2,1,8,3,7,4,14,0,0,1,1,3,1,1,5
6081,138782,2022,Türkiye,Italy,0,2,6,8,16/07/2022,0,1,2,3,10,2,3,15,1,6,9,16,0,0,0,0,3,2,0,5
6082,138782,2022,Türkiye,Thailand,3,1,9,13,14/07/2022,0,0,1,1,12,0,6,18,2,7,15,24,0,0,1,1,2,1,2,5
6083,138782,2022,Türkiye,USA,1,1,15,17,02/07/2022,0,0,0,0,11,2,5,18,2,5,4,11,0,0,0,0,0,1,0,1
6084,138782,2022,Türkiye,Japan,0,2,11,13,01/07/2022,0,0,2,2,10,3,7,20,5,5,4,14,0,0,0,0,4,1,0,5
6085,138782,2022,Türkiye,Netherlands,1,1,9,11,30/06/2022,0,0,2,2,6,1,6,13,2,2,6,10,0,0,0,0,2,0,0,2
6086,138782,2022,Canada,Türkiye,0,0,12,12,29/06/2022,0,1,0,1,1,4,6,11,1,3,2,6,0,0,0,0,0,0,0,0
6087,138782,2022,Türkiye,Korea,2,1,11,14,19/06/2022,0,0,0,0,7,1,4,12,1,4,1,6,0,0,0,0,0,0,0,0
6088,138782,2022,Germany,Türkiye,0,2,8,10,18/06/2022,0,0,0,0,7,2,5,14,0,3,8,11,0,0,0,0,2,1,0,3
6089,138782,2022,Serbia,Türkiye,0,0,13,13,17/06/2022,0,0,0,0,3,2,10,15,5,4,5,14,0,0,0,0,1,0,0,1
6090,138782,2022,Brazil,Türkiye,1,3,9,13,16/06/2022,0,0,3,3,8,1,4,13,1,4,5,10,0,0,0,0,0,1,1,2
6091,138782,2022,Türkiye,Belgium,1,0,15,16,05/06/2022,0,0,1,1,7,0,4,11,3,10,9,22,0,0,0,0,2,0,2,4
6092,138782,2022,Bulgaria,Türkiye,2,1,7,10,04/06/2022,0,0,1,1,8,1,4,13,3,2,8,13,1,0,0,1,2,0,0,2
6093,138782,2022,Türkiye,China,0,2,9,11,03/06/2022,0,0,3,3,7,1,7,15,1,6,7,14,0,0,0,0,2,1,0,3
6094,138782,2022,Türkiye,Italy,1,1,13,15,31/05/2022,0,0,1,1,6,3,4,13,3,4,5,12,0,0,0,0,3,0,1,4
6095,143580,2022,Türkiye,USA,0,0,0,0,02/07/2022,1,0,4,5,0,0,0,0,0,0,0,0,0,0,0,0,1,0,0,1
6096,143580,2022,Türkiye,Japan,0,0,1,1,01/07/2022,0,0,3,3,0,0,0,0,0,0,0,0,0,0,0,0,1,0,0,1
6097,143580,2022,Türkiye,Netherlands,0,0,0,0,30/06/2022,0,0,0,0,0,0,0,0,0,0,0,0,0,0,0,0,0,0,0,0
6098,143580,2022,Canada,Türkiye,0,1,4,5,29/06/2022,0,0,12,12,0,0,0,0,0,0,0,0,0,0,0,0,0,0,0,0
6099,143580,2022,Türkiye,Belgium,0,0,0,0,05/06/2022,3,0,1,4,0,0,0,0,0,0,0,0,0,0,0,0,0,0,0,0
6100,143580,2022,Bulgaria,Türkiye,0,0,0,0,04/06/2022,1,0,1,2,0,0,0,0,0,0,0,0,0,0,0,0,0,0,0,0
6101,143580,2022,Türkiye,China,0,0,5,5,03/06/2022,18,1,16,35,1,0,0,1,0,2,1,3,0,0,0,0,3,0,0,3
6102,143580,2022,Türkiye,Italy,0,0,1,1,31/05/2022,1,0,2,3,0,0,0,0,0,0,0,0,0,0,2,2,0,0,0,0
6103,152263,2022,Türkiye,Serbia,0,0,11,11,17/07/2022,0,0,3,3,8,0,6,14,5,5,14,24,0,0,0,0,3,2,0,5
6104,152263,2022,Türkiye,Italy,0,1,11,12,16/07/2022,0,0,1,1,7,1,5,13,1,2,7,10,0,0,0,0,3,2,1,6
6105,152263,2022,Türkiye,Thailand,1,1,14,16,14/07/2022,0,0,2,2,11,1,8,20,2,4,8,14,0,0,0,0,4,2,2,8
6106,152263,2022,Türkiye,USA,0,3,13,16,02/07/2022,0,1,1,2,14,1,8,23,5,7,4,16,0,0,0,0,0,1,0,1
6107,152263,2022,Türkiye,Japan,1,0,16,17,01/07/2022,0,0,3,3,9,1,3,13,6,4,5,15,0,0,0,0,2,0,0,2
6108,152263,2022,Türkiye,Netherlands,0,2,9,11,30/06/2022,0,0,1,1,8,5,4,17,3,3,3,9,0,0,0,0,1,0,0,1
6109,152263,2022,Canada,Türkiye,1,1,13,15,29/06/2022,0,0,2,2,14,1,8,23,2,7,1,10,0,0,0,0,1,0,0,1
6110,152263,2022,Türkiye,Korea,0,3,9,12,19/06/2022,0,0,0,0,11,2,4,17,4,3,8,15,1,0,0,1,0,0,1,1
6111,152263,2022,Germany,Türkiye,0,3,4,7,18/06/2022,0,1,3,4,12,1,3,16,9,3,3,15,0,0,1,1,1,0,0,1
6112,152263,2022,Serbia,Türkiye,0,1,12,13,17/06/2022,0,0,1,1,8,2,2,12,2,9,6,17,0,0,0,0,1,2,0,3
6113,152263,2022,Brazil,Türkiye,0,0,13,13,16/06/2022,0,0,2,2,7,1,3,11,3,4,7,14,0,0,0,0,1,3,0,4
6114,152263,2022,Türkiye,Belgium,0,2,10,12,05/06/2022,1,0,1,2,7,3,5,15,5,10,12,27,0,0,0,0,5,1,4,10
6115,152263,2022,Bulgaria,Türkiye,1,3,10,14,04/06/2022,0,0,2,2,7,0,3,10,1,2,7,10,0,0,1,1,2,0,1,3
6116,152263,2022,Türkiye,China,0,3,7,10,03/06/2022,0,0,2,2,9,2,5,16,1,6,7,14,0,0,0,0,1,0,0,1
6117,152263,2022,Türkiye,Italy,0,0,13,13,31/05/2022,0,0,4,4,6,0,4,10,2,5,2,9,0,0,0,0,2,2,2,6
6118,123798,2022,Türkiye,Belgium,0,0,0,0,05/06/2022,1,0,0,1,2,0,1,3,0,1,0,1,0,0,0,0,0,0,0,0
6119,123798,2022,Bulgaria,Türkiye,0,0,0,0,04/06/2022,0,0,0,0,0,0,0,0,0,0,0,0,0,0,0,0,0,0,0,0
6120,123798,2022,Türkiye,China,0,0,0,0,03/06/2022,0,0,0,0,0,0,0,0,0,0,0,0,0,0,0,0,0,0,0,0
6121,123798,2022,Türkiye,Italy,0,0,0,0,31/05/2022,0,0,0,0,0,0,0,0,0,0,0,0,0,0,0,0,0,0,0,0
6122,168151,2022,Türkiye,USA,0,0,0,0,02/07/2022,0,0,0,0,0,0,0,0,0,0,0,0,4,1,1,6,3,0,0,3
6123,168151,2022,Türkiye,Japan,0,0,0,0,01/07/2022,0,0,0,0,0,0,0,0,0,0,0,0,1,0,3,4,1,0,0,1
6124,168151,2022,Türkiye,Netherlands,0,0,0,0,30/06/2022,0,0,1,1,0,0,0,0,0,0,0,0,0,0,2,2,3,0,0,3
6125,168151,2022,Canada,Türkiye,0,0,0,0,29/06/2022,0,0,0,0,0,0,0,0,0,0,0,0,1,0,0,1,1,0,0,1
6126,123803,2022,,,-,-,-,-,-,-,-,-,-,-,-,-,-,-,-,-,-,-,-,-,-,-,-,-,-
6127,163089,2022,Türkiye,Serbia,0,0,5,5,17/07/2022,0,0,4,4,1,0,2,3,0,1,0,1,2,0,4,6,2,0,0,2
6128,163089,2022,Türkiye,Italy,0,1,9,10,16/07/2022,0,0,2,2,1,2,2,5,0,1,1,2,16,0,10,26,9,2,0,11
6129,163089,2022,Türkiye,Thailand,0,0,0,0,14/07/2022,0,0,0,0,0,0,0,0,0,0,0,0,0,0,0,0,0,0,0,0
6130,163089,2022,Türkiye,Belgium,1,1,10,12,05/06/2022,1,0,1,2,11,2,12,25,1,2,3,6,9,0,22,31,11,0,3,14
6131,163089,2022,Bulgaria,Türkiye,0,0,0,0,04/06/2022,0,0,0,0,0,0,0,0,0,0,0,0,0,0,0,0,0,0,0,0
6132,163089,2022,Türkiye,China,0,0,2,2,03/06/2022,0,0,2,2,1,3,1,5,1,0,0,1,4,0,4,8,0,1,1,2
6133,163089,2022,Türkiye,Italy,0,0,0,0,31/05/2022,0,0,0,0,0,0,0,0,0,0,0,0,0,0,0,0,0,0,0,0
6134,163091,2022,,,-,-,-,-,-,-,-,-,-,-,-,-,-,-,-,-,-,-,-,-,-,-,-,-,-
6135,173334,2022,,,-,-,-,-,-,-,-,-,-,-,-,-,-,-,-,-,-,-,-,-,-,-,-,-,-
6136,163093,2022,,,-,-,-,-,-,-,-,-,-,-,-,-,-,-,-,-,-,-,-,-,-,-,-,-,-
6137,152254,2022,,,-,-,-,-,-,-,-,-,-,-,-,-,-,-,-,-,-,-,-,-,-,-,-,-,-
6138,163982,2022,Türkiye,Serbia,0,0,10,10,17/07/2022,0,1,4,5,14,5,14,33,0,3,1,4,0,0,1,1,6,1,0,7
6139,163982,2022,Türkiye,Italy,2,1,8,11,16/07/2022,0,0,1,1,12,5,12,29,0,2,5,7,0,0,0,0,2,4,0,6
6140,163982,2022,Türkiye,Thailand,0,0,10,10,14/07/2022,0,0,1,1,15,4,15,34,2,2,4,8,0,0,0,0,7,3,1,11
6141,163982,2022,Türkiye,USA,0,3,16,19,02/07/2022,0,0,2,2,24,7,17,48,3,3,4,10,0,0,0,0,11,3,0,14
6142,163982,2022,Türkiye,Japan,0,1,1,2,01/07/2022,0,0,0,0,6,0,2,8,0,0,1,1,0,0,0,0,0,0,0,0
6143,163982,2022,Türkiye,Netherlands,0,0,0,0,30/06/2022,0,0,0,0,0,0,0,0,0,0,0,0,0,0,0,0,0,0,0,0
6144,163982,2022,Canada,Türkiye,2,4,13,19,29/06/2022,0,0,0,0,20,8,11,39,1,4,2,7,0,0,0,0,8,0,0,8
6145,163982,2022,Türkiye,Korea,0,3,9,12,19/06/2022,0,0,2,2,14,3,8,25,3,4,2,9,0,0,0,0,4,0,0,4
6146,163982,2022,Germany,Türkiye,0,1,6,7,18/06/2022,0,0,0,0,9,4,6,19,0,0,1,1,0,0,0,0,7,0,0,7
6147,163982,2022,Serbia,Türkiye,0,3,7,10,17/06/2022,0,0,0,0,14,6,15,35,1,3,5,9,0,0,0,0,2,0,0,2
6148,163982,2022,Brazil,Türkiye,1,1,12,14,16/06/2022,0,0,2,2,19,8,24,51,1,6,1,8,0,0,0,0,3,1,4,8
6149,163982,2022,Türkiye,Belgium,0,3,10,13,05/06/2022,0,0,0,0,20,10,18,48,0,6,2,8,0,0,0,0,9,1,2,12
6150,163982,2022,Bulgaria,Türkiye,0,2,14,16,04/06/2022,1,0,1,2,15,2,8,25,5,4,5,14,0,0,0,0,5,1,4,10
6151,163982,2022,Türkiye,China,1,0,12,13,03/06/2022,0,0,1,1,21,8,17,46,0,1,1,2,0,0,0,0,9,1,1,11
6152,163982,2022,Türkiye,Italy,0,2,8,10,31/05/2022,0,0,0,0,13,2,12,27,1,2,3,6,0,0,0,0,5,1,1,7
6153,132835,2022,USA,Germany,1,3,12,16,03/07/2022,4,0,99,103,1,1,1,3,0,5,2,7,0,0,1,1,8,0,0,8
6154,132835,2022,Türkiye,USA,0,0,0,0,02/07/2022,0,0,0,0,0,0,0,0,0,0,0,0,0,0,0,0,0,0,0,0
6155,132835,2022,USA,Serbia,0,0,0,0,01/07/2022,0,0,0,0,0,0,0,0,0,0,0,0,0,0,0,0,0,0,0,0
6156,132835,2022,Belgium,USA,0,0,0,0,30/06/2022,0,0,0,0,0,0,0,0,0,0,0,0,0,0,0,0,0,0,0,0
6157,132835,2022,Thailand,USA,0,0,2,2,19/06/2022,6,0,20,26,0,1,1,2,0,0,2,2,0,0,0,0,2,0,0,2
6158,132835,2022,USA,China,3,6,3,12,18/06/2022,17,0,68,85,2,0,0,2,0,2,3,5,0,0,0,0,2,1,2,5
6159,132835,2022,Poland,USA,0,0,0,0,17/06/2022,0,0,0,0,0,0,0,0,0,0,0,0,0,0,0,0,0,0,0,0
6160,132835,2022,Bulgaria,USA,1,1,11,13,15/06/2022,12,0,61,73,1,0,0,1,1,3,5,9,0,0,1,1,6,1,1,8
6161,143517,2022,USA,Serbia,2,1,19,22,13/07/2022,18,0,82,100,1,0,0,1,2,3,0,5,0,0,0,0,8,4,0,12
6162,143517,2022,USA,Germany,0,0,0,0,03/07/2022,0,0,0,0,0,0,0,0,0,0,0,0,0,0,0,0,0,0,0,0
6163,143517,2022,Türkiye,USA,1,1,14,16,02/07/2022,8,0,136,144,0,0,1,1,0,3,0,3,0,0,0,0,3,2,0,5
6164,143517,2022,USA,Serbia,0,0,8,8,01/07/2022,14,0,66,80,0,0,0,0,2,4,1,7,0,0,0,0,6,3,1,10
6165,143517,2022,Belgium,USA,0,0,7,7,30/06/2022,11,0,77,88,0,0,1,1,3,0,3,6,0,0,0,0,3,2,0,5
6166,146722,2022,USA,Serbia,0,2,4,6,13/07/2022,0,0,0,0,5,4,4,13,1,3,1,5,11,2,21,34,6,2,1,9
6167,146722,2022,USA,Germany,1,2,8,11,03/07/2022,0,0,2,2,7,2,6,15,2,1,2,5,8,2,20,30,7,3,0,10
6168,146722,2022,Türkiye,USA,0,0,0,0,02/07/2022,0,0,0,0,0,0,0,0,0,0,0,0,0,0,0,0,0,0,0,0
6169,146722,2022,USA,Serbia,0,2,8,10,01/07/2022,0,0,4,4,16,1,13,30,2,0,0,2,13,2,11,26,4,0,0,4
6170,146722,2022,Belgium,USA,0,0,0,0,30/06/2022,0,0,0,0,0,0,0,0,0,0,0,0,0,0,0,0,0,0,0,0
6171,146722,2022,Thailand,USA,0,0,0,0,19/06/2022,0,0,0,0,0,0,0,0,0,0,0,0,0,0,0,0,0,0,0,0
6172,146722,2022,USA,China,2,0,10,12,18/06/2022,1,0,3,4,18,5,6,29,0,2,1,3,5,0,24,29,6,1,0,7
6173,146722,2022,Poland,USA,0,0,0,0,17/06/2022,0,0,0,0,0,0,0,0,0,0,0,0,0,0,0,0,0,0,0,0
6174,146722,2022,Bulgaria,USA,0,1,8,9,15/06/2022,0,0,1,1,7,4,9,20,1,3,2,6,7,4,15,26,9,3,0,12
6175,135564,2022,USA,Serbia,0,0,0,0,13/07/2022,0,1,6,7,0,0,0,0,0,0,0,0,6,1,5,12,10,1,0,11
6176,135564,2022,USA,Germany,0,0,0,0,03/07/2022,0,0,0,0,0,0,0,0,0,0,0,0,0,0,0,0,0,0,0,0
6177,135564,2022,Türkiye,USA,0,0,0,0,02/07/2022,0,0,9,9,0,0,0,0,0,0,0,0,15,0,6,21,17,2,0,19
6178,135564,2022,USA,Serbia,0,0,0,0,01/07/2022,0,1,3,4,0,0,0,0,0,0,0,0,4,2,1,7,7,2,1,10
6179,135564,2022,Belgium,USA,0,0,0,0,30/06/2022,0,0,2,2,0,0,0,0,0,0,0,0,3,1,4,8,5,3,0,8
6180,135564,2022,Thailand,USA,0,0,0,0,19/06/2022,0,0,17,17,0,0,0,0,0,0,0,0,2,1,16,19,16,3,2,21
6181,135564,2022,USA,China,0,0,0,0,18/06/2022,0,0,3,3,0,0,0,0,0,0,0,0,4,2,12,18,11,0,0,11
6182,135564,2022,Poland,USA,0,0,0,0,17/06/2022,0,0,0,0,0,0,0,0,0,0,0,0,0,0,0,0,0,0,0,0
6183,135564,2022,Bulgaria,USA,0,0,0,0,15/06/2022,0,0,5,5,0,0,0,0,0,0,0,0,3,1,8,12,8,1,0,9
6184,152187,2022,USA,Serbia,0,0,0,0,13/07/2022,0,0,0,0,0,0,0,0,0,0,0,0,0,0,0,0,0,0,0,0
6185,152187,2022,USA,Germany,0,0,0,0,03/07/2022,0,0,9,9,0,0,0,0,0,0,0,0,4,0,11,15,15,3,2,20
6186,152187,2022,Türkiye,USA,0,0,0,0,02/07/2022,0,0,0,0,0,0,0,0,0,0,0,0,0,0,0,0,0,0,0,0
6187,152187,2022,USA,Serbia,0,0,0,0,01/07/2022,0,0,0,0,0,0,0,0,0,0,0,0,0,0,0,0,0,0,0,0
6188,152187,2022,Belgium,USA,0,0,0,0,30/06/2022,0,0,0,0,0,0,0,0,0,0,0,0,0,0,0,0,0,0,0,0
6189,152187,2022,Thailand,USA,0,0,0,0,19/06/2022,0,0,0,0,0,0,0,0,0,0,0,0,0,0,0,0,0,0,0,0
6190,152187,2022,USA,China,0,0,0,0,18/06/2022,0,0,0,0,0,0,0,0,0,0,0,0,0,0,0,0,0,0,0,0
6191,152187,2022,Poland,USA,0,0,0,0,17/06/2022,0,0,5,5,0,0,0,0,0,0,0,0,3,0,1,4,12,4,0,16
6192,152187,2022,Bulgaria,USA,0,0,0,0,15/06/2022,0,0,0,0,0,0,0,0,0,0,0,0,0,0,0,0,0,0,0,0
6193,152187,2022,Japan,USA,0,0,0,0,05/06/2022,0,1,15,16,0,0,0,0,0,0,0,0,4,2,3,9,15,5,2,22
6194,152187,2022,USA,Brazil,0,0,0,0,05/06/2022,0,0,13,13,0,0,0,0,0,0,0,0,8,0,2,10,17,3,0,20
6195,152187,2022,USA,Canada,0,0,0,0,04/06/2022,0,0,0,0,0,0,0,0,0,0,0,0,0,0,0,0,0,0,0,0
6196,152187,2022,USA,Dominican Republic,0,0,0,0,01/06/2022,0,0,13,13,0,0,0,0,0,0,0,0,10,0,3,13,15,0,1,16
6197,145702,2022,USA,Germany,1,1,13,15,03/07/2022,0,0,1,1,2,0,5,7,2,4,5,11,0,0,0,0,3,1,0,4
6198,145702,2022,Türkiye,USA,0,0,0,0,02/07/2022,0,0,0,0,0,0,0,0,0,0,0,0,0,0,0,0,0,0,0,0
6199,145702,2022,USA,Serbia,0,0,0,0,01/07/2022,0,0,0,0,0,0,0,0,0,0,0,0,0,0,0,0,0,0,0,0
6200,145702,2022,Belgium,USA,0,0,16,16,30/06/2022,0,0,3,3,4,1,2,7,1,2,0,3,0,0,0,0,5,0,0,5
6201,145702,2022,Japan,USA,0,0,7,7,05/06/2022,0,0,0,0,2,1,3,6,0,3,1,4,2,0,0,2,1,1,0,2
6202,145702,2022,USA,Brazil,0,0,0,0,05/06/2022,0,0,0,0,0,0,0,0,0,0,0,0,0,0,0,0,0,0,0,0
6203,145702,2022,USA,Canada,0,0,12,12,04/06/2022,0,0,1,1,3,0,4,7,0,2,5,7,0,0,0,0,1,0,0,1
6204,145702,2022,USA,Dominican Republic,1,0,10,11,01/06/2022,0,0,2,2,5,1,5,11,0,4,6,10,0,0,1,1,0,0,0,0
6205,132500,2022,USA,Serbia,0,0,1,1,13/07/2022,2,0,0,2,0,0,0,0,0,0,0,0,0,0,0,0,0,0,0,0
6206,132500,2022,Thailand,USA,1,1,12,14,19/06/2022,26,1,56,83,1,0,0,1,1,1,4,6,0,0,0,0,8,1,0,9
6207,132500,2022,USA,China,0,0,0,0,18/06/2022,0,0,0,0,0,0,0,0,0,0,0,0,0,0,0,0,0,0,0,0
6208,132500,2022,Poland,USA,1,0,10,11,17/06/2022,14,0,60,74,2,0,1,3,1,1,4,6,0,0,0,0,8,1,0,9
6209,132500,2022,Bulgaria,USA,0,0,0,0,15/06/2022,0,0,0,0,0,0,0,0,0,0,0,0,0,0,0,0,0,0,0,0
6210,132500,2022,Japan,USA,0,0,14,14,05/06/2022,24,1,70,95,1,0,4,5,0,3,2,5,0,0,1,1,16,0,0,16
6211,132500,2022,USA,Brazil,2,2,12,16,05/06/2022,13,0,60,73,1,0,0,1,0,4,5,9,0,0,0,0,12,2,1,15
6212,132500,2022,USA,Canada,1,2,7,10,04/06/2022,9,0,55,64,2,0,1,3,0,3,1,4,0,0,0,0,14,3,1,18
6213,132500,2022,USA,Dominican Republic,0,1,13,14,01/06/2022,23,0,46,69,3,1,3,7,0,2,0,2,0,0,1,1,12,2,0,14
6214,160909,2022,USA,Serbia,0,0,0,0,13/07/2022,0,0,0,0,0,0,0,0,0,0,0,0,0,0,0,0,0,0,0,0
6215,160909,2022,USA,Germany,0,0,0,0,03/07/2022,0,0,0,0,0,0,0,0,0,0,0,0,0,0,0,0,0,0,0,0
6216,160909,2022,Türkiye,USA,0,3,14,17,02/07/2022,0,0,1,1,2,3,2,7,4,9,3,16,0,1,0,1,5,1,0,6
6217,160909,2022,USA,Serbia,1,0,23,24,01/07/2022,0,0,1,1,4,1,0,5,2,3,0,5,0,0,0,0,2,1,0,3
6218,160909,2022,Belgium,USA,0,0,0,0,30/06/2022,0,0,0,0,0,0,0,0,0,0,0,0,0,0,0,0,0,0,0,0
6219,160909,2022,Thailand,USA,0,0,0,0,19/06/2022,0,0,0,0,0,0,0,0,0,0,0,0,0,0,0,0,0,0,0,0
6220,160909,2022,USA,China,0,1,7,8,18/06/2022,0,0,0,0,4,3,1,8,2,2,4,8,1,0,0,1,3,0,0,3
6221,160909,2022,Poland,USA,0,0,0,0,17/06/2022,0,0,0,0,0,0,0,0,0,0,0,0,0,0,0,0,0,0,0,0
6222,160909,2022,Bulgaria,USA,1,2,7,10,15/06/2022,0,0,2,2,9,1,0,10,1,4,5,10,1,0,0,1,2,1,0,3
6223,135983,2022,Thailand,USA,1,1,3,5,19/06/2022,0,0,0,0,3,1,6,10,1,0,0,1,2,1,11,14,3,0,0,3
6224,135983,2022,USA,China,0,0,0,0,18/06/2022,0,0,0,0,0,0,0,0,0,0,0,0,0,0,0,0,0,0,0,0
6225,135983,2022,Poland,USA,0,1,10,11,17/06/2022,0,0,2,2,11,3,11,25,1,0,2,3,3,1,17,21,5,1,0,6
6226,135983,2022,Bulgaria,USA,0,0,0,0,15/06/2022,0,0,0,0,0,0,0,0,0,0,0,0,0,0,0,0,0,0,0,0
6227,135983,2022,Japan,USA,0,0,7,7,05/06/2022,0,0,2,2,7,2,14,23,0,2,1,3,6,0,7,13,7,2,0,9
6228,135983,2022,USA,Brazil,0,0,0,0,05/06/2022,0,0,0,0,0,0,0,0,0,0,0,0,0,0,0,0,0,0,0,0
6229,135983,2022,USA,Canada,0,1,9,10,04/06/2022,0,0,2,2,11,2,11,24,1,0,1,2,4,0,5,9,8,3,0,11
6230,135983,2022,USA,Dominican Republic,0,0,0,0,01/06/2022,0,0,0,0,0,0,0,0,0,0,0,0,0,0,0,0,0,0,0,0
6231,152194,2022,Japan,USA,0,0,0,0,05/06/2022,0,0,0,0,0,0,0,0,0,0,0,0,0,0,0,0,0,0,0,0
6232,152194,2022,USA,Brazil,0,0,0,0,05/06/2022,0,0,0,0,0,0,0,0,0,0,0,0,0,0,0,0,0,0,0,0
6233,152194,2022,USA,Canada,0,1,11,12,04/06/2022,0,0,0,0,6,0,2,8,3,3,2,8,0,0,0,0,2,0,0,2
6234,152194,2022,USA,Dominican Republic,0,0,0,0,01/06/2022,0,0,0,0,0,0,0,0,0,0,0,0,0,0,0,0,0,0,0,0
6235,155307,2022,USA,Serbia,0,1,7,8,13/07/2022,0,0,0,0,10,4,5,19,1,6,1,8,0,0,0,0,8,1,1,10
6236,155307,2022,USA,Germany,0,0,0,0,03/07/2022,0,0,0,0,0,0,0,0,0,0,0,0,0,0,0,0,0,0,0,0
6237,155307,2022,Türkiye,USA,3,3,12,18,02/07/2022,0,0,0,0,20,5,20,45,1,0,3,4,0,0,0,0,7,2,0,9
6238,155307,2022,USA,Serbia,0,0,0,0,01/07/2022,0,0,0,0,0,0,0,0,0,0,0,0,0,0,0,0,0,0,0,0
6239,155307,2022,Belgium,USA,1,4,8,13,30/06/2022,0,0,0,0,12,4,11,27,2,3,0,5,0,0,0,0,5,3,0,8
6240,155307,2022,Japan,USA,0,2,5,7,05/06/2022,0,0,0,0,11,4,18,33,0,4,1,5,0,0,0,0,11,3,1,15
6241,155307,2022,USA,Brazil,0,0,0,0,05/06/2022,0,0,0,0,0,0,0,0,0,0,0,0,0,0,0,0,0,0,0,0
6242,155307,2022,USA,Canada,0,3,9,12,04/06/2022,0,0,1,1,13,4,10,27,2,2,1,5,0,0,0,0,5,0,1,6
6243,155307,2022,USA,Dominican Republic,0,0,0,0,01/06/2022,0,0,0,0,0,0,0,0,0,0,0,0,0,0,0,0,0,0,0,0
6244,172978,2022,USA,Serbia,0,1,6,7,13/07/2022,0,0,0,0,9,3,5,17,2,2,1,5,0,0,0,0,1,1,0,2
6245,172978,2022,USA,Germany,1,1,11,13,03/07/2022,0,0,4,4,12,6,13,31,1,3,1,5,0,0,0,0,8,1,0,9
6246,172978,2022,Türkiye,USA,0,0,0,0,02/07/2022,0,0,0,0,0,0,0,0,0,0,0,0,0,0,0,0,0,0,0,0
6247,172978,2022,USA,Serbia,1,1,9,11,01/07/2022,0,0,1,1,14,3,13,30,0,1,1,2,0,0,0,0,10,3,0,13
6248,172978,2022,Belgium,USA,0,0,0,0,30/06/2022,0,0,0,0,0,0,0,0,0,0,0,0,0,0,0,0,0,0,0,0
6249,172978,2022,Japan,USA,0,0,0,0,05/06/2022,0,0,0,0,0,0,0,0,0,0,0,0,0,0,0,0,0,0,0,0
6250,172978,2022,USA,Brazil,3,1,10,14,05/06/2022,0,0,3,3,15,9,10,34,1,1,0,2,0,0,0,0,4,1,0,5
6251,172978,2022,USA,Canada,0,0,0,0,04/06/2022,0,0,0,0,0,0,0,0,0,0,0,0,0,0,0,0,0,0,0,0
6252,172978,2022,USA,Dominican Republic,1,2,10,13,01/06/2022,0,0,2,2,13,1,14,28,1,3,4,8,0,0,0,0,6,6,0,12
6253,162942,2022,USA,Serbia,0,0,7,7,13/07/2022,0,0,0,0,1,0,0,1,0,0,0,0,0,0,0,0,0,0,0,0
6254,162942,2022,USA,Germany,2,0,14,16,03/07/2022,0,0,6,6,18,5,20,43,4,3,2,9,7,1,11,19,10,2,0,12
6255,162942,2022,Türkiye,USA,0,0,1,1,02/07/2022,0,0,0,0,0,0,0,0,0,0,0,0,0,0,0,0,0,0,0,0
6256,162942,2022,USA,Serbia,2,0,11,13,01/07/2022,0,0,3,3,10,1,6,17,0,2,1,3,11,0,13,24,11,2,0,13
6257,162942,2022,Belgium,USA,0,0,0,0,30/06/2022,0,0,0,0,0,0,0,0,0,0,0,0,0,0,0,0,0,0,0,0
6258,162942,2022,Japan,USA,0,2,3,5,05/06/2022,0,0,1,1,6,1,5,12,0,1,0,1,2,0,2,4,4,1,0,5
6259,162942,2022,USA,Brazil,0,1,11,12,05/06/2022,0,0,4,4,9,3,14,26,3,1,0,4,11,1,8,20,5,1,0,6
6260,162942,2022,USA,Canada,0,0,0,0,04/06/2022,0,0,0,0,0,0,0,0,0,0,0,0,0,0,0,0,0,0,0,0
6261,162942,2022,USA,Dominican Republic,2,1,16,19,01/06/2022,0,0,2,2,10,5,11,26,3,1,1,5,8,0,6,14,10,3,0,13
6262,140052,2022,USA,Serbia,1,2,27,30,13/07/2022,0,0,2,2,3,1,6,10,3,6,6,15,0,0,2,2,1,2,0,3
6263,140052,2022,USA,Germany,0,0,0,0,03/07/2022,0,0,0,0,0,0,0,0,0,0,0,0,0,0,0,0,0,0,0,0
6264,140052,2022,Türkiye,USA,1,0,14,15,02/07/2022,0,0,0,0,10,5,5,20,0,7,0,7,0,0,1,1,0,1,0,1
6265,140052,2022,USA,Serbia,1,1,13,15,01/07/2022,0,0,1,1,4,4,4,12,3,5,4,12,0,0,1,1,3,0,0,3
6266,140052,2022,Belgium,USA,0,0,0,0,30/06/2022,0,0,0,0,0,0,0,0,0,0,0,0,0,0,0,0,0,0,0,0
6267,140052,2022,Thailand,USA,0,0,0,0,19/06/2022,0,0,0,0,0,0,0,0,0,0,0,0,0,0,0,0,0,0,0,0
6268,140052,2022,USA,China,2,1,14,17,18/06/2022,0,0,1,1,6,1,5,12,3,3,2,8,0,0,0,0,4,1,1,6
6269,140052,2022,Poland,USA,0,0,0,0,17/06/2022,0,0,0,0,0,0,0,0,0,0,0,0,0,0,0,0,0,0,0,0
6270,140052,2022,Bulgaria,USA,4,0,15,19,15/06/2022,0,0,0,0,4,1,2,7,2,2,2,6,0,0,0,0,1,1,1,3
6271,172977,2022,USA,Serbia,0,0,0,0,13/07/2022,0,0,0,0,0,0,0,0,0,0,0,0,0,0,0,0,0,0,0,0
6272,172977,2022,USA,Germany,0,1,9,10,03/07/2022,0,0,1,1,7,2,3,12,2,5,5,12,0,0,0,0,4,2,0,6
6273,172977,2022,Türkiye,USA,0,0,0,0,02/07/2022,0,0,0,0,0,0,0,0,0,0,0,0,0,0,0,0,0,0,0,0
6274,172977,2022,USA,Serbia,0,0,0,0,01/07/2022,0,0,0,0,0,0,0,0,0,0,0,0,0,0,0,0,0,0,0,0
6275,172977,2022,Belgium,USA,1,0,8,9,30/06/2022,0,0,0,0,4,1,7,12,1,1,2,4,0,0,0,0,2,1,0,3
6276,172977,2022,Japan,USA,0,0,3,3,05/06/2022,0,0,0,0,1,1,2,4,1,0,5,6,1,0,1,2,0,0,0,0
6277,172977,2022,USA,Brazil,1,0,13,14,05/06/2022,0,0,2,2,5,3,0,8,3,3,5,11,0,0,0,0,1,0,0,1
6278,172977,2022,USA,Canada,0,0,0,0,04/06/2022,0,0,0,0,0,0,0,0,0,0,0,0,0,0,0,0,0,0,0,0
6279,172977,2022,USA,Dominican Republic,0,2,5,7,01/06/2022,0,0,0,0,3,2,3,8,3,4,3,10,1,0,1,2,1,0,0,1
6280,186425,2022,,,-,-,-,-,-,-,-,-,-,-,-,-,-,-,-,-,-,-,-,-,-,-,-,-,-
6281,179566,2022,USA,Germany,0,0,0,0,03/07/2022,0,0,0,0,0,0,0,0,0,0,0,0,0,0,0,0,0,0,0,0
6282,179566,2022,Türkiye,USA,2,3,15,20,02/07/2022,0,0,2,2,24,7,16,47,0,3,1,4,20,1,30,51,10,0,0,10
6283,179566,2022,USA,Serbia,0,0,0,0,01/07/2022,0,0,0,0,0,0,0,0,0,0,0,0,0,0,0,0,0,0,0,0
6284,179566,2022,Belgium,USA,1,0,12,13,30/06/2022,0,0,1,1,18,3,7,28,1,1,2,4,11,3,11,25,5,0,0,5
6285,179566,2022,Japan,USA,0,1,7,8,05/06/2022,0,0,2,2,10,2,18,30,0,0,1,1,9,1,14,24,5,1,0,6
6286,179566,2022,USA,Brazil,0,0,0,0,05/06/2022,0,0,0,0,0,0,0,0,0,0,0,0,0,0,0,0,0,0,0,0
6287,179566,2022,USA,Canada,1,1,15,17,04/06/2022,0,1,5,6,9,3,11,23,2,1,1,4,18,0,12,30,5,2,0,7
6288,179566,2022,USA,Dominican Republic,0,0,0,0,01/06/2022,0,0,0,0,0,0,0,0,0,0,0,0,0,0,0,0,0,0,0,0
6289,178951,2022,Japan,USA,0,0,0,0,05/06/2022,0,0,0,0,0,0,0,0,0,0,0,0,0,0,0,0,0,0,0,0
6290,178951,2022,USA,Brazil,0,0,0,0,05/06/2022,0,0,0,0,0,0,0,0,0,0,0,0,0,0,0,0,0,0,0,0
6291,178951,2022,USA,Canada,0,0,0,0,04/06/2022,0,0,0,0,0,0,0,0,0,0,0,0,0,0,0,0,0,0,0,0
6292,178951,2022,USA,Dominican Republic,0,0,0,0,01/06/2022,0,0,0,0,0,0,0,0,0,0,0,0,0,0,0,0,0,0,0,0
6293,143524,2022,Thailand,USA,0,0,1,1,19/06/2022,0,0,0,0,0,2,4,6,0,0,1,1,0,0,0,0,1,0,1,2
6294,143524,2022,USA,China,0,2,11,13,18/06/2022,0,0,0,0,7,3,11,21,1,4,1,6,0,0,0,0,6,7,0,13
6295,143524,2022,Poland,USA,0,0,0,0,17/06/2022,0,0,0,0,0,0,0,0,0,0,0,0,0,0,0,0,0,0,0,0
6296,143524,2022,Bulgaria,USA,0,2,9,11,15/06/2022,0,0,2,2,10,1,10,21,2,4,5,11,0,0,0,0,7,3,1,11
6297,174134,2022,Japan,USA,0,0,0,0,05/06/2022,0,0,0,0,0,0,0,0,0,0,0,0,0,0,0,0,0,0,0,0
6298,174134,2022,USA,Brazil,0,0,0,0,05/06/2022,0,0,0,0,0,0,0,0,0,0,0,0,0,0,0,0,0,0,0,0
6299,174134,2022,USA,Canada,0,0,0,0,04/06/2022,0,0,14,14,0,0,0,0,0,0,0,0,6,1,1,8,17,3,1,21
6300,174134,2022,USA,Dominican Republic,0,0,0,0,01/06/2022,0,0,0,0,0,0,0,0,0,0,0,0,0,0,0,0,0,0,0,0
6301,141933,2022,USA,Serbia,0,0,13,13,13/07/2022,0,0,9,9,17,8,14,39,4,4,4,12,6,1,13,20,14,6,1,21
6302,141933,2022,USA,Germany,0,0,5,5,03/07/2022,0,0,2,2,4,0,7,11,0,0,2,2,3,0,2,5,3,0,0,3
6303,141933,2022,Türkiye,USA,2,2,18,22,02/07/2022,0,0,4,4,19,4,17,40,0,3,1,4,16,0,10,26,10,2,0,12
6304,141933,2022,USA,Serbia,0,0,0,0,01/07/2022,0,0,0,0,0,0,0,0,0,0,0,0,0,0,0,0,0,0,0,0
6305,141933,2022,Belgium,USA,0,0,15,15,30/06/2022,0,0,1,1,11,2,9,22,1,1,1,3,6,0,12,18,12,2,0,14
6306,141933,2022,Thailand,USA,1,3,9,13,19/06/2022,1,0,4,5,10,2,16,28,0,3,3,6,7,1,11,19,16,2,1,19
6307,141933,2022,USA,China,1,1,9,11,18/06/2022,0,0,6,6,13,3,12,28,1,2,1,4,5,1,8,14,6,1,0,7
6308,141933,2022,Poland,USA,0,0,0,0,17/06/2022,0,0,0,0,0,0,0,0,0,0,0,0,0,0,0,0,0,0,0,0
6309,141933,2022,Bulgaria,USA,1,1,9,11,15/06/2022,0,0,2,2,13,5,11,29,0,2,2,4,3,1,12,16,4,1,0,5
6310,166638,2022,USA,Serbia,0,1,12,13,13/07/2022,0,0,3,3,6,3,2,11,6,9,13,28,0,1,0,1,1,1,0,2
6311,166638,2022,Thailand,USA,1,1,13,15,19/06/2022,0,0,1,1,8,0,5,13,1,6,8,15,0,0,0,0,2,0,1,3
6312,166638,2022,USA,China,0,0,0,0,18/06/2022,0,0,0,0,0,0,0,0,0,0,0,0,0,0,0,0,0,0,0,0
6313,166638,2022,Poland,USA,0,1,14,15,17/06/2022,0,0,0,0,7,0,4,11,2,6,5,13,0,0,0,0,1,2,1,4
6314,166638,2022,Bulgaria,USA,0,0,0,0,15/06/2022,0,0,0,0,0,0,0,0,0,0,0,0,0,0,0,0,0,0,0,0
6315,139848,2022,USA,Serbia,0,0,6,6,13/07/2022,0,0,3,3,14,3,5,22,2,0,1,3,11,1,19,31,8,3,0,11
6316,139848,2022,Thailand,USA,1,1,15,17,19/06/2022,0,0,3,3,24,2,19,45,2,1,2,5,4,0,20,24,10,1,0,11
6317,139848,2022,USA,China,0,0,0,0,18/06/2022,0,0,0,0,0,0,0,0,0,0,0,0,0,0,0,0,0,0,0,0
6318,139848,2022,Poland,USA,0,0,11,11,17/06/2022,0,0,3,3,15,2,2,19,3,1,2,6,7,0,12,19,6,1,1,8
6319,139848,2022,Bulgaria,USA,0,0,0,0,15/06/2022,0,0,0,0,0,0,0,0,0,0,0,0,0,0,0,0,0,0,0,0
6320,139848,2022,Japan,USA,0,0,1,1,05/06/2022,0,0,0,0,1,1,0,2,1,1,0,2,3,1,3,7,2,0,0,2
6321,139848,2022,USA,Brazil,0,0,7,7,05/06/2022,0,0,2,2,11,4,10,25,2,0,1,3,11,1,14,26,11,3,0,14
6322,139848,2022,USA,Canada,0,0,0,0,04/06/2022,0,0,0,0,0,0,0,0,0,0,0,0,0,0,0,0,0,0,0,0
6323,139848,2022,USA,Dominican Republic,0,1,8,9,01/06/2022,0,0,2,2,13,6,8,27,2,0,2,4,15,0,8,23,6,0,0,6
6324,186519,2022,Thailand,USA,0,5,10,15,19/06/2022,0,0,2,2,7,3,7,17,3,4,8,15,0,0,0,0,1,0,0,1
6325,186519,2022,USA,China,0,0,0,0,18/06/2022,0,0,0,0,0,0,0,0,0,0,0,0,0,0,0,0,0,0,0,0
6326,186519,2022,Poland,USA,0,1,12,13,17/06/2022,0,0,1,1,5,2,3,10,1,2,4,7,0,0,0,0,1,0,0,1
6327,186519,2022,Bulgaria,USA,0,0,0,0,15/06/2022,0,0,0,0,0,0,0,0,0,0,0,0,0,0,0,0,0,0,0,0
6328,186519,2022,Japan,USA,0,2,9,11,05/06/2022,0,0,1,1,7,2,4,13,3,0,2,5,3,0,3,6,6,0,0,6
6329,186519,2022,USA,Brazil,0,0,10,10,05/06/2022,0,0,1,1,4,0,4,8,2,2,4,8,0,0,0,0,1,0,0,1
6330,186519,2022,USA,Canada,0,0,0,0,04/06/2022,0,0,0,0,0,0,0,0,0,0,0,0,0,0,0,0,0,0,0,0
6331,186519,2022,USA,Dominican Republic,0,0,0,0,01/06/2022,0,0,0,0,0,0,0,0,0,0,0,0,0,0,0,0,0,0,0,0
6332,143525,2022,Thailand,USA,0,0,9,9,19/06/2022,0,0,0,0,8,5,12,25,0,6,6,12,0,0,0,0,9,1,2,12
6333,143525,2022,USA,China,0,0,0,0,18/06/2022,0,0,0,0,0,0,0,0,0,0,0,0,0,0,0,0,0,0,0,0
6334,143525,2022,Poland,USA,0,0,12,12,17/06/2022,1,0,0,1,11,2,9,22,1,1,5,7,0,0,0,0,13,1,1,15
6335,143525,2022,Bulgaria,USA,0,0,0,0,15/06/2022,0,0,0,0,0,0,0,0,0,0,0,0,0,0,0,0,0,0,0,0
6336,152119,2023,Brazil,China,1,1,8,10,13/07/2023,0,0,0,0,1,1,2,4,2,0,2,4,0,0,0,0,3,0,1,4
6337,152119,2023,Thailand,Brazil,0,0,0,0,02/07/2023,0,0,0,0,0,0,0,0,0,0,0,0,0,0,0,0,0,0,0,0
6338,152119,2023,Brazil,Türkiye,0,0,4,4,30/06/2023,0,0,0,0,0,2,0,2,1,0,2,3,0,0,0,0,0,1,1,2
6339,152119,2023,Brazil,Canada,0,0,0,0,29/06/2023,0,0,0,0,0,0,0,0,0,0,0,0,0,0,0,0,0,0,0,0
6340,152119,2023,Brazil,Italy,0,0,2,2,28/06/2023,0,0,0,0,0,0,1,1,0,0,0,0,0,0,0,0,1,0,0,1
6341,152119,2023,Brazil,USA,0,0,4,4,18/06/2023,0,0,0,0,3,0,0,3,3,1,0,4,0,0,0,0,1,0,0,1
6342,152119,2023,Brazil,Germany,2,0,4,6,17/06/2023,0,0,1,1,2,1,1,4,2,10,1,13,0,0,0,0,2,0,1,3
6343,152119,2023,Brazil,Serbia,0,0,0,0,16/06/2023,0,0,0,0,0,0,0,0,0,0,0,0,0,0,0,0,0,0,0,0
6344,152119,2023,Brazil,Korea,2,0,10,12,15/06/2023,0,0,1,1,6,2,2,10,3,5,9,17,0,0,0,0,2,0,3,5
6345,152119,2023,Croatia,Brazil,1,2,5,8,04/06/2023,0,0,1,1,6,0,2,8,2,0,3,5,0,1,1,2,1,0,1,2
6346,152119,2023,Brazil,Dominican Republic,1,0,7,8,03/06/2023,0,0,1,1,9,4,2,15,2,9,6,17,1,0,0,1,3,0,1,4
6347,152119,2023,Brazil,Netherlands,0,1,9,10,01/06/2023,0,0,0,0,2,2,1,5,1,1,6,8,0,0,0,0,1,1,0,2
6348,152119,2023,China,Brazil,1,2,9,12,31/05/2023,0,0,0,0,14,0,5,19,1,2,4,7,0,0,0,0,2,0,1,3
6349,152135,2023,Brazil,China,0,0,0,0,13/07/2023,0,0,0,0,0,0,0,0,0,0,0,0,0,0,0,0,0,0,0,0
6350,152135,2023,Thailand,Brazil,0,0,0,0,02/07/2023,0,0,3,3,0,0,0,0,0,0,0,0,2,2,6,10,12,4,0,16
6351,152135,2023,Brazil,Türkiye,0,0,0,0,30/06/2023,0,0,10,10,0,0,0,0,0,0,0,0,8,0,20,28,8,8,1,17
6352,152135,2023,Brazil,Canada,0,0,0,0,29/06/2023,0,0,7,7,0,0,0,0,0,0,0,0,6,0,19,25,12,1,5,18
6353,152135,2023,Brazil,Italy,0,0,0,0,28/06/2023,0,0,0,0,0,0,0,0,0,0,0,0,0,0,0,0,0,0,0,0
6354,152135,2023,Brazil,USA,0,0,0,0,18/06/2023,0,0,5,5,0,0,0,0,0,0,0,0,2,2,8,12,6,5,0,11
6355,152135,2023,Brazil,Germany,0,0,0,0,17/06/2023,0,0,4,4,0,0,0,0,0,0,0,0,6,0,2,8,11,2,2,15
6356,152135,2023,Brazil,Serbia,0,0,0,0,16/06/2023,0,0,9,9,0,0,0,0,0,0,0,0,3,1,7,11,16,6,2,24
6357,152135,2023,Brazil,Korea,0,0,0,0,15/06/2023,0,0,1,1,0,0,0,0,0,0,0,0,1,0,6,7,9,2,0,11
6358,115970,2023,Brazil,China,0,0,0,0,13/07/2023,0,0,0,0,0,0,0,0,0,0,0,0,0,0,0,0,0,0,0,0
6359,115970,2023,Thailand,Brazil,0,0,0,0,02/07/2023,0,0,0,0,0,0,0,0,0,0,0,0,0,0,0,0,0,0,0,0
6360,115970,2023,Brazil,Türkiye,0,0,3,3,30/06/2023,0,0,1,1,1,3,4,8,1,3,2,6,2,1,11,14,8,0,2,10
6361,115970,2023,Brazil,Canada,0,1,3,4,29/06/2023,0,0,1,1,3,2,7,12,1,1,0,2,2,0,5,7,2,1,0,3
6362,115970,2023,Brazil,Italy,1,0,10,11,28/06/2023,0,0,1,1,3,2,13,18,1,1,4,6,6,1,9,16,8,1,2,11
6363,115970,2023,Brazil,USA,0,0,0,0,18/06/2023,0,0,0,0,0,0,0,0,0,0,0,0,0,0,0,0,0,0,0,0
6364,115970,2023,Brazil,Germany,0,0,4,4,17/06/2023,0,0,1,1,2,1,2,5,0,1,2,3,1,0,6,7,0,0,1,1
6365,115970,2023,Brazil,Serbia,0,1,16,17,16/06/2023,0,0,4,4,12,1,15,28,0,3,2,5,9,3,19,31,11,7,1,19
6366,115970,2023,Brazil,Korea,0,1,10,11,15/06/2023,0,0,0,0,6,5,5,16,1,0,2,3,6,0,14,20,14,3,2,19
6367,113963,2023,Brazil,China,1,2,9,12,13/07/2023,0,0,4,4,17,3,5,25,0,3,3,6,0,1,2,3,1,2,0,3
6368,113963,2023,Thailand,Brazil,1,3,13,17,02/07/2023,0,0,3,3,10,1,4,15,0,2,2,4,0,0,1,1,2,1,1,4
6369,113963,2023,Brazil,Türkiye,0,2,6,8,30/06/2023,0,0,2,2,8,0,6,14,0,2,5,7,0,0,1,1,0,1,1,2
6370,113963,2023,Brazil,Canada,1,4,14,19,29/06/2023,0,0,2,2,14,1,7,22,2,6,4,12,0,0,0,0,2,0,0,2
6371,113963,2023,Brazil,Italy,1,2,14,17,28/06/2023,0,0,0,0,8,0,3,11,3,8,5,16,0,0,0,0,3,2,0,5
6372,113963,2023,Brazil,USA,1,2,4,7,18/06/2023,0,0,0,0,10,2,3,15,1,4,3,8,0,0,0,0,2,0,2,4
6373,113963,2023,Brazil,Germany,0,1,5,6,17/06/2023,0,0,2,2,3,0,6,9,4,3,3,10,0,0,0,0,3,0,0,3
6374,113963,2023,Brazil,Serbia,1,0,16,17,16/06/2023,0,1,4,5,8,0,6,14,9,4,3,16,0,0,1,1,2,1,0,3
6375,113963,2023,Brazil,Korea,1,1,11,13,15/06/2023,0,0,5,5,9,4,5,18,1,7,4,12,0,0,2,2,1,1,0,2
6376,136897,2023,Brazil,China,0,0,0,0,13/07/2023,0,0,0,0,0,0,0,0,0,0,0,0,0,0,0,0,0,0,0,0
6377,136897,2023,Thailand,Brazil,0,2,9,11,02/07/2023,0,0,1,1,6,2,10,18,2,0,2,4,0,0,0,0,9,1,0,10
6378,136897,2023,Brazil,Türkiye,0,1,2,3,30/06/2023,0,0,2,2,3,3,3,9,0,2,1,3,0,0,0,0,2,0,0,2
6379,136897,2023,Brazil,Canada,2,2,9,13,29/06/2023,0,0,2,2,13,10,8,31,0,1,2,3,0,0,0,0,2,2,0,4
6380,136897,2023,Brazil,Italy,1,2,18,21,28/06/2023,0,0,2,2,18,7,17,42,2,6,2,10,0,0,0,0,4,3,1,8
6381,136897,2023,Brazil,USA,0,1,1,2,18/06/2023,0,0,0,0,2,1,2,5,0,0,1,1,0,0,0,0,1,1,0,2
6382,136897,2023,Brazil,Germany,1,0,9,10,17/06/2023,0,0,2,2,18,5,12,35,0,3,2,5,0,0,0,0,11,0,0,11
6383,136897,2023,Brazil,Serbia,0,0,0,0,16/06/2023,0,0,0,0,1,2,2,5,0,0,1,1,0,0,0,0,0,0,0,0
6384,136897,2023,Brazil,Korea,0,0,0,0,15/06/2023,0,0,0,0,1,1,1,3,0,0,1,1,0,0,0,0,0,0,0,0
6385,151187,2023,Brazil,China,2,1,9,12,13/07/2023,36,0,72,108,2,0,1,3,0,1,1,2,0,0,0,0,4,2,2,8
6386,151187,2023,Thailand,Brazil,0,0,9,9,02/07/2023,24,0,60,84,1,0,1,2,0,1,3,4,0,0,0,0,2,3,1,6
6387,151187,2023,Brazil,Türkiye,0,2,2,4,30/06/2023,8,0,49,57,0,0,2,2,0,1,2,3,0,0,1,1,4,4,1,9
6388,151187,2023,Brazil,Canada,0,1,3,4,29/06/2023,12,0,56,68,0,0,0,0,2,2,0,4,0,0,0,0,8,1,2,11
6389,151187,2023,Brazil,Italy,0,0,3,3,28/06/2023,5,0,27,32,0,0,0,0,0,0,1,1,0,0,0,0,1,0,0,1
6390,151187,2023,Brazil,USA,0,0,9,9,18/06/2023,5,0,51,56,0,0,2,2,0,2,2,4,0,0,0,0,1,4,1,6
6391,151187,2023,Brazil,Germany,0,0,4,4,17/06/2023,8,0,18,26,0,0,1,1,0,2,1,3,0,0,0,0,0,0,0,0
6392,151187,2023,Brazil,Serbia,0,0,14,14,16/06/2023,14,3,87,104,1,1,0,2,3,4,3,10,0,0,0,0,9,6,2,17
6393,151187,2023,Brazil,Korea,0,0,12,12,15/06/2023,22,0,57,79,0,0,0,0,1,1,5,7,0,0,0,0,4,3,0,7
6394,151187,2023,Croatia,Brazil,1,0,5,6,04/06/2023,2,0,56,58,1,0,0,1,1,0,1,2,0,0,0,0,2,0,0,2
6395,151187,2023,Brazil,Dominican Republic,1,0,18,19,03/06/2023,8,1,113,122,1,1,2,4,0,1,2,3,0,0,0,0,6,1,2,9
6396,151187,2023,Brazil,Netherlands,0,0,10,10,01/06/2023,5,3,73,81,1,0,2,3,0,1,1,2,0,0,0,0,4,0,0,4
6397,151187,2023,China,Brazil,0,1,16,17,31/05/2023,11,1,110,122,0,0,1,1,0,0,1,1,0,0,0,0,4,0,2,6
6398,119575,2023,Brazil,China,0,0,4,4,13/07/2023,8,0,7,15,0,0,0,0,0,0,0,0,0,0,0,0,0,0,0,0
6399,119575,2023,Thailand,Brazil,0,0,0,0,02/07/2023,1,0,0,1,0,0,0,0,0,0,0,0,0,0,0,0,0,0,0,0
6400,119575,2023,Brazil,Türkiye,0,1,6,7,30/06/2023,2,0,30,32,0,0,0,0,0,1,0,1,0,0,0,0,1,1,0,2
6401,119575,2023,Brazil,Canada,0,0,11,11,29/06/2023,23,0,68,91,1,0,0,1,0,0,3,3,0,0,0,0,5,1,1,7
6402,119575,2023,Brazil,Italy,0,2,11,13,28/06/2023,13,1,96,110,0,0,0,0,1,2,6,9,0,0,1,1,2,2,0,4
6403,119575,2023,Brazil,USA,0,0,9,9,18/06/2023,8,0,20,28,0,0,0,0,0,1,0,1,0,0,0,0,3,3,0,6
6404,119575,2023,Brazil,Germany,0,0,11,11,17/06/2023,12,0,69,81,1,0,3,4,0,5,3,8,0,0,0,0,9,2,1,12
6405,119575,2023,Brazil,Serbia,0,0,3,3,16/06/2023,2,0,7,9,0,0,0,0,0,0,0,0,0,0,0,0,0,1,0,1
6406,119575,2023,Brazil,Korea,0,0,5,5,15/06/2023,4,0,4,8,0,0,0,0,0,0,0,0,0,0,0,0,0,0,0,0
6407,136896,2023,Brazil,China,1,2,12,15,13/07/2023,0,0,2,2,14,10,9,33,1,3,1,5,14,0,29,43,12,2,2,16
6408,136896,2023,Thailand,Brazil,0,0,13,13,02/07/2023,0,0,2,2,17,6,7,30,1,0,3,4,9,0,11,20,5,1,3,9
6409,136896,2023,Brazil,Türkiye,0,0,14,14,30/06/2023,0,0,2,2,7,4,16,27,0,1,1,2,7,0,6,13,6,4,1,11
6410,136896,2023,Brazil,Canada,0,0,25,25,29/06/2023,0,0,2,2,19,14,30,63,1,2,2,5,14,1,10,25,14,3,0,17
6411,136896,2023,Brazil,Italy,0,1,20,21,28/06/2023,0,1,1,2,24,9,17,50,1,5,4,10,10,0,11,21,13,6,1,20
6412,141651,2023,Brazil,China,0,0,4,4,13/07/2023,0,1,3,4,2,2,5,9,0,0,0,0,2,0,12,14,2,2,0,4
6413,141651,2023,Thailand,Brazil,0,0,14,14,02/07/2023,0,0,1,1,8,4,8,20,2,2,3,7,9,1,13,23,8,2,2,12
6414,141651,2023,Brazil,Türkiye,1,1,6,8,30/06/2023,0,0,1,1,10,5,16,31,1,3,2,6,2,0,11,13,5,1,0,6
6415,141651,2023,Brazil,Canada,0,1,9,10,29/06/2023,0,0,0,0,10,3,7,20,1,2,1,4,4,0,10,14,6,1,0,7
6416,141651,2023,Brazil,Italy,1,0,3,4,28/06/2023,0,0,1,1,3,2,6,11,0,0,0,0,2,0,6,8,1,0,0,1
6417,141651,2023,Brazil,USA,0,2,11,13,18/06/2023,0,0,2,2,10,2,10,22,1,2,2,5,3,0,6,9,7,4,0,11
6418,141651,2023,Brazil,Germany,1,3,14,18,17/06/2023,0,0,6,6,17,3,20,40,0,2,9,11,6,2,8,16,6,1,0,7
6419,141651,2023,Brazil,Serbia,1,0,13,14,16/06/2023,0,0,2,2,10,3,9,22,0,0,3,3,6,0,11,17,5,4,1,10
6420,141651,2023,Brazil,Korea,0,1,1,2,15/06/2023,0,0,0,0,0,0,0,0,0,0,0,0,0,0,0,0,0,0,0,0
6421,141651,2023,Croatia,Brazil,0,0,4,4,04/06/2023,0,0,0,0,0,0,0,0,0,0,0,0,0,0,1,1,1,0,0,1
6422,141651,2023,Brazil,Dominican Republic,0,1,3,4,03/06/2023,0,0,0,0,0,0,0,0,0,0,0,0,0,0,0,0,0,0,0,0
6423,141651,2023,Brazil,Netherlands,1,0,3,4,01/06/2023,0,0,0,0,0,0,0,0,0,0,0,0,0,0,0,0,1,0,0,1
6424,141651,2023,China,Brazil,0,0,1,1,31/05/2023,0,0,0,0,0,0,0,0,0,0,0,0,0,0,0,0,0,0,0,0
6425,164674,2023,Brazil,China,0,0,0,0,13/07/2023,0,0,12,12,0,0,0,0,0,0,0,0,7,0,3,10,8,5,1,14
6426,164674,2023,Thailand,Brazil,0,0,0,0,02/07/2023,0,0,0,0,0,0,0,0,0,0,0,0,0,0,0,0,0,0,0,0
6427,164674,2023,Brazil,Türkiye,0,0,0,0,30/06/2023,0,0,0,0,0,0,0,0,0,0,0,0,0,0,0,0,0,0,0,0
6428,164674,2023,Brazil,Canada,0,0,0,0,29/06/2023,0,0,5,5,0,0,0,0,0,0,0,0,6,0,18,24,6,1,1,8
6429,164674,2023,Brazil,Italy,0,0,0,0,28/06/2023,0,0,8,8,0,0,0,0,0,0,0,0,12,0,34,46,22,4,0,26
6430,164674,2023,Brazil,USA,0,0,0,0,18/06/2023,0,0,0,0,0,0,0,0,0,0,0,0,0,0,0,0,0,0,0,0
6431,164674,2023,Brazil,Germany,0,0,0,0,17/06/2023,0,0,6,6,0,0,0,0,0,0,0,0,0,0,4,4,9,2,1,12
6432,164674,2023,Brazil,Serbia,0,0,0,0,16/06/2023,0,0,0,0,0,0,0,0,0,0,0,0,0,0,0,0,0,0,0,0
6433,164674,2023,Brazil,Korea,0,0,0,0,15/06/2023,0,0,0,0,0,0,0,0,0,0,0,0,0,0,0,0,0,0,0,0
6434,164674,2023,Croatia,Brazil,0,0,0,0,04/06/2023,0,0,0,0,0,0,0,0,0,0,0,0,0,0,0,0,0,0,0,0
6435,164674,2023,Brazil,Dominican Republic,0,0,0,0,03/06/2023,0,0,5,5,0,0,0,0,0,0,0,0,14,0,15,29,16,2,4,22
6436,164674,2023,Brazil,Netherlands,0,0,0,0,01/06/2023,0,0,8,8,0,0,0,0,0,0,0,0,5,1,10,16,12,0,0,12
6437,164674,2023,China,Brazil,0,0,0,0,31/05/2023,0,0,6,6,0,0,0,0,0,0,0,0,8,1,11,20,14,0,1,15
6438,144866,2023,Brazil,China,0,1,6,7,13/07/2023,0,0,2,2,5,1,1,7,2,4,3,9,0,0,0,0,0,1,1,2
6439,144866,2023,Thailand,Brazil,1,3,6,10,02/07/2023,0,0,0,0,8,1,1,10,5,5,7,17,0,0,0,0,0,0,0,0
6440,144866,2023,Brazil,Türkiye,0,1,6,7,30/06/2023,0,0,1,1,4,1,2,7,2,3,0,5,0,0,0,0,1,0,0,1
6441,144866,2023,Brazil,Canada,0,1,19,20,29/06/2023,0,0,2,2,5,3,4,12,6,4,9,19,0,0,0,0,3,1,1,5
6442,144866,2023,Brazil,Italy,1,1,16,18,28/06/2023,0,0,1,1,11,3,6,20,2,6,5,13,0,0,0,0,3,1,0,4
6443,144866,2023,Brazil,USA,0,1,5,6,18/06/2023,0,0,1,1,2,1,3,6,3,3,2,8,0,0,0,0,3,1,0,4
6444,144866,2023,Brazil,Germany,0,1,13,14,17/06/2023,0,0,0,0,7,1,3,11,3,4,0,7,0,0,0,0,1,1,0,2
6445,144866,2023,Brazil,Serbia,0,1,19,20,16/06/2023,0,0,3,3,9,2,8,19,3,9,8,20,0,0,0,0,3,3,0,6
6446,144866,2023,Brazil,Korea,0,0,0,0,15/06/2023,0,0,0,0,0,0,0,0,0,0,0,0,0,0,0,0,0,0,0,0
6447,144866,2023,Croatia,Brazil,1,1,11,13,04/06/2023,0,0,0,0,6,2,3,11,2,1,2,5,2,0,2,4,2,0,0,2
6448,144866,2023,Brazil,Dominican Republic,1,2,15,18,03/06/2023,0,0,2,2,1,1,4,6,4,3,3,10,0,0,0,0,1,0,2,3
6449,144866,2023,Brazil,Netherlands,3,0,12,15,01/06/2023,0,0,0,0,0,2,3,5,0,2,2,4,0,0,0,0,1,0,0,1
6450,144866,2023,China,Brazil,0,1,16,17,31/05/2023,0,0,1,1,7,0,7,14,2,2,4,8,0,0,0,0,1,0,2,3
6451,171260,2023,Brazil,China,1,1,5,7,13/07/2023,0,0,0,0,5,4,9,18,0,1,1,2,0,0,0,0,3,3,0,6
6452,171260,2023,Brazil,USA,0,1,4,5,18/06/2023,0,0,1,1,10,3,13,26,1,3,0,4,0,0,0,0,5,1,1,7
6453,171260,2023,Brazil,Germany,0,1,1,2,17/06/2023,0,0,0,0,1,1,4,6,0,1,0,1,0,0,0,0,1,1,0,2
6454,171260,2023,Brazil,Serbia,0,4,14,18,16/06/2023,0,0,1,1,13,7,12,32,3,3,5,11,0,0,0,0,11,3,2,16
6455,171260,2023,Brazil,Korea,0,1,6,7,15/06/2023,0,0,1,1,13,1,7,21,2,2,3,7,0,0,0,0,6,0,1,7
6456,171260,2023,Croatia,Brazil,0,0,0,0,04/06/2023,0,0,0,0,0,0,0,0,0,0,0,0,0,0,0,0,0,0,0,0
6457,171260,2023,Brazil,Dominican Republic,1,0,9,10,03/06/2023,0,0,2,2,10,4,17,31,1,3,0,4,0,0,0,0,8,0,0,8
6458,171260,2023,Brazil,Netherlands,1,2,11,14,01/06/2023,0,0,0,0,10,4,5,19,0,1,3,4,0,0,0,0,5,0,1,6
6459,171260,2023,China,Brazil,1,2,13,16,31/05/2023,0,0,1,1,16,3,14,33,4,0,0,4,0,0,0,0,9,0,3,12
6460,162999,2023,Brazil,China,0,2,8,10,13/07/2023,0,0,0,0,4,3,11,18,0,3,0,3,3,0,14,17,9,2,1,12
6461,162999,2023,Thailand,Brazil,0,0,0,0,02/07/2023,0,0,0,0,0,0,0,0,0,0,0,0,0,0,0,0,0,0,0,0
6462,162999,2023,Brazil,Türkiye,0,0,0,0,30/06/2023,0,0,0,0,0,0,0,0,0,0,0,0,0,0,0,0,0,0,0,0
6463,162999,2023,Brazil,Canada,0,1,2,3,29/06/2023,0,0,0,0,1,1,2,4,0,1,0,1,1,2,9,12,1,0,0,1
6464,162999,2023,Brazil,Italy,0,0,0,0,28/06/2023,0,0,0,0,0,0,1,1,0,0,0,0,0,0,0,0,0,0,0,0
6465,162999,2023,Brazil,USA,1,0,9,10,18/06/2023,0,0,1,1,6,6,6,18,0,1,0,1,11,5,32,48,2,2,0,4
6466,162999,2023,Brazil,Germany,2,2,13,17,17/06/2023,0,0,0,0,9,1,11,21,0,1,2,3,10,1,28,39,4,2,0,6
6467,162999,2023,Brazil,Serbia,0,1,4,5,16/06/2023,0,0,0,0,0,6,8,14,0,1,0,1,2,0,17,19,5,1,1,7
6468,162999,2023,Brazil,Korea,1,2,12,15,15/06/2023,0,0,1,1,14,5,6,25,0,2,1,3,6,3,19,28,8,2,0,10
6469,162999,2023,Croatia,Brazil,1,1,13,15,04/06/2023,0,0,1,1,3,5,9,17,1,0,0,1,3,1,11,15,10,0,0,10
6470,162999,2023,Brazil,Dominican Republic,0,3,14,17,03/06/2023,0,0,2,2,11,10,11,32,2,4,3,9,9,2,21,32,7,1,2,10
6471,162999,2023,Brazil,Netherlands,1,1,8,10,01/06/2023,0,0,0,0,10,4,9,23,2,0,1,3,9,2,22,33,4,0,1,5
6472,162999,2023,China,Brazil,0,4,16,20,31/05/2023,0,0,1,1,15,8,8,31,1,0,0,1,12,1,26,39,9,1,2,12
6473,163000,2023,Brazil,China,2,3,4,9,13/07/2023,0,0,1,1,10,6,9,25,1,2,2,5,0,0,0,0,8,2,1,11
6474,163000,2023,Croatia,Brazil,0,0,0,0,04/06/2023,0,0,0,0,2,0,0,2,2,0,0,2,0,0,0,0,1,0,0,1
6475,163000,2023,Brazil,Dominican Republic,0,0,0,0,03/06/2023,0,0,0,0,0,0,0,0,0,0,0,0,0,0,0,0,0,0,0,0
6476,163000,2023,Brazil,Netherlands,0,0,0,0,01/06/2023,0,0,0,0,0,0,0,0,0,0,0,0,0,0,0,0,0,0,0,0
6477,163000,2023,China,Brazil,0,0,0,0,31/05/2023,0,0,0,0,1,0,1,2,0,0,0,0,0,0,0,0,0,0,1,1
6478,151859,2023,Serbia,Bulgaria,1,1,1,3,02/07/2023,0,1,1,2,0,0,1,1,2,0,0,2,0,0,6,6,0,0,0,0
6479,151859,2023,Bulgaria,Poland,0,0,2,2,30/06/2023,0,0,1,1,4,1,1,6,0,2,0,2,0,1,6,7,2,1,0,3
6480,151859,2023,USA,Bulgaria,0,0,0,0,29/06/2023,0,0,0,0,0,0,0,0,0,0,0,0,0,0,0,0,0,0,0,0
6481,151859,2023,Bulgaria,Korea,0,0,0,0,27/06/2023,0,0,0,0,0,0,0,0,0,0,0,0,0,0,0,0,0,0,0,0
6482,151859,2023,Bulgaria,Netherlands,0,0,0,0,18/06/2023,0,0,0,0,0,0,0,0,0,0,0,0,0,0,0,0,0,0,0,0
6483,151859,2023,Bulgaria,China,0,0,1,1,16/06/2023,0,0,1,1,0,4,5,9,0,0,0,0,0,1,6,7,0,2,0,2
6484,151859,2023,Bulgaria,Canada,0,2,5,7,15/06/2023,0,0,1,1,7,6,14,27,0,1,1,2,3,0,11,14,2,1,0,3
6485,151859,2023,Italy,Bulgaria,0,0,0,0,14/06/2023,0,0,1,1,0,0,0,0,0,0,0,0,1,1,0,2,1,0,0,1
6486,153422,2023,Serbia,Bulgaria,0,0,0,0,02/07/2023,0,0,4,4,0,0,0,0,0,0,0,0,0,0,0,0,0,0,0,0
6487,153422,2023,Bulgaria,Poland,0,0,0,0,30/06/2023,0,0,6,6,0,0,0,0,0,0,0,0,0,0,0,0,0,0,0,0
6488,153422,2023,USA,Bulgaria,0,0,1,1,29/06/2023,4,1,30,35,0,0,1,1,1,0,0,1,0,0,0,0,0,1,0,1
6489,153422,2023,Bulgaria,Korea,0,0,0,0,27/06/2023,0,0,0,0,0,0,0,0,0,0,0,0,0,0,0,0,0,0,0,0
6490,153422,2023,Bulgaria,Netherlands,0,0,0,0,18/06/2023,0,0,0,0,0,0,0,0,0,0,0,0,0,0,0,0,0,0,0,0
6491,153422,2023,Bulgaria,China,0,0,0,0,16/06/2023,1,0,7,8,0,0,0,0,0,1,0,1,0,0,0,0,1,0,0,1
6492,153422,2023,Bulgaria,Canada,0,1,0,1,15/06/2023,2,0,25,27,0,1,0,1,1,0,1,2,0,0,0,0,2,1,2,5
6493,153422,2023,Italy,Bulgaria,0,1,2,3,14/06/2023,2,0,23,25,1,0,1,2,0,0,2,2,0,0,0,0,1,0,1,2
6494,153422,2023,Germany,Bulgaria,0,0,1,1,04/06/2023,1,0,19,20,0,0,0,0,0,0,0,0,0,0,0,0,1,0,0,1
6495,153422,2023,Bulgaria,Japan,0,0,1,1,03/06/2023,0,0,16,16,0,0,0,0,1,0,0,1,0,0,0,0,1,0,0,1
6496,153422,2023,Bulgaria,Dominican Republic,0,0,0,0,01/06/2023,3,1,16,20,0,0,0,0,0,0,1,1,0,0,0,0,0,0,0,0
6497,153422,2023,Croatia,Bulgaria,0,0,0,0,31/05/2023,0,0,0,0,0,0,0,0,0,0,0,0,0,0,0,0,0,0,0,0
6498,174474,2023,Serbia,Bulgaria,1,2,12,15,02/07/2023,0,0,4,4,9,7,18,34,1,2,5,8,1,1,5,7,6,7,0,13
6499,174474,2023,Bulgaria,Poland,2,2,11,15,30/06/2023,0,0,4,4,10,5,13,28,0,3,1,4,4,0,24,28,9,1,1,11
6500,174474,2023,USA,Bulgaria,2,1,8,11,29/06/2023,0,0,1,1,8,10,11,29,0,2,3,5,1,0,7,8,6,0,0,6
6501,174474,2023,Bulgaria,Korea,3,4,15,22,27/06/2023,0,0,2,2,15,8,11,34,0,3,2,5,9,0,11,20,12,4,0,16
6502,174474,2023,Bulgaria,Netherlands,1,2,7,10,18/06/2023,0,0,2,2,9,6,12,27,0,2,0,2,4,2,29,35,6,0,0,6
6503,174474,2023,Bulgaria,China,0,1,7,8,16/06/2023,0,1,2,3,5,8,11,24,0,0,0,0,3,2,33,38,4,5,3,12
6504,174474,2023,Bulgaria,Canada,0,1,6,7,15/06/2023,0,0,4,4,9,3,12,24,0,1,0,1,3,1,13,17,6,1,2,9
6505,174474,2023,Italy,Bulgaria,1,4,5,10,14/06/2023,0,0,0,0,11,6,21,38,0,4,4,8,8,0,24,32,6,6,0,12
6506,174474,2023,Germany,Bulgaria,3,2,15,20,04/06/2023,0,0,0,0,25,9,25,59,0,0,2,2,5,2,13,20,13,0,3,16
6507,174474,2023,Bulgaria,Japan,1,1,9,11,03/06/2023,0,0,4,4,7,3,10,20,0,1,0,1,4,2,19,25,3,0,1,4
6508,174474,2023,Bulgaria,Dominican Republic,2,0,12,14,01/06/2023,0,0,2,2,12,3,27,42,0,2,3,5,14,2,26,42,17,1,1,19
6509,174474,2023,Croatia,Bulgaria,3,1,8,12,31/05/2023,0,0,1,1,10,6,5,21,0,0,4,4,4,0,14,18,8,0,1,9
6510,153421,2023,Serbia,Bulgaria,0,0,1,1,02/07/2023,0,0,0,0,0,1,0,1,0,1,1,2,0,0,0,0,0,0,0,0
6511,153421,2023,Bulgaria,Poland,0,0,0,0,30/06/2023,0,0,0,0,0,1,0,1,0,0,0,0,0,0,0,0,0,0,0,0
6512,153421,2023,USA,Bulgaria,0,1,5,6,29/06/2023,0,0,0,0,4,3,9,16,1,2,1,4,0,0,0,0,0,0,0,0
6513,153421,2023,Bulgaria,Korea,0,0,0,0,27/06/2023,0,0,0,0,0,0,0,0,0,0,0,0,0,0,0,0,0,0,0,0
6514,153421,2023,Bulgaria,Netherlands,0,0,0,0,18/06/2023,0,0,0,0,0,0,0,0,0,0,0,0,0,0,0,0,0,0,0,0
6515,153421,2023,Bulgaria,China,0,0,1,1,16/06/2023,0,0,1,1,2,3,1,6,0,0,0,0,0,0,0,0,1,2,0,3
6516,153421,2023,Bulgaria,Canada,0,0,1,1,15/06/2023,0,0,0,0,1,0,3,4,0,0,0,0,0,0,0,0,0,0,0,0
6517,153421,2023,Italy,Bulgaria,0,0,2,2,14/06/2023,0,0,0,0,0,1,0,1,0,0,0,0,0,0,0,0,0,1,1,2
6518,153421,2023,Germany,Bulgaria,0,2,0,2,04/06/2023,0,0,0,0,2,2,3,7,0,0,0,0,0,0,0,0,0,0,0,0
6519,153421,2023,Bulgaria,Japan,0,1,1,2,03/06/2023,0,0,0,0,4,1,2,7,0,0,0,0,0,0,0,0,0,0,0,0
6520,153421,2023,Bulgaria,Dominican Republic,0,0,3,3,01/06/2023,0,0,0,0,0,0,3,3,0,0,0,0,0,0,1,1,1,0,0,1
6521,153421,2023,Croatia,Bulgaria,0,0,0,0,31/05/2023,0,0,0,0,0,0,0,0,0,0,0,0,0,0,0,0,0,0,0,0
6522,142348,2023,Serbia,Bulgaria,1,1,12,14,02/07/2023,9,2,92,103,0,0,4,4,1,5,6,12,0,0,1,1,8,3,2,13
6523,142348,2023,Bulgaria,Poland,0,0,16,16,30/06/2023,6,1,102,109,1,0,1,2,1,3,7,11,0,0,0,0,5,0,1,6
6524,142348,2023,USA,Bulgaria,0,1,0,1,29/06/2023,5,0,44,49,0,1,0,1,1,3,0,4,0,0,0,0,2,3,0,5
6525,142348,2023,Bulgaria,Korea,0,1,12,13,27/06/2023,23,0,94,117,0,0,3,3,2,3,3,8,0,0,0,0,3,0,1,4
6526,142348,2023,Bulgaria,Netherlands,1,0,8,9,18/06/2023,9,0,76,85,0,1,1,2,0,3,4,7,0,0,0,0,4,2,0,6
6527,142348,2023,Bulgaria,China,0,0,9,9,16/06/2023,21,0,60,81,1,0,1,2,0,1,2,3,0,1,0,1,3,1,1,5
6528,142348,2023,Bulgaria,Canada,0,0,4,4,15/06/2023,5,0,51,56,0,0,3,3,0,2,1,3,0,0,0,0,1,1,0,2
6529,142348,2023,Italy,Bulgaria,0,0,4,4,14/06/2023,6,0,60,66,1,1,1,3,0,1,1,2,0,2,0,2,2,2,0,4
6530,142348,2023,Germany,Bulgaria,0,1,11,12,04/06/2023,5,0,116,121,2,0,1,3,0,0,2,2,0,0,0,0,11,0,3,14
6531,142348,2023,Bulgaria,Japan,0,0,5,5,03/06/2023,5,1,55,61,0,0,0,0,1,2,2,5,0,0,0,0,1,0,0,1
6532,142348,2023,Bulgaria,Dominican Republic,0,0,10,10,01/06/2023,3,0,102,105,4,0,4,8,0,4,2,6,0,0,1,1,9,1,4,14
6533,142348,2023,Croatia,Bulgaria,2,0,12,14,31/05/2023,2,0,74,76,1,0,0,1,0,0,1,1,0,0,0,0,9,0,0,9
6534,163256,2023,Serbia,Bulgaria,1,0,8,9,02/07/2023,0,1,1,2,6,4,14,24,0,1,1,2,4,2,28,34,10,3,1,14
6535,163256,2023,Bulgaria,Poland,2,0,8,10,30/06/2023,0,0,1,1,7,11,15,33,1,3,0,4,2,2,27,31,6,0,0,6
6536,163256,2023,USA,Bulgaria,1,1,5,7,29/06/2023,0,0,4,4,5,7,9,21,0,0,0,0,3,3,19,25,11,2,0,13
6537,163256,2023,Bulgaria,Korea,0,2,13,15,27/06/2023,0,0,2,2,7,2,17,26,1,3,4,8,4,2,24,30,13,2,0,15
6538,163256,2023,Bulgaria,Netherlands,0,1,6,7,18/06/2023,0,0,4,4,6,9,11,26,0,2,0,2,3,1,16,20,2,1,0,3
6539,163256,2023,Bulgaria,China,0,2,8,10,16/06/2023,0,0,2,2,4,6,10,20,0,1,1,2,5,2,20,27,6,1,4,11
6540,163256,2023,Bulgaria,Canada,0,0,3,3,15/06/2023,0,0,0,0,5,6,5,16,0,3,0,3,1,2,11,14,2,1,0,3
6541,163256,2023,Italy,Bulgaria,2,1,11,14,14/06/2023,0,0,4,4,6,4,12,22,1,1,0,2,1,0,27,28,5,4,1,10
6542,163256,2023,Germany,Bulgaria,0,1,15,16,04/06/2023,0,0,2,2,16,4,12,32,0,1,2,3,2,3,33,38,9,0,1,10
6543,163256,2023,Bulgaria,Japan,1,1,7,9,03/06/2023,0,0,2,2,3,2,12,17,2,3,1,6,7,2,10,19,2,0,3,5
6544,163256,2023,Bulgaria,Dominican Republic,0,0,10,10,01/06/2023,0,0,0,0,16,4,17,37,1,1,1,3,5,1,25,31,6,0,0,6
6545,163256,2023,Croatia,Bulgaria,0,0,3,3,31/05/2023,0,0,0,0,1,2,2,5,1,0,0,1,1,0,1,2,0,0,0,0
6546,142337,2023,Serbia,Bulgaria,3,1,12,16,02/07/2023,0,0,0,0,3,3,7,13,5,3,5,13,0,0,1,1,4,2,0,6
6547,142337,2023,Bulgaria,Poland,0,1,11,12,30/06/2023,0,0,0,0,7,1,5,13,1,6,3,10,0,0,2,2,3,2,0,5
6548,142337,2023,USA,Bulgaria,0,1,5,6,29/06/2023,0,0,1,1,3,4,3,10,3,2,1,6,0,0,0,0,3,0,0,3
6549,142337,2023,Bulgaria,Korea,1,0,11,12,27/06/2023,0,0,2,2,8,1,8,17,7,4,15,26,2,0,1,3,3,0,0,3
6550,142337,2023,Bulgaria,Netherlands,0,3,5,8,18/06/2023,0,0,1,1,7,3,5,15,5,2,5,12,0,0,0,0,3,2,1,6
6551,142337,2023,Bulgaria,China,0,0,7,7,16/06/2023,0,0,0,0,7,2,4,13,2,3,4,9,0,0,0,0,2,2,0,4
6552,142337,2023,Bulgaria,Canada,0,0,3,3,15/06/2023,0,0,0,0,2,1,3,6,2,1,3,6,1,0,0,1,0,0,0,0
6553,142337,2023,Italy,Bulgaria,0,1,6,7,14/06/2023,0,0,1,1,6,1,3,10,1,5,1,7,0,0,0,0,0,0,0,0
6554,142337,2023,Germany,Bulgaria,0,2,11,13,04/06/2023,0,0,2,2,6,4,6,16,4,2,5,11,0,0,1,1,5,0,0,5
6555,142337,2023,Bulgaria,Japan,0,1,6,7,03/06/2023,0,0,0,0,5,4,2,11,2,2,1,5,1,0,1,2,3,0,1,4
6556,142337,2023,Bulgaria,Dominican Republic,3,1,14,18,01/06/2023,0,0,2,2,3,1,7,11,1,2,0,3,0,0,0,0,4,0,0,4
6557,142337,2023,Croatia,Bulgaria,1,0,8,9,31/05/2023,0,0,1,1,2,0,6,8,6,3,2,11,0,0,0,0,4,0,0,4
6558,164660,2023,Serbia,Bulgaria,1,0,9,10,02/07/2023,1,0,1,2,3,0,3,6,1,1,3,5,1,0,1,2,2,0,0,2
6559,164660,2023,Bulgaria,Poland,0,1,4,5,30/06/2023,0,0,1,1,0,0,4,4,1,4,2,7,0,0,0,0,0,2,0,2
6560,164660,2023,USA,Bulgaria,0,0,8,8,29/06/2023,0,0,1,1,0,0,0,0,0,1,1,2,0,0,0,0,1,0,0,1
6561,164660,2023,Bulgaria,Korea,0,0,9,9,27/06/2023,0,0,0,0,0,0,0,0,0,0,0,0,0,0,0,0,1,0,0,1
6562,164660,2023,Bulgaria,Netherlands,0,0,0,0,18/06/2023,0,0,1,1,0,0,0,0,0,0,0,0,0,0,1,1,0,0,0,0
6563,164660,2023,Bulgaria,China,0,0,0,0,16/06/2023,0,0,0,0,0,0,0,0,0,0,0,0,0,0,0,0,0,0,0,0
6564,164660,2023,Bulgaria,Canada,0,0,2,2,15/06/2023,0,1,3,4,0,1,3,4,0,1,3,4,0,0,0,0,1,2,1,4
6565,164660,2023,Italy,Bulgaria,0,0,0,0,14/06/2023,0,0,0,0,0,0,0,0,0,0,0,0,0,0,0,0,0,0,0,0
6566,164660,2023,Germany,Bulgaria,0,0,0,0,04/06/2023,0,0,0,0,0,0,0,0,0,0,0,0,0,0,0,0,0,0,0,0
6567,164660,2023,Bulgaria,Japan,0,0,4,4,03/06/2023,0,0,4,4,2,0,3,5,0,0,3,3,0,0,0,0,1,0,0,1
6568,164660,2023,Bulgaria,Dominican Republic,0,1,5,6,01/06/2023,0,0,2,2,1,0,2,3,1,4,4,9,0,0,0,0,0,0,1,1
6569,164660,2023,Croatia,Bulgaria,2,2,13,17,31/05/2023,0,0,0,0,0,0,1,1,1,2,2,5,0,0,0,0,2,0,1,3
6570,174478,2023,Serbia,Bulgaria,0,0,0,0,02/07/2023,0,0,10,10,0,0,0,0,0,0,0,0,7,5,27,39,14,7,0,21
6571,174478,2023,Bulgaria,Poland,0,0,0,0,30/06/2023,0,1,10,11,0,0,0,0,0,0,0,0,0,1,12,13,14,9,0,23
6572,174478,2023,USA,Bulgaria,0,0,0,0,29/06/2023,0,0,7,7,0,0,0,0,0,0,0,0,6,4,20,30,12,4,0,16
6573,174478,2023,Bulgaria,Korea,0,0,0,0,27/06/2023,0,0,11,11,0,0,0,0,0,0,0,0,2,4,9,15,23,5,3,31
6574,174478,2023,Bulgaria,Netherlands,0,0,0,0,18/06/2023,0,0,6,6,0,0,0,0,0,0,0,0,1,0,12,13,15,4,2,21
6575,174478,2023,Bulgaria,China,0,0,0,0,16/06/2023,0,0,8,8,0,0,0,0,0,0,0,0,2,2,8,12,7,4,1,12
6576,174478,2023,Bulgaria,Canada,0,0,0,0,15/06/2023,0,0,5,5,0,0,0,0,0,0,0,0,1,1,14,16,9,2,0,11
6577,174478,2023,Italy,Bulgaria,0,0,0,0,14/06/2023,0,0,5,5,0,0,0,0,0,0,0,0,0,0,5,5,14,3,1,18
6578,174478,2023,Germany,Bulgaria,0,0,0,0,04/06/2023,0,0,15,15,0,0,0,0,0,0,0,0,7,1,23,31,25,1,5,31
6579,174478,2023,Bulgaria,Japan,0,0,0,0,03/06/2023,0,0,2,2,0,0,0,0,0,0,0,0,3,0,8,11,9,0,0,9
6580,174478,2023,Bulgaria,Dominican Republic,0,0,0,0,01/06/2023,0,0,9,9,0,0,0,0,0,0,0,0,5,1,9,15,20,2,3,25
6581,174478,2023,Croatia,Bulgaria,0,0,0,0,31/05/2023,0,0,10,10,0,0,0,0,0,0,0,0,3,1,9,13,14,0,4,18
6582,163261,2023,Serbia,Bulgaria,0,0,2,2,02/07/2023,0,0,1,1,1,0,1,2,2,3,2,7,0,0,0,0,1,0,0,1
6583,163261,2023,Bulgaria,Poland,0,2,5,7,30/06/2023,0,0,1,1,0,0,2,2,3,4,4,11,0,0,0,0,0,0,0,0
6584,163261,2023,USA,Bulgaria,0,1,2,3,29/06/2023,0,0,0,0,2,1,1,4,0,0,0,0,0,0,0,0,1,0,0,1
6585,163261,2023,Bulgaria,Korea,2,4,8,14,27/06/2023,0,1,0,1,2,1,3,6,2,8,7,17,0,0,0,0,0,1,1,2
6586,163261,2023,Bulgaria,Netherlands,0,4,7,11,18/06/2023,0,0,1,1,1,0,5,6,0,2,6,8,0,0,0,0,0,0,0,0
6587,163261,2023,Bulgaria,China,0,3,9,12,16/06/2023,0,0,0,0,4,0,0,4,2,3,4,9,0,0,0,0,1,1,2,4
6588,163261,2023,Bulgaria,Canada,2,1,7,10,15/06/2023,0,0,2,2,0,0,2,2,0,2,8,10,0,0,2,2,4,0,1,5
6589,163261,2023,Italy,Bulgaria,1,1,6,8,14/06/2023,0,0,0,0,2,2,1,5,0,2,5,7,0,0,0,0,2,0,0,2
6590,163261,2023,Germany,Bulgaria,1,5,15,21,04/06/2023,0,0,2,2,1,0,3,4,1,1,3,5,0,0,0,0,3,1,0,4
6591,163261,2023,Bulgaria,Japan,2,1,5,8,03/06/2023,0,0,0,0,1,0,5,6,0,2,2,4,0,0,0,0,0,0,0,0
6592,163261,2023,Bulgaria,Dominican Republic,1,0,12,13,01/06/2023,0,0,1,1,2,0,1,3,1,1,0,2,0,0,1,1,2,0,0,2
6593,163261,2023,Croatia,Bulgaria,0,0,0,0,31/05/2023,0,0,0,0,0,0,0,0,0,0,0,0,0,0,0,0,0,0,0,0
6594,163141,2023,Serbia,Bulgaria,0,0,15,15,02/07/2023,0,0,3,3,18,6,24,48,0,3,4,7,0,0,0,0,8,1,1,10
6595,163141,2023,Bulgaria,Poland,1,1,8,10,30/06/2023,0,1,3,4,17,4,27,48,1,2,2,5,0,0,1,1,8,2,0,10
6596,163141,2023,USA,Bulgaria,0,1,6,7,29/06/2023,0,0,1,1,3,2,13,18,0,0,1,1,0,0,0,0,3,1,0,4
6597,163141,2023,Bulgaria,Korea,0,2,12,14,27/06/2023,0,0,1,1,18,7,26,51,1,2,4,7,0,0,0,0,6,3,0,9
6598,163141,2023,Bulgaria,Netherlands,0,0,0,0,18/06/2023,0,0,0,0,0,0,0,0,0,0,0,0,0,0,0,0,0,0,0,0
6599,163141,2023,Bulgaria,China,0,0,4,4,16/06/2023,0,0,0,0,9,1,7,17,1,4,1,6,0,0,0,0,2,1,0,3
6600,163141,2023,Bulgaria,Canada,0,0,2,2,15/06/2023,0,0,2,2,2,3,3,8,0,0,0,0,0,0,0,0,2,1,0,3
6601,163141,2023,Italy,Bulgaria,1,2,7,10,14/06/2023,0,0,0,0,10,2,8,20,0,0,1,1,0,0,0,0,5,2,0,7
6602,163141,2023,Germany,Bulgaria,1,0,18,19,04/06/2023,0,0,0,0,13,7,22,42,1,1,2,4,0,0,0,0,9,0,1,10
6603,163141,2023,Bulgaria,Japan,0,0,2,2,03/06/2023,0,1,0,1,3,1,1,5,0,0,1,1,0,0,0,0,3,0,0,3
6604,163141,2023,Bulgaria,Dominican Republic,1,0,13,14,01/06/2023,0,0,2,2,11,7,25,43,1,2,3,6,0,0,0,0,5,1,2,8
6605,163141,2023,Croatia,Bulgaria,1,2,7,10,31/05/2023,0,0,3,3,11,4,19,34,0,1,0,1,0,0,0,0,6,0,0,6
6606,163144,2023,Serbia,Bulgaria,0,0,0,0,02/07/2023,0,0,1,1,0,1,1,2,0,0,0,0,0,0,0,0,0,0,0,0
6607,163144,2023,Bulgaria,Poland,0,0,0,0,30/06/2023,0,0,0,0,0,0,0,0,0,0,0,0,0,0,0,0,0,0,0,0
6608,163144,2023,USA,Bulgaria,0,0,0,0,29/06/2023,0,0,1,1,0,0,0,0,0,0,0,0,0,0,0,0,0,1,0,1
6609,163144,2023,Bulgaria,Korea,0,0,0,0,27/06/2023,0,0,0,0,0,0,0,0,0,0,0,0,0,0,0,0,0,0,0,0
6610,163144,2023,Bulgaria,Netherlands,0,0,0,0,18/06/2023,0,0,0,0,0,0,0,0,0,0,0,0,0,0,0,0,0,0,0,0
6611,163144,2023,Bulgaria,China,0,0,1,1,16/06/2023,0,0,0,0,2,0,0,2,0,0,0,0,0,1,2,3,0,0,1,1
6612,163144,2023,Bulgaria,Canada,0,0,0,0,15/06/2023,0,0,0,0,0,0,0,0,0,0,0,0,0,0,0,0,0,0,0,0
6613,163144,2023,Italy,Bulgaria,0,0,0,0,14/06/2023,0,0,0,0,0,0,0,0,0,0,0,0,0,0,0,0,0,0,0,0
6614,163144,2023,Germany,Bulgaria,0,0,0,0,04/06/2023,0,0,0,0,0,0,1,1,0,0,0,0,0,0,2,2,2,0,0,2
6615,163144,2023,Bulgaria,Japan,0,0,0,0,03/06/2023,0,0,0,0,0,0,0,0,0,0,0,0,0,0,0,0,0,0,0,0
6616,163144,2023,Bulgaria,Dominican Republic,0,0,0,0,01/06/2023,0,0,0,0,0,0,1,1,0,0,1,1,0,0,3,3,2,0,0,2
6617,163144,2023,Croatia,Bulgaria,0,0,0,0,31/05/2023,0,0,0,0,0,0,0,0,0,0,0,0,0,0,0,0,0,0,0,0
6618,174467,2023,Serbia,Bulgaria,0,0,0,0,02/07/2023,0,0,1,1,0,0,0,0,0,0,0,0,0,1,2,3,1,0,1,2
6619,174467,2023,Bulgaria,Poland,0,0,0,0,30/06/2023,0,0,1,1,0,0,0,0,0,0,0,0,0,2,3,5,2,0,1,3
6620,174467,2023,USA,Bulgaria,0,0,0,0,29/06/2023,0,0,0,0,0,0,0,0,0,0,0,0,0,0,0,0,0,0,0,0
6621,174467,2023,Bulgaria,Korea,0,0,0,0,27/06/2023,0,0,0,0,0,0,0,0,0,0,0,0,0,0,1,1,1,0,0,1
6622,174467,2023,Bulgaria,Netherlands,0,0,0,0,18/06/2023,0,0,0,0,0,0,0,0,0,0,0,0,0,0,2,2,0,0,0,0
6623,174467,2023,Bulgaria,China,0,0,0,0,16/06/2023,0,0,0,0,0,0,0,0,0,0,0,0,0,0,0,0,0,0,0,0
6624,174467,2023,Bulgaria,Canada,0,0,0,0,15/06/2023,0,0,0,0,0,0,0,0,0,0,0,0,1,0,1,2,2,0,0,2
6625,174467,2023,Italy,Bulgaria,0,0,0,0,14/06/2023,0,0,0,0,0,0,0,0,0,0,0,0,0,0,0,0,0,0,0,0
6626,174467,2023,Germany,Bulgaria,0,0,0,0,04/06/2023,0,0,0,0,0,0,0,0,0,0,0,0,0,0,0,0,0,0,0,0
6627,174467,2023,Bulgaria,Japan,0,0,0,0,03/06/2023,0,0,0,0,0,0,0,0,0,0,0,0,2,0,6,8,4,0,1,5
6628,174467,2023,Bulgaria,Dominican Republic,0,0,0,0,01/06/2023,0,0,1,1,0,0,0,0,0,0,0,0,0,0,0,0,0,0,0,0
6629,174467,2023,Croatia,Bulgaria,0,0,0,0,31/05/2023,0,0,0,0,0,0,0,0,0,0,0,0,0,0,0,0,0,0,0,0
6630,174472,2023,Serbia,Bulgaria,0,0,0,0,02/07/2023,0,0,0,0,0,1,0,1,0,0,0,0,0,0,0,0,0,0,0,0
6631,174472,2023,Bulgaria,Poland,0,0,2,2,30/06/2023,0,0,0,0,0,2,0,2,0,0,0,0,0,0,0,0,0,1,0,1
6632,174472,2023,USA,Bulgaria,0,0,1,1,29/06/2023,0,0,0,0,0,1,0,1,0,0,0,0,0,0,0,0,0,0,0,0
6633,174472,2023,Bulgaria,Korea,0,0,0,0,27/06/2023,0,0,0,0,0,0,0,0,0,0,0,0,0,0,0,0,0,0,0,0
6634,174472,2023,Bulgaria,Netherlands,3,4,7,14,18/06/2023,0,0,2,2,14,8,10,32,0,2,0,2,0,0,0,0,5,0,1,6
6635,174472,2023,Bulgaria,China,0,0,5,5,16/06/2023,0,0,0,0,2,1,6,9,0,1,0,1,0,1,0,1,3,0,0,3
6636,174472,2023,Bulgaria,Canada,1,2,2,5,15/06/2023,0,0,3,3,1,4,5,10,0,1,0,1,0,0,0,0,2,0,0,2
6637,174472,2023,Italy,Bulgaria,0,0,3,3,14/06/2023,0,0,0,0,1,2,4,7,1,0,0,1,0,0,0,0,2,0,0,2
6638,174472,2023,Germany,Bulgaria,0,0,1,1,04/06/2023,0,0,0,0,3,0,0,3,0,0,0,0,0,0,0,0,0,0,0,0
6639,174472,2023,Bulgaria,Japan,0,1,7,8,03/06/2023,0,0,1,1,7,7,9,23,0,3,2,5,0,0,1,1,5,1,0,6
6640,174472,2023,Bulgaria,Dominican Republic,1,0,2,3,01/06/2023,0,0,0,0,3,1,1,5,0,0,0,0,0,0,0,0,1,0,0,1
6641,174472,2023,Croatia,Bulgaria,0,0,0,0,31/05/2023,0,0,0,0,0,0,0,0,0,0,0,0,0,0,0,0,0,0,0,0
6642,168355,2023,Netherlands,Canada,2,3,12,17,01/07/2023,0,0,4,4,8,7,8,23,3,4,4,11,0,0,0,0,10,4,2,16
6643,168355,2023,Canada,Italy,2,5,5,12,30/06/2023,0,0,4,4,12,7,13,32,1,3,2,6,0,0,0,0,5,4,3,12
6644,168355,2023,Brazil,Canada,1,2,16,19,29/06/2023,0,0,1,1,15,7,11,33,3,1,7,11,0,0,0,0,15,1,3,19
6645,168355,2023,Croatia,Canada,1,1,8,10,27/06/2023,0,0,3,3,9,5,14,28,1,6,0,7,0,0,0,0,8,5,0,13
6646,168355,2023,Dominican Republic,Canada,0,3,7,10,17/06/2023,0,0,4,4,9,8,12,29,1,2,5,8,0,0,0,0,5,0,0,5
6647,168355,2023,Türkiye,Canada,0,4,3,7,16/06/2023,0,0,1,1,9,6,12,27,1,3,2,6,0,0,0,0,7,3,1,11
6648,168355,2023,Bulgaria,Canada,1,2,5,8,15/06/2023,0,0,1,1,12,1,6,19,2,3,9,14,0,0,0,0,5,2,2,9
6649,168355,2023,China,Canada,0,7,4,11,13/06/2023,0,1,2,3,10,10,10,30,0,2,2,4,0,0,0,0,6,6,1,13
6650,175158,2023,Netherlands,Canada,0,0,0,0,01/07/2023,0,0,0,0,0,0,0,0,0,0,0,0,0,0,0,0,0,0,0,0
6651,175158,2023,Canada,Italy,0,0,0,0,30/06/2023,0,0,0,0,0,0,0,0,0,0,0,0,0,0,0,0,0,0,0,0
6652,175158,2023,Brazil,Canada,0,0,0,0,29/06/2023,0,0,0,0,0,0,0,0,0,0,0,0,0,0,0,0,0,0,0,0
6653,175158,2023,Croatia,Canada,0,0,0,0,27/06/2023,0,0,12,12,0,0,0,0,0,0,0,0,1,0,15,16,7,2,2,11
6654,175158,2023,Dominican Republic,Canada,0,0,0,0,17/06/2023,0,0,15,15,0,0,0,0,0,0,0,0,4,1,26,31,12,2,0,14
6655,175158,2023,Türkiye,Canada,0,0,0,0,16/06/2023,0,0,7,7,0,0,0,0,0,0,0,0,0,0,5,5,3,1,2,6
6656,175158,2023,Bulgaria,Canada,0,0,0,0,15/06/2023,0,0,6,6,0,0,0,0,0,0,0,0,1,1,6,8,6,2,0,8
6657,175158,2023,China,Canada,0,0,0,0,13/06/2023,0,0,10,10,0,0,0,0,0,0,0,0,0,0,8,8,8,3,1,12
6658,175158,2023,Canada,Serbia,0,0,0,0,04/06/2023,0,0,0,0,0,0,0,0,0,0,0,0,0,0,0,0,0,0,0,0
6659,175158,2023,Canada,Korea,0,0,0,0,02/06/2023,0,0,4,4,0,0,0,0,0,0,0,0,0,0,9,9,9,4,0,13
6660,175158,2023,Canada,Thailand,0,0,0,0,01/06/2023,1,0,9,10,0,0,0,0,0,0,0,0,2,1,7,10,9,7,2,18
6661,175158,2023,Poland,Canada,0,0,0,0,30/05/2023,0,0,20,20,0,0,0,0,0,0,0,0,0,1,16,17,23,4,2,29
6662,153629,2023,Netherlands,Canada,0,2,13,15,01/07/2023,0,0,4,4,5,2,7,14,6,2,4,12,0,0,1,1,2,2,0,4
6663,153629,2023,Canada,Italy,0,0,10,10,30/06/2023,0,0,2,2,3,0,8,11,1,4,5,10,0,0,0,0,1,3,1,5
6664,153629,2023,Brazil,Canada,1,2,19,22,29/06/2023,0,0,2,2,7,3,3,13,4,6,3,13,0,0,1,1,1,0,0,1
6665,153629,2023,Croatia,Canada,1,1,12,14,27/06/2023,0,1,3,4,5,2,5,12,4,5,6,15,0,0,0,0,7,1,0,8
6666,153629,2023,Dominican Republic,Canada,1,1,1,3,17/06/2023,0,0,2,2,1,1,4,6,1,1,2,4,0,0,0,0,2,0,0,2
6667,153629,2023,Türkiye,Canada,0,0,6,6,16/06/2023,0,0,0,0,1,0,3,4,0,2,1,3,0,0,0,0,2,0,0,2
6668,153629,2023,Bulgaria,Canada,0,2,6,8,15/06/2023,0,0,1,1,3,1,2,6,3,3,5,11,0,0,0,0,0,0,0,0
6669,153629,2023,China,Canada,0,0,0,0,13/06/2023,0,0,0,0,0,0,0,0,0,0,0,0,0,0,0,0,0,0,0,0
6670,153629,2023,Canada,Serbia,0,1,13,14,04/06/2023,0,0,3,3,8,0,6,14,1,5,4,10,0,0,2,2,2,1,0,3
6671,153629,2023,Canada,Korea,0,0,0,0,02/06/2023,0,0,0,0,0,0,0,0,0,0,0,0,0,0,0,0,0,0,0,0
6672,153629,2023,Canada,Thailand,0,0,0,0,01/06/2023,0,0,0,0,0,0,0,0,0,0,0,0,0,0,0,0,0,0,0,0
6673,153629,2023,Poland,Canada,0,0,10,10,30/05/2023,0,0,2,2,0,3,4,7,1,1,5,7,0,0,0,0,1,0,0,1
6674,163360,2023,Netherlands,Canada,0,0,0,0,01/07/2023,0,0,0,0,0,0,0,0,0,0,0,0,0,0,0,0,0,0,0,0
6675,163360,2023,Canada,Italy,0,1,5,6,30/06/2023,0,0,0,0,2,0,1,3,1,1,1,3,0,0,1,1,2,0,0,2
6676,163360,2023,Brazil,Canada,0,0,0,0,29/06/2023,0,0,0,0,0,0,0,0,0,0,0,0,0,0,0,0,0,0,0,0
6677,163360,2023,Croatia,Canada,0,0,0,0,27/06/2023,0,0,0,0,0,0,0,0,0,0,0,0,0,0,0,0,0,0,0,0
6678,163360,2023,Dominican Republic,Canada,0,1,1,2,17/06/2023,0,0,0,0,1,3,1,5,0,2,3,5,0,0,0,0,0,0,0,0
6679,163360,2023,Türkiye,Canada,0,0,0,0,16/06/2023,0,0,0,0,0,0,0,0,0,0,0,0,0,0,0,0,0,0,0,0
6680,163360,2023,Bulgaria,Canada,0,1,1,2,15/06/2023,0,0,0,0,0,0,0,0,0,0,1,1,0,0,0,0,0,0,0,0
6681,163360,2023,China,Canada,0,1,3,4,13/06/2023,0,0,0,0,3,0,2,5,0,1,1,2,0,0,0,0,0,0,0,0
6682,163360,2023,Canada,Serbia,0,1,0,1,04/06/2023,0,0,0,0,0,2,1,3,1,1,2,4,0,0,0,0,0,0,0,0
6683,163360,2023,Canada,Korea,0,1,3,4,02/06/2023,0,0,1,1,13,2,3,18,5,4,6,15,0,0,0,0,4,1,1,6
6684,163360,2023,Canada,Thailand,0,1,7,8,01/06/2023,1,0,1,2,6,4,5,15,4,4,3,11,0,0,0,0,1,1,0,2
6685,163360,2023,Poland,Canada,0,1,3,4,30/05/2023,0,0,1,1,2,0,1,3,1,4,3,8,0,0,0,0,0,0,0,0
6686,142777,2023,Netherlands,Canada,0,0,0,0,01/07/2023,0,0,0,0,0,0,0,0,0,0,0,0,0,0,0,0,0,0,0,0
6687,142777,2023,Canada,Italy,0,0,1,1,30/06/2023,0,0,0,0,0,0,0,0,0,0,0,0,0,0,0,0,0,0,0,0
6688,142777,2023,Brazil,Canada,0,0,0,0,29/06/2023,0,0,0,0,0,0,0,0,0,0,0,0,0,0,0,0,0,0,0,0
6689,142777,2023,Croatia,Canada,0,0,1,1,27/06/2023,0,0,1,1,0,0,1,1,1,3,0,4,0,0,0,0,0,0,0,0
6690,142777,2023,Dominican Republic,Canada,0,1,11,12,17/06/2023,0,0,2,2,0,1,0,1,1,2,3,6,0,0,0,0,3,2,0,5
6691,142777,2023,Türkiye,Canada,0,1,3,4,16/06/2023,0,0,3,3,1,0,3,4,1,1,2,4,0,0,0,0,3,0,0,3
6692,142777,2023,Bulgaria,Canada,0,0,0,0,15/06/2023,0,0,0,0,0,0,0,0,0,0,0,0,0,0,0,0,0,0,0,0
6693,142777,2023,China,Canada,0,0,5,5,13/06/2023,0,1,3,4,0,0,0,0,0,0,1,1,1,0,0,1,2,0,0,2
6694,132236,2023,Netherlands,Canada,1,1,15,17,01/07/2023,0,0,6,6,23,11,17,51,1,2,2,5,6,0,18,24,10,3,1,14
6695,132236,2023,Canada,Italy,1,3,9,13,30/06/2023,0,0,4,4,16,8,19,43,1,1,5,7,9,2,37,48,10,2,0,12
6696,132236,2023,Brazil,Canada,1,2,15,18,29/06/2023,0,0,6,6,22,8,27,57,2,0,1,3,16,1,54,71,6,2,1,9
6697,132236,2023,Croatia,Canada,0,0,10,10,27/06/2023,0,0,2,2,17,2,26,45,3,2,3,8,3,0,16,19,10,0,2,12
6698,132236,2023,Dominican Republic,Canada,1,3,14,18,17/06/2023,0,1,2,3,19,7,25,51,1,4,5,10,7,0,48,55,14,2,0,16
6699,132236,2023,Türkiye,Canada,0,1,6,7,16/06/2023,0,0,1,1,17,7,13,37,0,4,1,5,7,1,31,39,1,1,0,2
6700,132236,2023,Bulgaria,Canada,2,0,20,22,15/06/2023,0,0,2,2,9,2,8,19,0,2,1,3,0,0,25,25,6,1,3,10
6701,132236,2023,China,Canada,0,0,8,8,13/06/2023,0,0,3,3,12,6,9,27,1,1,0,2,0,3,26,29,6,5,4,15
6702,132236,2023,Canada,Serbia,2,2,13,17,04/06/2023,0,0,4,4,20,6,39,65,1,3,1,5,9,2,47,58,11,4,0,15
6703,132236,2023,Canada,Korea,1,0,11,12,02/06/2023,0,0,1,1,9,2,4,15,1,0,4,5,2,1,20,23,9,4,1,14
6704,132236,2023,Canada,Thailand,1,1,12,14,01/06/2023,0,0,0,0,8,2,25,35,1,1,7,9,5,4,37,46,8,6,0,14
6705,132236,2023,Poland,Canada,0,3,24,27,30/05/2023,0,0,2,2,36,6,29,71,1,4,6,11,8,2,34,44,12,3,3,18
6706,173581,2023,Netherlands,Canada,1,0,4,5,01/07/2023,0,0,0,0,1,2,7,10,1,0,0,1,1,0,9,10,2,1,0,3
6707,173581,2023,Canada,Italy,0,0,13,13,30/06/2023,0,0,0,0,8,4,9,21,0,0,2,2,2,0,8,10,7,3,1,11
6708,173581,2023,Brazil,Canada,0,0,12,12,29/06/2023,0,1,1,2,8,1,15,24,0,1,2,3,3,0,6,9,11,0,1,12
6709,173581,2023,Croatia,Canada,2,0,12,14,27/06/2023,0,0,1,1,2,4,8,14,0,0,1,1,1,0,14,15,6,1,1,8
6710,173581,2023,Dominican Republic,Canada,0,1,0,1,17/06/2023,0,0,0,0,2,2,2,6,0,1,2,3,0,0,1,1,1,0,0,1
6711,173581,2023,Türkiye,Canada,0,0,1,1,16/06/2023,0,0,0,0,0,0,0,0,0,0,0,0,0,1,2,3,0,0,0,0
6712,173581,2023,Bulgaria,Canada,0,0,1,1,15/06/2023,0,0,0,0,0,0,1,1,0,0,0,0,0,0,0,0,1,0,1,2
6713,173581,2023,China,Canada,0,1,0,1,13/06/2023,0,0,0,0,0,0,0,0,0,1,0,1,0,0,0,0,1,0,0,1
6714,173581,2023,Canada,Serbia,0,0,2,2,04/06/2023,0,0,0,0,2,0,5,7,0,1,1,2,1,0,0,1,2,2,0,4
6715,173581,2023,Canada,Korea,1,0,9,10,02/06/2023,0,0,1,1,5,2,5,12,1,0,3,4,2,0,9,11,3,3,2,8
6716,173581,2023,Canada,Thailand,0,2,4,6,01/06/2023,1,0,5,6,8,2,9,19,0,2,1,3,2,1,6,9,11,2,1,14
6717,173581,2023,Poland,Canada,0,0,7,7,30/05/2023,0,0,1,1,5,4,5,14,0,2,2,4,2,0,10,12,9,0,2,11
6718,173585,2023,Netherlands,Canada,0,0,17,17,01/07/2023,20,1,95,116,1,1,0,2,0,3,4,7,0,1,0,1,10,1,1,12
6719,173585,2023,Canada,Italy,0,0,17,17,30/06/2023,23,2,96,121,1,1,0,2,1,2,2,5,0,0,0,0,7,3,1,11
6720,173585,2023,Brazil,Canada,0,1,20,21,29/06/2023,29,1,115,145,2,0,1,3,1,2,7,10,0,0,1,1,9,5,3,17
6721,173585,2023,Croatia,Canada,0,1,11,12,27/06/2023,22,1,74,97,3,0,3,6,0,2,4,6,0,0,0,0,10,1,2,13
6722,173585,2023,Dominican Republic,Canada,1,0,12,13,17/06/2023,43,0,87,130,2,1,3,6,0,4,2,6,0,0,0,0,15,7,2,24
6723,173585,2023,Türkiye,Canada,1,1,12,14,16/06/2023,8,2,61,71,0,1,2,3,1,2,1,4,0,0,0,0,9,2,1,12
6724,173585,2023,Bulgaria,Canada,0,0,13,13,15/06/2023,14,0,33,47,0,0,1,1,3,1,1,5,0,1,0,1,11,2,2,15
6725,173585,2023,China,Canada,2,0,7,9,13/06/2023,23,1,55,79,0,0,3,3,1,0,2,3,0,1,0,1,10,5,0,15
6726,173585,2023,Canada,Serbia,1,1,22,24,04/06/2023,14,3,126,143,4,1,2,7,1,6,3,10,0,0,0,0,11,2,0,13
6727,173585,2023,Canada,Korea,0,1,11,12,02/06/2023,19,1,48,68,2,1,1,4,0,1,3,4,0,0,0,0,4,2,1,7
6728,173585,2023,Canada,Thailand,0,0,12,12,01/06/2023,29,3,60,92,0,0,0,0,1,1,4,6,0,0,0,0,10,6,2,18
6729,173585,2023,Poland,Canada,2,1,18,21,30/05/2023,22,1,94,117,3,0,3,6,2,7,3,12,0,0,0,0,10,5,1,16
6730,174676,2023,Netherlands,Canada,0,3,14,17,01/07/2023,0,0,3,3,10,7,10,27,1,1,1,3,5,1,15,21,12,1,1,14
6731,174676,2023,Canada,Italy,2,0,9,11,30/06/2023,0,0,1,1,4,5,4,13,1,1,0,2,1,1,5,7,4,2,1,7
6732,174676,2023,Brazil,Canada,0,0,6,6,29/06/2023,0,0,1,1,5,3,6,14,3,1,0,4,0,1,5,6,6,1,0,7
6733,174676,2023,Croatia,Canada,0,0,1,1,27/06/2023,0,0,0,0,1,2,6,9,1,0,1,2,1,2,9,12,2,0,0,2
6734,174676,2023,Dominican Republic,Canada,0,1,13,14,17/06/2023,0,0,3,3,12,11,15,38,3,4,3,10,0,0,9,9,3,2,1,6
6735,174676,2023,Türkiye,Canada,1,2,6,9,16/06/2023,0,0,1,1,5,2,7,14,0,3,1,4,1,1,14,16,2,1,0,3
6736,174676,2023,Bulgaria,Canada,1,1,6,8,15/06/2023,0,0,0,0,9,0,9,18,3,0,3,6,0,0,1,1,3,1,0,4
6737,174676,2023,China,Canada,0,1,11,12,13/06/2023,0,0,2,2,11,2,11,24,1,2,1,4,2,1,27,30,4,3,4,11
6738,174676,2023,Canada,Serbia,0,2,11,13,04/06/2023,0,0,2,2,18,6,26,50,6,5,0,11,2,2,21,25,12,5,2,19
6739,174676,2023,Canada,Korea,1,0,8,9,02/06/2023,0,0,0,0,6,2,9,17,2,3,6,11,0,0,0,0,5,2,1,8
6740,174676,2023,Canada,Thailand,0,0,3,3,01/06/2023,0,0,1,1,7,2,9,18,1,2,2,5,0,0,1,1,7,4,1,12
6741,174676,2023,Poland,Canada,0,2,13,15,30/05/2023,0,0,4,4,13,9,21,43,2,2,6,10,1,0,11,12,5,3,2,10
6742,166581,2023,Netherlands,Canada,0,0,2,2,01/07/2023,0,0,2,2,0,0,1,1,0,1,0,1,0,0,1,1,1,0,0,1
6743,166581,2023,Canada,Italy,0,0,1,1,30/06/2023,0,0,0,0,0,0,1,1,0,0,0,0,0,0,0,0,0,0,0,0
6744,166581,2023,Brazil,Canada,0,0,0,0,29/06/2023,0,0,0,0,0,0,0,0,0,0,0,0,0,0,0,0,0,0,0,0
6745,166581,2023,Croatia,Canada,0,0,0,0,27/06/2023,0,0,0,0,0,0,0,0,0,0,0,0,0,0,0,0,0,0,0,0
6746,166581,2023,Dominican Republic,Canada,0,0,3,3,17/06/2023,0,0,1,1,2,3,4,9,0,0,0,0,0,0,0,0,3,1,0,4
6747,166581,2023,Türkiye,Canada,0,0,0,0,16/06/2023,0,0,0,0,0,0,0,0,0,0,0,0,0,0,0,0,0,0,0,0
6748,166581,2023,Bulgaria,Canada,0,0,0,0,15/06/2023,0,0,0,0,1,0,1,2,0,1,1,2,0,0,0,0,0,1,0,1
6749,166581,2023,China,Canada,0,0,0,0,13/06/2023,0,0,0,0,0,0,0,0,0,0,0,0,0,0,0,0,0,0,0,0
6750,166581,2023,Canada,Serbia,0,1,12,13,04/06/2023,0,0,2,2,7,1,9,17,0,3,4,7,0,0,0,0,6,8,0,14
6751,166581,2023,Canada,Korea,0,0,1,1,02/06/2023,0,0,0,0,3,0,1,4,0,2,1,3,0,0,0,0,0,0,1,1
6752,166581,2023,Canada,Thailand,0,0,0,0,01/06/2023,0,0,0,0,0,1,2,3,0,1,1,2,0,0,0,0,0,1,0,1
6753,166581,2023,Poland,Canada,0,0,0,0,30/05/2023,0,0,0,0,0,0,0,0,0,0,0,0,0,0,0,0,0,0,0,0
6754,174680,2023,Netherlands,Canada,0,0,0,0,01/07/2023,0,0,0,0,0,0,0,0,0,0,0,0,0,0,0,0,0,0,0,0
6755,174680,2023,Canada,Italy,0,0,1,1,30/06/2023,0,0,0,0,0,0,0,0,0,0,0,0,0,0,0,0,1,0,0,1
6756,174680,2023,Brazil,Canada,0,0,1,1,29/06/2023,0,0,0,0,0,0,0,0,0,0,0,0,0,0,0,0,0,0,0,0
6757,174680,2023,Croatia,Canada,0,0,0,0,27/06/2023,0,0,0,0,0,0,0,0,0,0,0,0,2,0,2,4,0,0,0,0
6758,174680,2023,Dominican Republic,Canada,0,0,3,3,17/06/2023,0,0,0,0,0,0,0,0,0,0,0,0,0,0,0,0,1,0,0,1
6759,174680,2023,Türkiye,Canada,0,0,1,1,16/06/2023,0,0,0,0,0,0,0,0,0,0,0,0,0,0,0,0,0,1,0,1
6760,174680,2023,Bulgaria,Canada,0,0,2,2,15/06/2023,0,0,0,0,0,0,0,0,0,0,0,0,0,0,0,0,0,0,0,0
6761,174680,2023,China,Canada,0,0,3,3,13/06/2023,0,0,1,1,0,0,0,0,0,0,0,0,0,0,0,0,0,1,0,1
6762,174680,2023,Canada,Serbia,0,1,0,1,04/06/2023,0,0,0,0,0,0,0,0,0,0,0,0,0,0,0,0,0,0,0,0
6763,174680,2023,Canada,Korea,0,1,1,2,02/06/2023,0,0,0,0,0,0,0,0,0,0,0,0,0,0,0,0,0,0,0,0
6764,174680,2023,Canada,Thailand,0,0,6,6,01/06/2023,0,0,0,0,0,0,0,0,0,0,0,0,0,0,1,1,0,1,0,1
6765,174680,2023,Poland,Canada,0,1,3,4,30/05/2023,0,0,1,1,0,0,0,0,0,0,0,0,0,0,0,0,0,0,0,0
6766,192389,2023,Netherlands,Canada,0,0,0,0,01/07/2023,0,0,12,12,0,0,0,0,0,0,0,0,7,1,16,24,10,4,1,15
6767,192389,2023,Canada,Italy,0,0,0,0,30/06/2023,0,0,9,9,0,0,0,0,0,0,0,0,8,3,16,27,13,6,3,22
6768,192389,2023,Brazil,Canada,0,0,0,0,29/06/2023,0,0,8,8,0,0,0,0,0,0,0,0,4,2,9,15,9,7,1,17
6769,192389,2023,Croatia,Canada,0,0,0,0,27/06/2023,0,0,0,0,0,0,0,0,0,0,0,0,0,0,0,0,0,0,0,0
6770,192389,2023,Canada,Serbia,0,0,0,0,04/06/2023,0,0,19,19,0,0,0,0,0,0,0,0,4,1,15,20,12,5,1,18
6771,192389,2023,Canada,Korea,0,0,0,0,02/06/2023,0,0,0,0,0,0,0,0,0,0,0,0,0,0,0,0,0,0,0,0
6772,192389,2023,Canada,Thailand,0,0,0,0,01/06/2023,0,0,0,0,0,0,0,0,0,0,0,0,0,0,0,0,0,0,0,0
6773,192389,2023,Poland,Canada,0,0,0,0,30/05/2023,0,0,0,0,0,0,0,0,0,0,0,0,0,0,0,0,0,0,0,0
6774,168354,2023,Netherlands,Canada,1,0,16,17,01/07/2023,0,0,1,1,9,1,6,16,4,1,4,9,0,0,4,4,2,0,0,2
6775,168354,2023,Canada,Italy,2,1,10,13,30/06/2023,0,0,0,0,7,2,2,11,4,5,3,12,2,0,1,3,0,0,0,0
6776,168354,2023,Brazil,Canada,0,3,15,18,29/06/2023,0,0,3,3,5,1,14,20,8,5,11,24,0,0,0,0,3,1,2,6
6777,168354,2023,Croatia,Canada,0,1,13,14,27/06/2023,0,0,3,3,5,1,2,8,3,3,4,10,0,0,0,0,3,0,2,5
6778,168354,2023,Dominican Republic,Canada,0,1,10,11,17/06/2023,0,0,0,0,9,2,5,16,2,8,7,17,0,0,1,1,5,0,0,5
6779,168354,2023,Türkiye,Canada,0,2,7,9,16/06/2023,0,0,1,1,2,1,3,6,2,1,6,9,0,0,0,0,0,0,0,0
6780,168354,2023,Bulgaria,Canada,0,1,8,9,15/06/2023,0,0,3,3,4,1,3,8,2,2,7,11,0,0,0,0,4,0,0,4
6781,168354,2023,China,Canada,0,3,6,9,13/06/2023,0,0,2,2,5,1,5,11,0,2,1,3,0,0,0,0,3,1,0,4
6782,168354,2023,Canada,Serbia,1,4,13,18,04/06/2023,0,0,4,4,6,4,8,18,3,8,11,22,0,0,0,0,4,1,1,6
6783,168354,2023,Canada,Korea,0,1,20,21,02/06/2023,0,0,1,1,4,0,5,9,2,3,3,8,0,0,1,1,1,4,5,10
6784,168354,2023,Canada,Thailand,0,0,10,10,01/06/2023,1,0,1,2,5,2,7,14,4,3,3,10,0,0,0,0,3,0,0,3
6785,168354,2023,Poland,Canada,0,3,8,11,30/05/2023,0,0,1,1,5,2,3,10,1,8,15,24,1,0,3,4,6,0,1,7
6786,183258,2023,Netherlands,Canada,0,0,0,0,01/07/2023,0,0,0,0,0,0,0,0,0,0,0,0,0,0,0,0,0,0,0,0
6787,183258,2023,Canada,Italy,0,0,0,0,30/06/2023,0,0,0,0,0,0,0,0,0,0,0,0,0,0,0,0,0,0,0,0
6788,183258,2023,Brazil,Canada,0,0,0,0,29/06/2023,0,0,0,0,0,0,0,0,0,0,0,0,0,0,0,0,0,0,0,0
6789,183258,2023,Croatia,Canada,0,0,0,0,27/06/2023,0,0,0,0,0,0,0,0,0,0,0,0,0,0,0,0,0,0,0,0
6790,183258,2023,Dominican Republic,Canada,0,0,0,0,17/06/2023,0,0,0,0,0,0,0,0,0,0,0,0,0,0,0,0,0,0,0,0
6791,183258,2023,Türkiye,Canada,0,0,0,0,16/06/2023,0,0,0,0,0,0,0,0,0,0,0,0,0,0,0,0,0,0,0,0
6792,183258,2023,Bulgaria,Canada,0,0,0,0,15/06/2023,1,0,4,5,0,0,0,0,0,0,0,0,0,0,0,0,0,0,1,1
6793,183258,2023,China,Canada,0,0,0,0,13/06/2023,0,0,0,0,0,0,0,0,0,0,0,0,0,0,0,0,0,0,0,0
6794,135746,2023,China,Türkiye,1,2,9,12,16/07/2023,0,0,1,1,9,3,9,21,1,2,3,6,0,0,0,0,3,0,1,4
6795,135746,2023,Poland,China,1,0,7,8,15/07/2023,0,0,1,1,10,0,2,12,2,6,6,14,0,0,0,0,0,1,0,1
6796,135746,2023,Brazil,China,0,2,10,12,13/07/2023,0,0,2,2,6,1,12,19,7,6,6,19,0,0,0,0,2,0,0,2
6797,135746,2023,China,USA,1,0,10,11,02/07/2023,0,0,1,1,9,0,6,15,3,6,4,13,0,0,2,2,0,3,2,5
6798,135746,2023,Korea,China,1,1,12,14,01/07/2023,0,0,3,3,13,1,9,23,4,6,8,18,1,0,0,1,2,0,1,3
6799,135746,2023,China,Dominican Republic,1,0,11,12,30/06/2023,0,0,3,3,13,3,7,23,2,5,6,13,0,0,0,0,3,4,0,7
6800,135746,2023,China,Serbia,1,1,10,12,28/06/2023,0,0,4,4,9,2,6,17,3,8,2,13,0,0,1,1,2,1,0,3
6801,135746,2023,Italy,China,1,1,14,16,18/06/2023,0,0,2,2,13,0,9,22,1,5,4,10,0,0,0,0,3,2,1,6
6802,135746,2023,Poland,China,0,1,10,11,17/06/2023,0,1,2,3,7,1,2,10,0,5,3,8,0,0,1,1,0,1,0,1
6803,135746,2023,Bulgaria,China,0,0,9,9,16/06/2023,0,0,2,2,10,1,6,17,3,3,3,9,1,0,0,1,1,0,0,1
6804,135746,2023,China,Canada,0,1,6,7,13/06/2023,0,0,0,0,6,0,2,8,3,4,3,10,0,0,1,1,1,0,0,1
6805,135746,2023,Japan,China,2,0,8,10,04/06/2023,0,0,3,3,7,2,7,16,1,4,5,10,0,0,2,2,2,0,0,2
6806,135746,2023,China,Netherlands,0,2,9,11,03/06/2023,0,0,2,2,8,0,7,15,3,1,2,6,0,0,1,1,2,0,0,2
6807,135746,2023,China,Germany,0,2,7,9,02/06/2023,0,0,0,0,7,0,6,13,4,2,4,10,0,0,0,0,6,0,1,7
6808,135746,2023,China,Brazil,0,1,14,15,31/05/2023,0,0,1,1,9,2,10,21,3,3,2,8,0,0,0,0,3,0,1,4
6809,162354,2023,China,Türkiye,0,1,6,7,16/07/2023,21,0,64,85,1,1,1,3,0,0,5,5,0,0,0,0,4,1,0,5
6810,162354,2023,Poland,China,0,1,10,11,15/07/2023,26,1,32,59,0,0,2,2,0,4,3,7,0,0,0,0,5,1,0,6
6811,162354,2023,Brazil,China,0,1,11,12,13/07/2023,24,0,65,89,0,1,1,2,3,4,5,12,0,0,0,0,12,8,1,21
6812,162354,2023,China,USA,0,0,12,12,02/07/2023,15,1,81,97,1,0,0,1,2,4,2,8,0,0,2,2,5,6,4,15
6813,162354,2023,Korea,China,2,0,21,23,01/07/2023,28,2,50,80,1,0,2,3,0,4,4,8,0,0,0,0,3,0,1,4
6814,162354,2023,China,Dominican Republic,0,0,10,10,30/06/2023,33,0,58,91,0,0,0,0,0,4,2,6,0,0,1,1,7,3,0,10
6815,162354,2023,China,Serbia,2,0,10,12,28/06/2023,29,2,57,88,1,0,1,2,0,3,4,7,0,0,0,0,3,5,1,9
6816,162354,2023,Italy,China,0,0,22,22,18/06/2023,36,2,78,116,2,0,3,5,1,3,1,5,0,0,0,0,8,3,2,13
6817,162354,2023,Poland,China,0,0,8,8,17/06/2023,24,0,44,68,0,0,0,0,0,4,2,6,0,0,0,0,7,2,0,9
6818,162354,2023,Bulgaria,China,3,0,18,21,16/06/2023,34,0,46,80,1,0,0,1,0,3,3,6,0,0,0,0,4,2,1,7
6819,162354,2023,China,Canada,2,1,17,20,13/06/2023,20,1,40,61,1,0,2,3,0,4,3,7,0,0,0,0,4,5,2,11
6820,162354,2023,Japan,China,0,0,7,7,04/06/2023,2,0,79,81,0,1,0,1,4,3,0,7,0,0,1,1,6,0,1,7
6821,162354,2023,China,Netherlands,0,1,14,15,03/06/2023,8,1,92,101,0,0,1,1,1,0,3,4,0,0,2,2,13,0,3,16
6822,162354,2023,China,Germany,0,0,13,13,02/06/2023,10,0,64,74,0,0,0,0,0,0,0,0,0,0,0,0,9,1,1,11
6823,162354,2023,China,Brazil,1,2,15,18,31/05/2023,12,2,108,122,0,0,1,1,1,1,2,4,0,0,0,0,4,0,3,7
6824,152337,2023,China,Türkiye,0,1,0,1,16/07/2023,0,0,0,0,0,1,0,1,0,1,0,1,0,0,0,0,0,0,0,0
6825,152337,2023,Poland,China,0,0,0,0,15/07/2023,0,0,0,0,0,0,0,0,0,0,0,0,0,0,0,0,0,0,0,0
6826,152337,2023,Brazil,China,0,0,0,0,13/07/2023,0,0,0,0,0,0,0,0,0,0,0,0,0,0,0,0,0,0,0,0
6827,152337,2023,China,USA,0,0,0,0,02/07/2023,0,0,0,0,0,0,0,0,0,0,0,0,0,0,0,0,0,0,0,0
6828,152337,2023,Korea,China,0,0,1,1,01/07/2023,0,0,0,0,0,0,2,2,0,1,0,1,0,0,0,0,0,1,0,1
6829,152337,2023,China,Dominican Republic,0,1,7,8,30/06/2023,0,0,1,1,1,1,5,7,0,2,0,2,0,1,0,1,0,2,0,2
6830,152337,2023,China,Serbia,0,0,11,11,28/06/2023,0,0,2,2,8,1,2,11,3,5,5,13,3,0,1,4,0,0,2,2
6831,152337,2023,Italy,China,0,0,0,0,18/06/2023,0,0,0,0,0,0,0,0,0,0,0,0,0,0,0,0,0,0,0,0
6832,152337,2023,Poland,China,0,0,6,6,17/06/2023,0,0,1,1,1,0,5,6,1,5,3,9,0,0,1,1,1,1,0,2
6833,152337,2023,Bulgaria,China,0,0,0,0,16/06/2023,0,0,0,0,1,0,0,1,0,0,0,0,0,0,0,0,0,0,0,0
6834,152337,2023,China,Canada,0,0,0,0,13/06/2023,0,0,0,0,0,0,0,0,0,0,0,0,0,0,0,0,0,0,0,0
6835,152337,2023,Japan,China,0,0,0,0,04/06/2023,0,0,0,0,0,0,0,0,0,0,0,0,0,0,0,0,0,0,0,0
6836,152337,2023,China,Netherlands,0,0,0,0,03/06/2023,0,0,0,0,0,0,0,0,0,0,0,0,0,0,0,0,0,0,0,0
6837,152337,2023,China,Germany,0,0,0,0,02/06/2023,0,0,0,0,0,0,0,0,0,0,0,0,0,0,0,0,0,0,0,0
6838,152337,2023,China,Brazil,0,0,0,0,31/05/2023,0,0,0,0,0,0,0,0,0,0,0,0,0,0,0,0,0,0,0,0
6839,152332,2023,China,Türkiye,0,1,0,1,16/07/2023,0,0,1,1,0,0,1,1,0,0,0,0,0,0,0,0,0,0,0,0
6840,152332,2023,Poland,China,0,0,0,0,15/07/2023,0,0,0,0,0,0,0,0,0,0,0,0,0,0,0,0,0,0,0,0
6841,152332,2023,Brazil,China,0,0,0,0,13/07/2023,0,0,0,0,0,0,0,0,0,0,0,0,0,0,0,0,0,0,0,0
6842,152332,2023,China,USA,0,2,6,8,02/07/2023,0,0,1,1,4,1,7,12,3,1,5,9,1,0,0,1,3,1,0,4
6843,152332,2023,Korea,China,0,0,0,0,01/07/2023,0,0,0,0,0,0,0,0,0,0,0,0,0,0,0,0,0,0,0,0
6844,152332,2023,China,Dominican Republic,0,0,0,0,30/06/2023,0,0,0,0,0,0,0,0,0,0,0,0,0,0,0,0,0,0,0,0
6845,152332,2023,China,Serbia,0,0,0,0,28/06/2023,0,0,0,0,0,0,0,0,0,0,0,0,0,0,0,0,0,0,0,0
6846,152332,2023,Italy,China,0,0,0,0,18/06/2023,0,0,0,0,0,0,0,0,0,0,0,0,0,0,0,0,0,0,0,0
6847,152332,2023,Poland,China,0,0,1,1,17/06/2023,0,0,0,0,0,0,0,0,0,0,0,0,0,0,0,0,0,0,0,0
6848,152332,2023,Bulgaria,China,0,0,2,2,16/06/2023,0,0,0,0,1,0,0,1,0,0,0,0,0,0,0,0,0,0,0,0
6849,152332,2023,China,Canada,0,0,0,0,13/06/2023,0,0,0,0,0,0,0,0,0,0,0,0,0,0,0,0,0,0,0,0
6850,152332,2023,Japan,China,0,0,0,0,04/06/2023,0,0,0,0,0,0,0,0,0,0,0,0,0,0,0,0,0,0,0,0
6851,152332,2023,China,Netherlands,0,0,0,0,03/06/2023,0,0,0,0,0,0,0,0,0,0,0,0,0,0,0,0,0,0,0,0
6852,152332,2023,China,Germany,0,0,0,0,02/06/2023,0,0,0,0,0,0,0,0,0,0,0,0,0,0,0,0,0,0,0,0
6853,152332,2023,China,Brazil,0,0,0,0,31/05/2023,0,0,0,0,0,0,0,0,0,0,0,0,0,0,0,0,0,0,0,0
6854,143206,2023,China,Türkiye,0,2,10,12,16/07/2023,0,0,8,8,6,4,15,25,2,1,0,3,5,2,13,20,10,3,3,16
6855,143206,2023,Poland,China,0,1,12,13,15/07/2023,0,0,4,4,9,4,7,20,0,2,1,3,2,1,5,8,7,1,2,10
6856,143206,2023,Brazil,China,0,1,12,13,13/07/2023,0,1,1,2,14,3,4,21,0,3,5,8,3,2,16,21,10,2,1,13
6857,143206,2023,China,USA,0,1,19,20,02/07/2023,0,0,7,7,12,2,8,22,1,3,5,9,4,0,17,21,8,4,3,15
6858,143206,2023,Korea,China,0,0,16,16,01/07/2023,0,0,3,3,10,1,3,14,2,6,8,16,3,2,11,16,15,4,1,20
6859,143206,2023,China,Dominican Republic,0,0,11,11,30/06/2023,0,0,3,3,8,2,18,28,1,1,0,2,3,1,4,8,16,3,2,21
6860,143206,2023,China,Serbia,0,0,15,15,28/06/2023,0,0,3,3,10,4,14,28,0,2,2,4,6,1,14,21,9,2,3,14
6861,143206,2023,Italy,China,1,0,15,16,18/06/2023,0,0,5,5,12,7,17,36,3,2,0,5,7,1,11,19,10,1,1,12
6862,143206,2023,Poland,China,1,1,9,11,17/06/2023,0,1,3,4,12,4,8,24,0,3,1,4,2,0,7,9,9,1,1,11
6863,143206,2023,Bulgaria,China,2,0,3,5,16/06/2023,0,1,1,2,3,0,3,6,0,0,3,3,0,0,1,1,4,1,0,5
6864,143206,2023,China,Canada,1,0,10,11,13/06/2023,0,0,0,0,5,2,7,14,1,1,2,4,1,1,5,7,7,2,3,12
6865,143206,2023,Japan,China,1,1,14,16,04/06/2023,0,0,1,1,8,2,12,22,0,0,0,0,2,0,3,5,10,0,1,11
6866,143206,2023,China,Netherlands,0,1,8,9,03/06/2023,0,0,2,2,8,7,6,21,1,1,1,3,1,1,9,11,14,0,0,14
6867,143206,2023,China,Germany,0,0,18,18,02/06/2023,0,0,1,1,9,4,8,21,0,1,3,4,6,1,6,13,5,0,0,5
6868,143206,2023,China,Brazil,1,1,17,19,31/05/2023,0,0,0,0,15,8,12,35,2,0,0,2,6,1,8,15,11,1,0,12
6869,143201,2023,China,Türkiye,1,1,14,16,16/07/2023,0,0,0,0,7,1,4,12,1,3,2,6,0,0,0,0,3,3,0,6
6870,143201,2023,Poland,China,0,0,8,8,15/07/2023,0,0,3,3,5,1,3,9,1,3,5,9,0,0,0,0,1,0,0,1
6871,143201,2023,Brazil,China,1,0,17,18,13/07/2023,0,0,3,3,6,0,3,9,2,1,1,4,0,0,2,2,1,3,1,5
6872,143201,2023,China,USA,0,0,3,3,02/07/2023,0,0,1,1,2,0,2,4,0,2,0,2,0,0,2,2,0,0,0,0
6873,143201,2023,Korea,China,0,1,15,16,01/07/2023,0,0,3,3,7,1,10,18,2,4,4,10,0,0,0,0,0,0,0,0
6874,143201,2023,China,Dominican Republic,0,1,6,7,30/06/2023,0,0,0,0,7,0,5,12,2,0,4,6,0,1,0,1,1,1,0,2
6875,143201,2023,China,Serbia,0,0,0,0,28/06/2023,0,0,0,0,0,0,0,0,0,0,0,0,0,0,0,0,0,0,0,0
6876,143201,2023,Italy,China,0,2,14,16,18/06/2023,0,0,2,2,11,2,5,18,2,3,7,12,0,0,2,2,6,0,1,7
6877,143201,2023,Poland,China,1,0,2,3,17/06/2023,0,0,1,1,3,0,0,3,1,2,0,3,0,0,0,0,2,1,0,3
6878,143201,2023,Bulgaria,China,0,2,11,13,16/06/2023,0,1,1,2,6,1,8,15,3,3,0,6,0,0,0,0,3,0,0,3
6879,143201,2023,China,Canada,0,0,11,11,13/06/2023,0,0,0,0,8,0,4,12,1,2,4,7,0,0,0,0,1,2,2,5
6880,143201,2023,Japan,China,0,0,11,11,04/06/2023,0,0,1,1,10,0,3,13,1,1,3,5,1,0,3,4,2,0,1,3
6881,143201,2023,China,Netherlands,1,0,21,22,03/06/2023,0,1,4,5,11,0,4,15,4,5,0,9,0,0,0,0,3,0,0,3
6882,143201,2023,China,Germany,0,0,11,11,02/06/2023,0,0,4,4,11,0,4,15,0,2,2,4,0,0,0,0,1,0,1,2
6883,143201,2023,China,Brazil,0,2,11,13,31/05/2023,0,0,0,0,8,0,7,15,1,3,5,9,0,0,0,0,0,0,1,1
6884,162979,2023,China,Türkiye,0,0,2,2,16/07/2023,5,2,15,22,0,0,0,0,0,0,0,0,0,0,0,0,0,0,0,0
6885,162979,2023,Poland,China,0,0,0,0,15/07/2023,0,0,0,0,0,0,0,0,0,0,0,0,0,0,0,0,0,0,0,0
6886,162979,2023,Brazil,China,0,0,0,0,13/07/2023,1,0,2,3,0,0,0,0,0,0,0,0,0,0,0,0,1,1,0,2
6887,162979,2023,China,USA,0,0,0,0,02/07/2023,1,2,7,10,0,0,1,1,0,1,1,2,0,0,0,0,1,0,0,1
6888,162979,2023,Korea,China,0,0,1,1,01/07/2023,1,0,4,5,0,0,1,1,0,0,0,0,0,0,0,0,0,1,1,2
6889,162979,2023,China,Dominican Republic,1,0,4,5,30/06/2023,11,0,22,33,0,1,0,1,0,0,0,0,0,0,0,0,0,1,0,1
6890,162979,2023,China,Serbia,0,0,1,1,28/06/2023,5,0,5,10,0,0,1,1,0,0,0,0,0,0,0,0,0,1,0,1
6891,162979,2023,Italy,China,0,0,0,0,18/06/2023,2,0,1,3,0,0,0,0,0,0,0,0,0,0,0,0,0,0,0,0
6892,162979,2023,Poland,China,0,0,0,0,17/06/2023,4,0,4,8,0,0,0,0,0,0,0,0,0,0,0,0,0,0,0,0
6893,162979,2023,Bulgaria,China,1,0,3,4,16/06/2023,1,0,3,4,0,0,0,0,0,0,0,0,0,0,0,0,0,0,0,0
6894,162979,2023,China,Canada,1,0,0,1,13/06/2023,3,0,6,9,0,0,0,0,0,0,0,0,0,0,0,0,0,0,0,0
6895,162979,2023,Japan,China,0,0,0,0,04/06/2023,0,0,5,5,0,0,0,0,0,0,0,0,0,0,0,0,0,0,0,0
6896,162979,2023,China,Netherlands,0,0,0,0,03/06/2023,0,0,0,0,0,0,0,0,0,0,0,0,0,0,0,0,0,0,0,0
6897,162979,2023,China,Germany,0,0,0,0,02/06/2023,0,0,0,0,0,0,0,0,0,0,0,0,0,0,0,0,0,0,0,0
6898,162979,2023,China,Brazil,0,0,0,0,31/05/2023,0,1,9,10,0,0,0,0,0,0,0,0,0,0,0,0,1,0,0,1
6899,135740,2023,China,Türkiye,1,2,13,16,16/07/2023,0,0,2,2,8,7,4,19,0,4,1,5,4,4,15,23,8,5,2,15
6900,135740,2023,Poland,China,0,0,15,15,15/07/2023,0,0,3,3,11,1,4,16,2,3,3,8,8,2,11,21,5,2,2,9
6901,135740,2023,Brazil,China,0,0,16,16,13/07/2023,0,0,2,2,5,3,12,20,2,3,3,8,4,2,13,19,3,1,0,4
6902,135740,2023,China,USA,0,2,19,21,02/07/2023,0,0,0,0,12,2,14,28,0,4,6,10,5,1,10,16,7,3,1,11
6903,135740,2023,Korea,China,1,2,8,11,01/07/2023,0,0,1,1,14,1,11,26,0,7,1,8,4,1,13,18,10,2,1,13
6904,135740,2023,China,Dominican Republic,3,1,16,20,30/06/2023,0,0,2,2,6,4,9,19,0,1,2,3,9,3,14,26,4,5,1,10
6905,135740,2023,China,Serbia,0,2,10,12,28/06/2023,0,0,1,1,7,4,9,20,0,1,4,5,12,4,13,29,6,5,0,11
6906,135740,2023,Italy,China,0,2,13,15,18/06/2023,0,0,3,3,5,7,5,17,1,2,1,4,10,0,26,36,5,4,2,11
6907,135740,2023,Poland,China,1,1,8,10,17/06/2023,0,0,3,3,6,4,7,17,2,3,1,6,4,0,17,21,4,3,1,8
6908,135740,2023,Bulgaria,China,1,1,11,13,16/06/2023,0,0,2,2,8,6,8,22,1,5,0,6,10,0,15,25,6,4,0,10
6909,135740,2023,China,Canada,1,5,7,13,13/06/2023,0,0,1,1,5,2,9,16,1,2,2,5,0,1,13,14,6,1,0,7
6910,135740,2023,Japan,China,0,0,14,14,04/06/2023,0,0,0,0,4,3,7,14,1,0,2,3,3,3,13,19,6,0,0,6
6911,135740,2023,China,Netherlands,0,2,9,11,03/06/2023,0,0,0,0,13,4,7,24,1,0,3,4,5,0,16,21,4,0,2,6
6912,135740,2023,China,Germany,0,1,8,9,02/06/2023,0,0,2,2,8,2,7,17,1,1,1,3,4,1,4,9,8,1,3,12
6913,135740,2023,China,Brazil,1,1,19,21,31/05/2023,0,0,0,0,9,7,12,28,0,1,0,1,7,1,18,26,13,0,1,14
6914,152920,2023,China,Türkiye,0,1,0,1,16/07/2023,0,0,0,0,0,0,0,0,0,0,0,0,0,0,1,1,1,0,0,1
6915,152920,2023,Poland,China,0,0,0,0,15/07/2023,0,0,0,0,0,0,0,0,0,0,0,0,0,0,0,0,0,0,0,0
6916,152920,2023,Brazil,China,0,0,0,0,13/07/2023,0,0,0,0,0,0,0,0,0,0,0,0,0,0,0,0,0,0,0,0
6917,152920,2023,China,USA,0,0,0,0,02/07/2023,0,0,0,0,0,0,0,0,0,0,0,0,0,0,0,0,0,0,0,0
6918,152920,2023,Korea,China,0,0,0,0,01/07/2023,0,0,0,0,0,0,0,0,0,0,0,0,0,0,0,0,0,0,0,0
6919,152920,2023,China,Dominican Republic,0,0,6,6,30/06/2023,0,0,0,0,1,0,2,3,0,0,0,0,0,1,3,4,4,0,0,4
6920,152920,2023,China,Serbia,0,1,3,4,28/06/2023,0,0,0,0,2,0,3,5,0,2,0,2,3,1,1,5,0,0,0,0
6921,152920,2023,Italy,China,0,0,2,2,18/06/2023,0,0,0,0,0,1,0,1,0,0,0,0,1,0,4,5,1,1,0,2
6922,152920,2023,Poland,China,0,0,0,0,17/06/2023,0,0,0,0,0,0,0,0,0,0,0,0,0,0,0,0,0,0,0,0
6923,152920,2023,Bulgaria,China,0,0,0,0,16/06/2023,0,0,0,0,0,1,1,2,0,0,0,0,0,0,0,0,0,0,0,0
6924,152920,2023,China,Canada,0,0,0,0,13/06/2023,0,0,0,0,0,0,0,0,0,0,0,0,0,0,0,0,0,0,0,0
6925,152920,2023,Japan,China,0,1,4,5,04/06/2023,0,0,0,0,1,2,2,5,1,0,0,1,0,0,3,3,3,0,0,3
6926,152920,2023,China,Netherlands,0,1,1,2,03/06/2023,0,0,0,0,0,0,4,4,0,0,1,1,0,0,2,2,1,0,0,1
6927,152920,2023,China,Germany,0,0,0,0,02/06/2023,0,0,0,0,0,0,0,0,0,0,0,0,0,0,0,0,0,0,0,0
6928,152920,2023,China,Brazil,0,0,0,0,31/05/2023,0,0,0,0,0,0,0,0,0,0,0,0,0,0,0,0,0,0,0,0
6929,152318,2023,China,Türkiye,1,3,9,13,16/07/2023,0,0,2,2,19,4,18,41,1,3,1,5,4,1,7,12,10,6,0,16
6930,152318,2023,Poland,China,0,1,15,16,15/07/2023,0,0,4,4,13,3,8,24,1,1,4,6,2,0,10,12,4,0,1,5
6931,152318,2023,Brazil,China,0,2,17,19,13/07/2023,0,0,2,2,16,5,19,40,0,1,0,1,7,3,13,23,6,4,2,12
6932,152318,2023,China,USA,2,2,19,23,02/07/2023,0,0,1,1,26,7,13,46,0,1,4,5,6,1,12,19,7,3,3,13
6933,152318,2023,Korea,China,2,1,9,12,01/07/2023,0,0,6,6,10,5,10,25,2,2,5,9,5,1,12,18,7,1,0,8
6934,152318,2023,China,Dominican Republic,0,2,16,18,30/06/2023,0,0,3,3,22,9,15,46,2,4,1,7,17,0,10,27,5,8,0,13
6935,152318,2023,China,Serbia,0,2,13,15,28/06/2023,0,0,3,3,18,3,13,34,0,5,2,7,3,3,10,16,3,2,0,5
6936,152318,2023,Italy,China,1,1,17,19,18/06/2023,0,0,1,1,20,8,18,46,3,3,0,6,2,1,6,9,12,4,1,17
6937,152318,2023,Poland,China,0,2,9,11,17/06/2023,0,0,3,3,12,5,15,32,1,9,2,12,5,1,10,16,4,0,0,4
6938,152318,2023,Bulgaria,China,3,2,15,20,16/06/2023,0,0,3,3,15,1,10,26,0,4,4,8,2,0,15,17,11,1,1,13
6939,152318,2023,China,Canada,0,2,10,12,13/06/2023,0,0,3,3,13,2,13,28,1,2,3,6,3,0,5,8,1,2,1,4
6940,152318,2023,Japan,China,0,1,11,12,04/06/2023,0,0,0,0,19,3,11,33,1,2,1,4,2,1,6,9,9,0,1,10
6941,152318,2023,China,Netherlands,4,3,14,21,03/06/2023,0,0,0,0,20,5,13,38,3,0,0,3,13,4,10,27,5,0,6,11
6942,152318,2023,China,Germany,0,1,13,14,02/06/2023,0,0,1,1,14,2,10,26,0,0,0,0,7,1,12,20,6,0,1,7
6943,152318,2023,China,Brazil,1,2,16,19,31/05/2023,0,0,1,1,25,4,12,41,0,2,0,2,11,0,23,34,11,2,2,15
6944,135742,2023,China,Türkiye,0,0,1,1,16/07/2023,0,0,0,0,3,0,0,3,0,0,0,0,0,0,1,1,2,0,0,2
6945,135742,2023,Poland,China,0,0,0,0,15/07/2023,0,0,0,0,0,0,0,0,0,0,0,0,0,0,0,0,0,0,0,0
6946,135742,2023,Brazil,China,0,1,0,1,13/07/2023,0,0,0,0,2,0,0,2,1,0,1,2,0,0,0,0,0,0,0,0
6947,135742,2023,China,USA,0,0,2,2,02/07/2023,0,0,0,0,0,0,4,4,0,0,1,1,0,0,2,2,0,0,0,0
6948,135742,2023,Korea,China,0,0,0,0,01/07/2023,0,0,0,0,0,0,0,0,0,0,0,0,0,0,0,0,0,0,0,0
6949,135742,2023,China,Dominican Republic,0,0,6,6,30/06/2023,0,0,0,0,1,0,5,6,0,0,2,2,1,0,1,2,2,5,0,7
6950,135742,2023,China,Serbia,0,0,0,0,28/06/2023,0,0,0,0,0,0,0,0,0,0,1,1,0,0,0,0,0,0,0,0
6951,135742,2023,Italy,China,0,0,0,0,18/06/2023,0,0,0,0,1,0,0,1,0,0,0,0,0,0,0,0,0,0,0,0
6952,135742,2023,Poland,China,0,1,2,3,17/06/2023,0,0,0,0,3,0,0,3,1,0,1,2,0,0,0,0,3,0,0,3
6953,135742,2023,Bulgaria,China,0,0,7,7,16/06/2023,0,0,0,0,6,3,3,12,2,0,6,8,0,0,0,0,2,1,1,4
6954,135742,2023,China,Canada,0,0,2,2,13/06/2023,0,0,0,0,1,0,0,1,0,0,0,0,0,0,0,0,1,1,0,2
6955,135742,2023,Japan,China,0,0,0,0,04/06/2023,0,0,0,0,0,0,0,0,0,0,0,0,0,0,0,0,0,0,0,0
6956,135742,2023,China,Netherlands,1,1,3,5,03/06/2023,0,0,0,0,1,1,3,5,1,0,0,1,0,0,1,1,0,0,0,0
6957,135742,2023,China,Germany,0,0,0,0,02/06/2023,0,0,0,0,0,0,0,0,0,0,0,0,0,0,0,0,0,0,0,0
6958,135742,2023,China,Brazil,0,0,0,0,31/05/2023,0,0,0,0,2,0,2,4,0,0,1,1,0,0,0,0,1,0,0,1
6959,163909,2023,China,Türkiye,0,0,0,0,16/07/2023,0,0,2,2,0,0,0,0,0,0,0,0,0,0,0,0,1,1,1,3
6960,163909,2023,Poland,China,0,0,0,0,15/07/2023,0,0,0,0,0,0,0,0,0,0,0,0,0,0,0,0,0,0,0,0
6961,163909,2023,Brazil,China,0,0,1,1,13/07/2023,0,0,0,0,0,0,0,0,0,0,0,0,0,0,0,0,0,1,0,1
6962,163909,2023,China,USA,0,0,0,0,02/07/2023,0,0,2,2,0,0,0,0,0,0,0,0,0,0,0,0,1,1,1,3
6963,163909,2023,Korea,China,0,0,0,0,01/07/2023,0,0,1,1,0,0,0,0,0,0,0,0,0,0,0,0,2,0,1,3
6964,163909,2023,China,Dominican Republic,0,0,0,0,30/06/2023,0,0,3,3,0,0,0,0,0,0,0,0,0,0,0,0,7,5,0,12
6965,163909,2023,China,Serbia,0,0,0,0,28/06/2023,0,0,1,1,0,0,0,0,0,0,0,0,0,0,0,0,11,0,1,12
6966,163909,2023,Italy,China,0,0,0,0,18/06/2023,0,0,0,0,0,0,0,0,0,0,0,0,0,0,0,0,5,1,0,6
6967,163909,2023,Poland,China,0,0,0,0,17/06/2023,0,0,0,0,0,0,0,0,0,0,0,0,0,0,0,0,0,0,0,0
6968,163909,2023,Bulgaria,China,0,0,0,0,16/06/2023,0,0,0,0,0,0,0,0,0,0,0,0,0,0,0,0,0,0,0,0
6969,163909,2023,China,Canada,0,0,0,0,13/06/2023,0,0,0,0,0,0,0,0,0,0,0,0,0,0,0,0,0,0,0,0
6970,163909,2023,Japan,China,0,0,0,0,04/06/2023,0,0,0,0,0,0,0,0,0,0,0,0,0,0,0,0,0,0,0,0
6971,163909,2023,China,Netherlands,0,0,0,0,03/06/2023,0,0,0,0,0,0,0,0,0,0,0,0,0,0,0,0,0,0,0,0
6972,163909,2023,China,Germany,0,0,0,0,02/06/2023,0,0,0,0,0,0,0,0,0,0,0,0,0,0,0,0,0,0,0,0
6973,163909,2023,China,Brazil,0,0,0,0,31/05/2023,0,0,0,0,0,0,0,0,0,0,0,0,0,0,0,0,0,0,0,0
6974,135745,2023,China,Türkiye,0,0,0,0,16/07/2023,0,0,4,4,0,0,0,0,0,0,0,0,5,1,24,30,10,1,1,12
6975,135745,2023,Poland,China,0,0,0,0,15/07/2023,0,0,4,4,0,0,0,0,0,0,0,0,3,1,7,11,10,5,2,17
6976,135745,2023,Brazil,China,0,0,0,0,13/07/2023,0,0,9,9,0,0,0,0,0,0,0,0,2,1,9,12,10,2,2,14
6977,135745,2023,China,USA,0,0,0,0,02/07/2023,0,0,8,8,0,0,0,0,0,0,0,0,4,0,13,17,13,1,1,15
6978,135745,2023,Korea,China,0,0,0,0,01/07/2023,0,0,2,2,0,0,0,0,0,0,0,0,2,1,10,13,8,1,1,10
6979,135745,2023,China,Dominican Republic,0,0,0,0,30/06/2023,0,0,8,8,0,0,0,0,0,0,0,0,13,1,10,24,10,4,0,14
6980,135745,2023,China,Serbia,0,0,0,0,28/06/2023,0,0,7,7,0,0,0,0,0,0,0,0,1,0,7,8,7,2,0,9
6981,135745,2023,Italy,China,0,0,0,0,18/06/2023,0,0,7,7,0,0,0,0,0,0,0,0,6,1,13,20,10,1,1,12
6982,135745,2023,Poland,China,0,0,0,0,17/06/2023,0,0,8,8,0,0,0,0,0,0,0,0,5,1,13,19,7,3,0,10
6983,135745,2023,Bulgaria,China,0,0,0,0,16/06/2023,0,0,7,7,0,0,0,0,0,0,0,0,1,0,7,8,16,5,1,22
6984,135745,2023,China,Canada,0,0,0,0,13/06/2023,0,0,4,4,0,0,0,0,0,0,0,0,3,0,14,17,9,5,2,16
6985,135745,2023,Japan,China,0,0,0,0,04/06/2023,0,0,7,7,0,0,0,0,0,0,0,0,5,1,11,17,7,0,1,8
6986,135745,2023,China,Netherlands,0,0,0,0,03/06/2023,0,0,9,9,0,0,0,0,0,0,0,0,3,0,15,18,6,1,2,9
6987,135745,2023,China,Germany,0,0,0,0,02/06/2023,0,0,11,11,0,0,0,0,0,0,0,0,2,2,7,11,13,1,2,16
6988,135745,2023,China,Brazil,0,0,0,0,31/05/2023,0,0,6,6,0,0,0,0,0,0,0,0,9,0,8,17,15,0,3,18
6989,143198,2023,China,Türkiye,0,0,1,1,16/07/2023,0,0,0,0,0,0,0,0,0,0,0,0,0,0,0,0,0,0,0,0
6990,143198,2023,Poland,China,0,0,3,3,15/07/2023,0,0,0,0,0,0,0,0,0,0,0,0,0,0,0,0,0,0,0,0
6991,143198,2023,Brazil,China,0,0,2,2,13/07/2023,0,0,0,0,0,0,0,0,0,0,0,0,0,0,0,0,0,0,0,0
6992,143198,2023,China,USA,0,0,2,2,02/07/2023,0,0,0,0,0,0,0,0,0,0,0,0,0,0,0,0,0,0,0,0
6993,143198,2023,Korea,China,0,0,1,1,01/07/2023,0,0,0,0,0,0,0,0,0,0,0,0,0,0,0,0,0,0,0,0
6994,143198,2023,China,Dominican Republic,0,1,0,1,30/06/2023,0,0,0,0,0,0,0,0,0,0,0,0,0,0,0,0,0,0,0,0
6995,143198,2023,China,Serbia,0,0,0,0,28/06/2023,0,0,0,0,0,0,0,0,0,0,0,0,0,0,0,0,0,0,0,0
6996,143198,2023,Italy,China,0,1,1,2,18/06/2023,0,0,0,0,0,0,0,0,0,0,0,0,0,0,0,0,1,0,0,1
6997,143198,2023,Poland,China,0,0,2,2,17/06/2023,0,0,0,0,0,0,0,0,0,0,0,0,0,0,0,0,0,0,0,0
6998,143198,2023,Bulgaria,China,0,0,0,0,16/06/2023,0,0,0,0,0,0,0,0,0,0,0,0,0,0,0,0,0,0,0,0
6999,143198,2023,China,Canada,0,0,1,1,13/06/2023,0,0,0,0,0,0,0,0,0,0,0,0,0,0,0,0,0,0,0,0
7000,143198,2023,Japan,China,0,0,2,2,04/06/2023,0,0,0,0,0,0,0,0,0,0,0,0,0,0,0,0,0,0,0,0
7001,143198,2023,China,Netherlands,0,0,3,3,03/06/2023,0,0,0,0,0,0,0,0,0,0,0,0,0,0,0,0,0,0,0,0
7002,143198,2023,China,Germany,0,0,0,0,02/06/2023,0,0,0,0,0,0,0,0,0,0,0,0,0,0,0,0,0,0,0,0
7003,143198,2023,China,Brazil,0,1,1,2,31/05/2023,0,0,0,0,0,0,0,0,0,0,0,0,0,0,0,0,0,0,0,0
7004,194499,2023,Croatia,Türkiye,0,1,7,8,02/07/2023,6,0,46,52,0,0,3,3,0,2,0,2,0,0,1,1,5,1,0,6
7005,194499,2023,Italy,Croatia,0,1,0,1,01/07/2023,6,0,32,38,0,0,3,3,0,3,3,6,0,0,0,0,2,0,0,2
7006,194499,2023,Croatia,Netherlands,0,0,6,6,29/06/2023,9,4,59,72,0,1,0,1,0,1,0,1,0,0,1,1,7,3,1,11
7007,194499,2023,Croatia,Canada,0,1,9,10,27/06/2023,18,1,82,101,1,0,2,3,1,4,3,8,0,0,0,0,6,2,1,9
7008,194499,2023,Thailand,Croatia,1,0,9,10,18/06/2023,17,0,75,92,0,0,2,2,0,4,4,8,0,0,0,0,5,3,1,9
7009,194499,2023,Serbia,Croatia,1,1,6,8,18/06/2023,18,3,68,89,0,0,1,1,0,3,2,5,0,0,0,0,8,5,1,14
7010,194499,2023,Korea,Croatia,0,0,5,5,16/06/2023,34,0,56,90,2,0,3,5,2,3,3,8,0,0,0,0,8,3,1,12
7011,194499,2023,Croatia,USA,2,2,9,13,13/06/2023,13,0,100,113,3,0,4,7,0,0,9,9,0,0,0,0,7,5,2,14
7012,194499,2023,Croatia,Brazil,0,0,8,8,04/06/2023,9,1,70,80,0,0,0,0,0,1,4,5,0,0,0,0,3,0,1,4
7013,194499,2023,Croatia,Japan,2,1,6,9,02/06/2023,3,0,103,106,0,0,0,0,2,0,3,5,0,0,0,0,3,0,1,4
7014,194499,2023,Croatia,Germany,0,0,10,10,01/06/2023,8,0,66,74,0,1,0,1,0,1,0,1,0,0,0,0,8,3,0,11
7015,194499,2023,Croatia,Bulgaria,0,1,2,3,31/05/2023,7,1,36,44,0,0,0,0,1,0,1,2,0,0,0,0,4,0,0,4
7016,194498,2023,Croatia,Türkiye,0,1,6,7,02/07/2023,0,0,1,1,6,3,16,25,0,2,3,5,3,1,18,22,4,0,1,5
7017,194498,2023,Italy,Croatia,0,0,5,5,01/07/2023,0,0,2,2,5,4,16,25,2,2,1,5,1,1,14,16,5,4,0,9
7018,194498,2023,Croatia,Netherlands,0,2,5,7,29/06/2023,0,0,1,1,9,8,12,29,1,2,1,4,0,0,0,0,2,6,2,10
7019,194498,2023,Croatia,Canada,1,0,3,4,27/06/2023,0,0,2,2,4,2,7,13,0,0,2,2,0,0,0,0,1,2,0,3
7020,194498,2023,Thailand,Croatia,0,2,4,6,18/06/2023,0,0,1,1,17,1,16,34,2,1,5,8,0,0,0,0,8,4,2,14
7021,194498,2023,Serbia,Croatia,0,0,5,5,18/06/2023,0,0,1,1,6,5,8,19,0,3,1,4,0,0,0,0,2,4,1,7
7022,194498,2023,Korea,Croatia,1,0,16,17,16/06/2023,0,0,2,2,8,3,16,27,0,3,5,8,0,0,0,0,7,1,1,9
7023,194498,2023,Croatia,USA,0,4,3,7,13/06/2023,0,0,1,1,13,5,20,38,1,0,7,8,0,0,0,0,8,2,1,11
7024,194498,2023,Croatia,Brazil,2,1,6,9,04/06/2023,0,0,1,1,10,6,15,31,2,2,2,6,0,0,1,1,4,0,1,5
7025,194498,2023,Croatia,Japan,0,2,6,8,02/06/2023,0,1,0,1,8,10,27,45,0,0,3,3,0,0,1,1,6,0,3,9
7026,194498,2023,Croatia,Germany,1,2,6,9,01/06/2023,0,0,1,1,16,1,13,30,1,0,3,4,0,0,0,0,7,1,1,9
7027,194498,2023,Croatia,Bulgaria,0,2,5,7,31/05/2023,0,0,1,1,7,8,13,28,1,1,1,3,0,0,0,0,5,1,1,7
7028,156438,2023,Croatia,Türkiye,1,1,12,14,02/07/2023,0,0,1,1,4,0,4,8,2,4,1,7,0,0,0,0,0,2,1,3
7029,156438,2023,Italy,Croatia,0,1,7,8,01/07/2023,0,0,1,1,2,0,3,5,0,6,5,11,0,0,0,0,0,1,0,1
7030,156438,2023,Croatia,Netherlands,0,0,6,6,29/06/2023,0,0,0,0,3,1,3,7,1,2,3,6,0,0,0,0,1,1,0,2
7031,156438,2023,Croatia,Canada,1,0,13,14,27/06/2023,0,0,1,1,6,0,5,11,3,6,3,12,0,0,0,0,4,1,1,6
7032,156438,2023,Thailand,Croatia,2,1,13,16,18/06/2023,0,0,3,3,3,2,3,8,1,1,6,8,0,0,0,0,4,0,1,5
7033,156438,2023,Serbia,Croatia,0,1,10,11,18/06/2023,0,0,3,3,5,1,4,10,3,3,6,12,0,0,0,0,5,3,1,9
7034,156438,2023,Korea,Croatia,1,0,10,11,16/06/2023,0,0,3,3,3,1,6,10,4,2,9,15,0,0,0,0,4,3,2,9
7035,156438,2023,Croatia,USA,0,1,11,12,13/06/2023,0,0,2,2,3,1,8,12,3,5,3,11,0,0,0,0,2,1,0,3
7036,156438,2023,Croatia,Brazil,0,0,8,8,04/06/2023,0,0,0,0,4,2,2,8,4,1,3,8,0,0,0,0,4,0,0,4
7037,156438,2023,Croatia,Japan,0,2,7,9,02/06/2023,0,0,0,0,3,1,6,10,3,0,1,4,1,0,0,1,3,0,0,3
7038,156438,2023,Croatia,Germany,0,0,5,5,01/06/2023,0,0,2,2,2,0,5,7,4,4,2,10,0,0,1,1,2,0,0,2
7039,156438,2023,Croatia,Bulgaria,1,0,7,8,31/05/2023,0,0,0,0,3,3,5,11,1,4,5,10,0,0,0,0,0,0,0,0
7040,162957,2023,Croatia,Türkiye,0,0,0,0,02/07/2023,0,0,0,0,0,0,0,0,0,0,0,0,0,0,0,0,0,0,0,0
7041,162957,2023,Italy,Croatia,0,0,0,0,01/07/2023,0,0,0,0,0,0,0,0,0,0,0,0,0,0,0,0,0,0,0,0
7042,162957,2023,Croatia,Netherlands,0,0,0,0,29/06/2023,0,0,0,0,0,0,0,0,0,0,0,0,0,0,0,0,0,0,0,0
7043,162957,2023,Croatia,Canada,0,0,0,0,27/06/2023,0,0,0,0,0,0,0,0,0,0,0,0,0,0,0,0,0,0,0,0
7044,173970,2023,Croatia,Türkiye,0,0,0,0,02/07/2023,0,0,14,14,0,0,0,0,0,0,0,0,0,0,0,0,0,1,0,1
7045,173970,2023,Italy,Croatia,1,0,6,7,01/07/2023,9,0,37,46,1,0,1,2,0,0,0,0,0,1,0,1,1,1,1,3
7046,173970,2023,Croatia,Netherlands,0,0,2,2,29/06/2023,1,0,6,7,0,0,1,1,0,1,1,2,0,0,0,0,0,0,0,0
7047,173970,2023,Croatia,Canada,0,0,0,0,27/06/2023,0,0,6,6,0,0,0,0,0,0,0,0,0,0,0,0,0,0,0,0
7048,173970,2023,Thailand,Croatia,0,0,0,0,18/06/2023,0,0,0,0,0,0,0,0,0,0,0,0,0,0,0,0,0,0,0,0
7049,173970,2023,Serbia,Croatia,0,0,2,2,18/06/2023,3,0,16,19,0,0,1,1,0,3,2,5,0,0,0,0,3,1,0,4
7050,173970,2023,Korea,Croatia,0,0,0,0,16/06/2023,0,0,0,0,0,0,0,0,0,0,0,0,0,0,0,0,0,0,0,0
7051,173970,2023,Croatia,USA,0,0,1,1,13/06/2023,0,0,5,5,0,0,0,0,0,0,0,0,0,0,0,0,0,0,0,0
7052,173970,2023,Croatia,Brazil,0,1,0,1,04/06/2023,0,0,0,0,0,0,0,0,0,0,0,0,0,0,0,0,0,0,0,0
7053,173970,2023,Croatia,Japan,1,0,5,6,02/06/2023,0,0,2,2,0,0,0,0,0,0,0,0,0,0,0,0,0,0,0,0
7054,173970,2023,Croatia,Germany,0,0,1,1,01/06/2023,1,0,4,5,0,0,0,0,0,0,0,0,0,0,0,0,0,0,0,0
7055,173970,2023,Croatia,Bulgaria,0,0,6,6,31/05/2023,8,1,36,45,0,0,1,1,1,0,0,1,0,0,0,0,1,0,0,1
7056,170571,2023,Croatia,Türkiye,0,0,0,0,02/07/2023,0,0,0,0,0,1,0,1,0,0,0,0,0,0,1,1,0,0,0,0
7057,170571,2023,Italy,Croatia,1,0,2,3,01/07/2023,0,0,0,0,0,1,2,3,0,0,0,0,1,2,4,7,0,0,0,0
7058,170571,2023,Croatia,Netherlands,0,0,6,6,29/06/2023,0,0,0,0,3,1,3,7,0,2,0,2,2,2,2,6,0,2,1,3
7059,170571,2023,Croatia,Canada,0,0,9,9,27/06/2023,0,0,1,1,9,3,11,23,0,1,3,4,5,2,18,25,8,1,0,9
7060,170571,2023,Thailand,Croatia,1,0,12,13,18/06/2023,0,0,1,1,9,3,12,24,0,1,3,4,5,1,8,14,7,2,0,9
7061,170571,2023,Serbia,Croatia,0,0,0,0,18/06/2023,0,0,0,0,0,1,6,7,0,0,0,0,0,1,2,3,0,1,0,1
7062,170571,2023,Korea,Croatia,0,1,13,14,16/06/2023,0,0,1,1,4,5,15,24,3,1,3,7,4,1,10,15,7,0,0,7
7063,170571,2023,Croatia,USA,0,1,13,14,13/06/2023,0,0,1,1,15,6,14,35,0,1,4,5,5,1,24,30,10,3,0,13
7064,170571,2023,Croatia,Brazil,0,2,6,8,04/06/2023,0,0,1,1,1,5,10,16,1,0,3,4,6,3,9,18,5,0,1,6
7065,170571,2023,Croatia,Japan,0,1,7,8,02/06/2023,0,0,0,0,7,3,7,17,0,2,1,3,2,2,10,14,7,0,2,9
7066,170571,2023,Croatia,Germany,0,0,2,2,01/06/2023,0,0,0,0,1,3,7,11,0,0,0,0,2,0,2,4,1,0,0,1
7067,170571,2023,Croatia,Bulgaria,0,3,2,5,31/05/2023,0,0,0,0,5,3,17,25,0,3,5,8,0,0,8,8,5,0,2,7
7068,147402,2023,Croatia,Türkiye,0,0,3,3,02/07/2023,0,0,0,0,1,0,0,1,0,0,0,0,2,1,5,8,2,1,1,4
7069,147402,2023,Italy,Croatia,0,0,7,7,01/07/2023,0,0,2,2,1,1,5,7,1,0,0,1,3,0,11,14,4,0,0,4
7070,147402,2023,Croatia,Netherlands,0,0,4,4,29/06/2023,0,0,0,0,3,2,6,11,0,0,0,0,3,2,15,20,0,4,0,4
7071,147402,2023,Croatia,Canada,0,1,8,9,27/06/2023,0,0,3,3,4,3,10,17,0,0,1,1,4,0,10,14,2,1,0,3
7072,147402,2023,Thailand,Croatia,0,0,6,6,18/06/2023,0,0,0,0,0,0,0,0,0,0,0,0,0,0,0,0,1,0,0,1
7073,147402,2023,Serbia,Croatia,1,1,11,13,18/06/2023,0,0,1,1,10,8,15,33,0,1,1,2,4,0,12,16,12,3,1,16
7074,147402,2023,Korea,Croatia,0,0,0,0,16/06/2023,0,0,0,0,0,0,0,0,0,0,0,0,0,0,0,0,0,0,0,0
7075,147402,2023,Croatia,USA,0,0,2,2,13/06/2023,0,0,0,0,1,2,0,3,0,0,0,0,1,0,6,7,0,1,1,2
7076,189437,2023,Croatia,Türkiye,0,0,6,6,02/07/2023,0,0,1,1,3,2,6,11,0,1,0,1,2,1,9,12,1,1,1,3
7077,189437,2023,Italy,Croatia,0,0,3,3,01/07/2023,0,0,1,1,0,4,9,13,0,0,1,1,0,0,5,5,2,1,0,3
7078,189437,2023,Croatia,Netherlands,0,0,2,2,29/06/2023,0,0,2,2,2,0,4,6,0,1,0,1,2,0,18,20,7,1,1,9
7079,189437,2023,Croatia,Canada,0,0,5,5,27/06/2023,0,0,0,0,0,4,1,5,0,0,0,0,2,2,4,8,4,1,2,7
7080,189437,2023,Thailand,Croatia,1,0,16,17,18/06/2023,0,0,3,3,7,2,12,21,1,2,0,3,6,0,19,25,12,3,1,16
7081,189437,2023,Serbia,Croatia,0,1,3,4,18/06/2023,0,0,1,1,1,0,1,2,0,1,0,1,1,1,10,12,2,3,0,5
7082,189437,2023,Korea,Croatia,1,0,9,10,16/06/2023,0,0,1,1,8,3,9,20,2,2,0,4,3,3,19,25,8,0,1,9
7083,189437,2023,Croatia,USA,2,0,15,17,13/06/2023,0,0,3,3,11,4,8,23,1,1,0,2,5,1,25,31,5,6,2,13
7084,189437,2023,Croatia,Brazil,0,1,7,8,04/06/2023,0,0,0,0,4,7,6,17,2,0,1,3,0,0,23,23,4,0,2,6
7085,189437,2023,Croatia,Japan,0,0,9,9,02/06/2023,0,0,2,2,9,0,14,23,1,0,2,3,4,1,18,23,6,0,2,8
7086,189437,2023,Croatia,Germany,0,0,17,17,01/06/2023,0,0,2,2,4,0,12,16,0,1,0,1,5,3,16,24,7,0,0,7
7087,189437,2023,Croatia,Bulgaria,0,0,11,11,31/05/2023,0,0,0,0,3,0,7,10,0,3,0,3,3,2,16,21,5,0,0,5
7088,189256,2023,Croatia,Türkiye,0,0,0,0,02/07/2023,0,0,0,0,0,0,0,0,0,0,0,0,0,0,0,0,1,0,0,1
7089,189256,2023,Italy,Croatia,0,0,0,0,01/07/2023,0,0,0,0,0,0,0,0,0,0,0,0,0,0,0,0,0,0,0,0
7090,189256,2023,Croatia,Netherlands,0,0,2,2,29/06/2023,0,0,3,3,1,4,6,11,0,0,1,1,1,0,8,9,4,0,0,4
7091,189256,2023,Croatia,Canada,0,0,1,1,27/06/2023,0,0,0,0,1,0,0,1,0,0,0,0,1,0,0,1,0,0,0,0
7092,189256,2023,Thailand,Croatia,0,0,0,0,18/06/2023,0,0,0,0,0,0,0,0,0,0,0,0,0,0,0,0,0,0,0,0
7093,189256,2023,Serbia,Croatia,0,0,9,9,18/06/2023,0,0,2,2,9,2,15,26,0,2,6,8,7,4,26,37,3,2,3,8
7094,189256,2023,Korea,Croatia,0,0,0,0,16/06/2023,0,0,0,0,0,0,0,0,0,0,0,0,0,0,0,0,0,0,0,0
7095,189256,2023,Croatia,USA,0,0,0,0,13/06/2023,0,0,0,0,0,1,0,1,0,0,0,0,0,0,1,1,0,0,0,0
7096,189256,2023,Croatia,Brazil,0,0,1,1,04/06/2023,0,0,0,0,0,0,1,1,0,0,0,0,0,1,3,4,1,0,0,1
7097,189256,2023,Croatia,Japan,0,0,0,0,02/06/2023,0,0,0,0,0,1,3,4,0,0,0,0,0,0,0,0,1,0,0,1
7098,189256,2023,Croatia,Germany,0,1,1,2,01/06/2023,0,0,3,3,1,0,5,6,1,0,1,2,1,0,6,7,2,0,1,3
7099,189256,2023,Croatia,Bulgaria,0,0,2,2,31/05/2023,0,0,0,0,1,3,3,7,0,2,0,2,2,3,5,10,1,1,0,2
7100,140914,2023,Croatia,Türkiye,0,2,6,8,02/07/2023,0,0,4,4,5,6,12,23,2,2,4,8,0,0,0,0,0,0,2,2
7101,140914,2023,Italy,Croatia,0,1,10,11,01/07/2023,0,0,0,0,8,8,18,34,0,2,1,3,0,0,1,1,10,2,1,13
7102,140914,2023,Croatia,Netherlands,0,0,0,0,29/06/2023,0,0,0,0,0,0,0,0,0,0,0,0,0,0,0,0,0,0,0,0
7103,140914,2023,Croatia,Canada,0,0,10,10,27/06/2023,0,0,0,0,8,11,13,32,1,0,7,8,0,0,0,0,7,3,2,12
7104,136824,2023,Croatia,Türkiye,0,1,7,8,02/07/2023,0,0,0,0,5,2,2,9,0,6,2,8,0,0,0,0,3,0,0,3
7105,136824,2023,Italy,Croatia,0,1,4,5,01/07/2023,0,0,0,0,3,2,4,9,3,5,8,16,0,0,0,0,1,1,0,2
7106,136824,2023,Croatia,Netherlands,1,0,6,7,29/06/2023,0,0,4,4,8,3,7,18,2,2,3,7,0,0,1,1,0,0,1,1
7107,136824,2023,Croatia,Canada,0,2,6,8,27/06/2023,0,0,0,0,10,4,3,17,0,2,5,7,0,0,0,0,3,0,2,5
7108,136824,2023,Thailand,Croatia,1,0,7,8,18/06/2023,0,0,2,2,10,2,4,16,3,0,4,7,0,0,0,0,1,1,2,4
7109,136824,2023,Serbia,Croatia,0,2,7,9,18/06/2023,0,0,2,2,8,2,6,16,2,2,2,6,0,0,0,0,3,2,1,6
7110,136824,2023,Korea,Croatia,3,0,13,16,16/06/2023,0,0,3,3,12,2,9,23,3,5,4,12,0,0,1,1,7,1,0,8
7111,136824,2023,Croatia,USA,0,2,12,14,13/06/2023,0,0,3,3,8,2,10,20,1,6,9,16,0,0,0,0,4,1,0,5
7112,136824,2023,Croatia,Brazil,1,1,7,9,04/06/2023,0,0,1,1,7,1,2,10,3,0,1,4,1,0,0,1,1,1,0,2
7113,136824,2023,Croatia,Japan,0,1,2,3,02/06/2023,0,0,0,0,2,1,10,13,0,1,1,2,0,0,0,0,0,0,1,1
7114,136824,2023,Croatia,Germany,0,0,11,11,01/06/2023,0,1,2,3,7,0,6,13,0,0,3,3,0,0,1,1,2,0,0,2
7115,136824,2023,Croatia,Bulgaria,0,1,6,7,31/05/2023,0,0,1,1,9,2,4,15,1,3,0,4,0,0,0,0,2,0,0,2
7116,186153,2023,Croatia,Türkiye,0,0,0,0,02/07/2023,0,0,0,0,0,0,0,0,0,0,0,0,0,0,0,0,0,0,0,0
7117,186153,2023,Italy,Croatia,0,0,0,0,01/07/2023,0,0,0,0,0,0,0,0,0,0,0,0,0,0,0,0,0,0,0,0
7118,186153,2023,Croatia,Netherlands,0,0,3,3,29/06/2023,0,0,1,1,0,1,0,1,0,0,0,0,0,0,0,0,0,0,0,0
7119,186153,2023,Croatia,Canada,0,0,0,0,27/06/2023,0,0,0,0,0,0,0,0,0,0,0,0,0,0,0,0,0,0,0,0
7120,186153,2023,Thailand,Croatia,0,0,0,0,18/06/2023,0,0,0,0,0,0,0,0,0,0,0,0,0,0,0,0,0,0,0,0
7121,186153,2023,Serbia,Croatia,0,0,0,0,18/06/2023,0,0,0,0,0,0,0,0,0,0,0,0,0,0,0,0,0,0,0,0
7122,186153,2023,Korea,Croatia,0,0,0,0,16/06/2023,0,0,0,0,0,0,0,0,0,0,0,0,0,0,0,0,0,0,0,0
7123,186153,2023,Croatia,USA,0,0,0,0,13/06/2023,0,0,0,0,0,0,0,0,0,0,0,0,0,0,0,0,0,0,0,0
7124,186153,2023,Croatia,Brazil,0,0,0,0,04/06/2023,0,0,0,0,0,0,0,0,0,0,0,0,0,0,0,0,0,0,0,0
7125,186153,2023,Croatia,Japan,0,1,4,5,02/06/2023,0,0,0,0,0,0,3,3,1,0,1,2,0,0,0,0,1,0,0,1
7126,186153,2023,Croatia,Germany,1,0,4,5,01/06/2023,0,0,0,0,0,0,0,0,0,0,0,0,0,0,0,0,0,0,1,1
7127,186153,2023,Croatia,Bulgaria,0,0,0,0,31/05/2023,0,0,0,0,0,0,0,0,0,0,0,0,0,0,0,0,0,0,0,0
7128,164734,2023,Croatia,Türkiye,0,2,1,3,02/07/2023,0,0,1,1,2,1,2,5,0,0,0,0,0,0,0,0,0,0,0,0
7129,164734,2023,Italy,Croatia,0,0,0,0,01/07/2023,0,0,0,0,0,0,0,0,0,0,0,0,0,0,0,0,0,0,0,0
7130,164734,2023,Croatia,Netherlands,1,1,0,2,29/06/2023,0,0,0,0,3,1,2,6,0,0,0,0,0,0,0,0,0,0,0,0
7131,164734,2023,Croatia,Canada,0,0,0,0,27/06/2023,0,0,0,0,0,0,0,0,0,0,0,0,0,0,0,0,0,0,0,0
7132,164734,2023,Thailand,Croatia,0,0,0,0,18/06/2023,0,0,0,0,0,0,0,0,0,0,0,0,0,0,0,0,0,0,0,0
7133,164734,2023,Serbia,Croatia,0,2,2,4,18/06/2023,0,0,1,1,3,2,3,8,0,0,1,1,0,0,0,0,4,4,0,8
7134,164734,2023,Korea,Croatia,0,0,0,0,16/06/2023,0,0,0,0,0,0,0,0,0,0,0,0,0,0,0,0,0,0,0,0
7135,164734,2023,Croatia,USA,0,0,0,0,13/06/2023,0,0,0,0,0,1,0,1,0,0,0,0,0,0,0,0,0,0,0,0
7136,189270,2023,Croatia,Türkiye,0,0,0,0,02/07/2023,0,0,11,11,0,0,0,0,0,0,0,0,7,0,13,20,7,6,3,16
7137,189270,2023,Italy,Croatia,0,0,0,0,01/07/2023,0,0,10,10,0,0,0,0,0,0,0,0,7,2,15,24,9,5,0,14
7138,189270,2023,Croatia,Netherlands,0,0,0,0,29/06/2023,0,0,11,11,0,0,0,0,0,0,0,0,4,2,8,14,9,1,0,10
7139,189270,2023,Croatia,Canada,0,0,0,0,27/06/2023,0,0,10,10,0,0,0,0,0,0,0,0,6,0,18,24,18,5,0,23
7140,189270,2023,Thailand,Croatia,0,0,0,0,18/06/2023,0,0,5,5,0,0,0,0,0,0,0,0,8,0,4,12,14,5,1,20
7141,189270,2023,Serbia,Croatia,0,0,0,0,18/06/2023,0,0,17,17,0,0,0,0,0,0,0,0,5,3,13,21,14,5,1,20
7142,189270,2023,Korea,Croatia,0,0,0,0,16/06/2023,0,0,5,5,0,0,0,0,0,0,0,0,5,3,5,13,20,1,2,23
7143,189270,2023,Croatia,USA,0,0,0,0,13/06/2023,0,0,8,8,0,0,0,0,0,0,0,0,5,1,8,14,14,8,1,23
7144,189270,2023,Croatia,Brazil,0,0,0,0,04/06/2023,0,0,3,3,0,0,0,0,0,0,0,0,5,3,13,21,6,1,3,10
7145,189270,2023,Croatia,Japan,0,0,0,0,02/06/2023,0,0,5,5,0,0,0,0,0,0,0,0,15,1,10,26,22,0,4,26
7146,189270,2023,Croatia,Germany,0,0,0,0,01/06/2023,0,0,9,9,0,0,0,0,0,0,0,0,7,0,4,11,14,1,4,19
7147,189270,2023,Croatia,Bulgaria,0,0,0,0,31/05/2023,0,0,7,7,0,0,0,0,0,0,0,0,7,4,16,27,13,2,2,17
7148,158817,2023,Serbia,Dominican Republic,0,1,6,7,01/07/2023,0,0,1,1,0,0,0,0,0,0,0,0,1,0,3,4,1,1,1,3
7149,158817,2023,China,Dominican Republic,0,1,8,9,30/06/2023,0,0,3,3,0,0,0,0,0,0,0,0,2,0,5,7,3,3,0,6
7150,158817,2023,Dominican Republic,Korea,0,1,4,5,29/06/2023,0,0,2,2,0,0,0,0,0,0,0,0,0,0,0,0,6,1,0,7
7151,158817,2023,Germany,Dominican Republic,0,0,3,3,27/06/2023,0,0,0,0,0,0,0,0,0,0,0,0,0,0,3,3,5,0,1,6
7152,158817,2023,Dominican Republic,Türkiye,0,1,5,6,18/06/2023,0,0,0,0,0,0,0,0,0,0,0,0,2,0,3,5,2,3,1,6
7153,158817,2023,Dominican Republic,Canada,0,0,0,0,17/06/2023,0,0,0,0,0,0,0,0,0,0,0,0,0,0,0,0,0,0,0,0
7154,158817,2023,Dominican Republic,Italy,0,0,0,0,15/06/2023,0,0,0,0,0,0,0,0,0,0,0,0,0,0,0,0,0,0,0,0
7155,158817,2023,Dominican Republic,Poland,0,0,0,0,13/06/2023,0,0,0,0,0,0,0,0,0,0,0,0,0,0,0,0,0,0,0,0
7156,158817,2023,Brazil,Dominican Republic,0,1,2,3,03/06/2023,0,0,7,7,0,0,0,0,0,0,0,0,4,1,20,25,7,0,1,8
7157,158817,2023,Dominican Republic,Netherlands,0,0,0,0,02/06/2023,1,0,6,7,0,0,0,0,0,0,0,0,5,2,21,28,16,0,2,18
7158,158817,2023,Bulgaria,Dominican Republic,0,0,0,0,01/06/2023,0,0,9,9,0,0,0,0,0,0,0,0,6,3,6,15,11,1,2,14
7159,158817,2023,Japan,Dominican Republic,0,0,0,0,30/05/2023,1,0,9,10,0,0,0,0,0,0,0,0,2,2,8,12,22,4,2,28
7160,119591,2023,Serbia,Dominican Republic,0,0,0,0,01/07/2023,0,0,0,0,0,0,0,0,0,0,0,0,0,0,0,0,0,0,0,0
7161,119591,2023,China,Dominican Republic,0,0,0,0,30/06/2023,0,0,0,0,0,0,0,0,0,0,0,0,0,0,0,0,0,0,0,0
7162,119591,2023,Dominican Republic,Korea,0,0,0,0,29/06/2023,0,0,0,0,0,0,0,0,0,0,0,0,0,0,0,0,0,0,0,0
7163,119591,2023,Germany,Dominican Republic,0,0,0,0,27/06/2023,0,0,0,0,0,0,0,0,0,0,0,0,0,0,0,0,0,0,0,0
7164,119591,2023,Dominican Republic,Türkiye,0,0,0,0,18/06/2023,0,0,0,0,0,0,0,0,0,0,0,0,0,0,0,0,0,0,0,0
7165,119591,2023,Dominican Republic,Canada,0,0,0,0,17/06/2023,0,0,0,0,0,0,0,0,0,0,0,0,0,0,0,0,0,0,0,0
7166,119591,2023,Dominican Republic,Italy,0,0,0,0,15/06/2023,0,0,0,0,0,0,0,0,0,0,0,0,0,0,0,0,0,0,0,0
7167,119591,2023,Dominican Republic,Poland,1,2,14,17,13/06/2023,0,0,1,1,1,1,5,7,1,4,8,13,0,0,0,0,2,1,1,4
7168,119591,2023,Brazil,Dominican Republic,0,0,13,13,03/06/2023,0,0,0,0,6,3,4,13,2,2,3,7,0,0,0,0,6,0,1,7
7169,119591,2023,Dominican Republic,Netherlands,2,1,22,25,02/06/2023,0,0,6,6,2,2,1,5,6,2,5,13,0,0,0,0,3,0,0,3
7170,119591,2023,Bulgaria,Dominican Republic,1,1,17,19,01/06/2023,0,0,5,5,9,1,2,12,3,4,4,11,0,2,0,2,5,0,0,5
7171,119591,2023,Japan,Dominican Republic,1,0,11,12,30/05/2023,0,0,8,8,6,1,7,14,3,5,6,14,0,0,1,1,2,0,0,2
7172,151087,2023,Serbia,Dominican Republic,0,0,0,0,01/07/2023,0,0,0,0,0,0,0,0,0,0,0,0,0,0,0,0,0,0,0,0
7173,151087,2023,China,Dominican Republic,0,0,3,3,30/06/2023,0,1,0,1,2,3,1,6,0,0,0,0,0,0,3,3,3,0,0,3
7174,151087,2023,Dominican Republic,Korea,0,1,3,4,29/06/2023,0,0,1,1,8,1,9,18,0,1,3,4,3,1,9,13,1,2,0,3
7175,151087,2023,Germany,Dominican Republic,0,0,0,0,27/06/2023,0,1,0,1,0,0,2,2,0,0,1,1,0,0,1,1,0,0,0,0
7176,151087,2023,Dominican Republic,Türkiye,0,0,0,0,18/06/2023,0,0,0,0,0,0,0,0,0,0,0,0,0,0,0,0,0,0,0,0
7177,151087,2023,Dominican Republic,Canada,0,0,2,2,17/06/2023,0,0,1,1,0,0,0,0,0,0,0,0,0,0,0,0,0,1,0,1
7178,151087,2023,Dominican Republic,Italy,0,0,3,3,15/06/2023,0,0,0,0,0,0,0,0,0,0,0,0,0,0,0,0,0,1,0,1
7179,151087,2023,Dominican Republic,Poland,0,0,4,4,13/06/2023,0,0,0,0,0,0,0,0,0,0,0,0,0,0,0,0,0,1,1,2
7180,151087,2023,Brazil,Dominican Republic,0,0,3,3,03/06/2023,0,0,0,0,0,0,0,0,0,0,0,0,0,0,0,0,0,0,0,0
7181,151087,2023,Dominican Republic,Netherlands,0,0,2,2,02/06/2023,0,0,0,0,0,1,0,1,0,0,0,0,0,0,0,0,0,0,1,1
7182,151087,2023,Bulgaria,Dominican Republic,0,0,0,0,01/06/2023,0,0,1,1,1,0,0,1,0,0,0,0,0,0,0,0,1,0,0,1
7183,151087,2023,Japan,Dominican Republic,0,0,0,0,30/05/2023,0,0,0,0,0,0,0,0,0,0,0,0,0,0,1,1,0,0,0,0
7184,119039,2023,Serbia,Dominican Republic,0,0,0,0,01/07/2023,0,0,26,26,0,0,0,0,0,0,0,0,6,0,12,18,19,2,3,24
7185,119039,2023,China,Dominican Republic,0,0,0,0,30/06/2023,0,1,21,22,0,0,0,0,0,0,0,0,9,3,17,29,19,10,0,29
7186,119039,2023,Dominican Republic,Korea,0,0,0,0,29/06/2023,1,0,11,12,0,0,0,0,0,0,0,0,4,1,6,11,7,1,1,9
7187,119039,2023,Germany,Dominican Republic,0,0,0,0,27/06/2023,0,1,21,22,0,0,0,0,0,0,0,0,4,2,12,18,12,7,2,21
7188,119039,2023,Dominican Republic,Türkiye,0,0,0,0,18/06/2023,0,0,30,30,0,0,0,0,0,0,0,0,5,0,10,15,13,7,1,21
7189,119039,2023,Dominican Republic,Canada,0,0,0,0,17/06/2023,0,0,35,35,0,0,0,0,0,0,0,0,3,1,11,15,16,3,2,21
7190,119039,2023,Dominican Republic,Italy,0,0,0,0,15/06/2023,0,0,23,23,0,0,0,0,0,0,0,0,1,0,9,10,16,6,0,22
7191,119039,2023,Dominican Republic,Poland,0,0,0,0,13/06/2023,0,0,27,27,0,0,0,0,0,0,0,0,5,0,12,17,13,8,1,22
7192,119585,2023,Serbia,Dominican Republic,0,0,16,16,01/07/2023,7,0,102,109,1,0,1,2,1,5,6,12,0,0,2,2,8,6,1,15
7193,119585,2023,China,Dominican Republic,0,1,17,18,30/06/2023,22,1,90,113,0,0,3,3,0,1,1,2,0,0,0,0,8,2,1,11
7194,119585,2023,Dominican Republic,Korea,2,1,14,17,29/06/2023,19,2,47,68,2,0,0,2,0,2,6,8,0,0,0,0,6,1,1,8
7195,119585,2023,Germany,Dominican Republic,0,1,17,18,27/06/2023,9,1,79,89,1,0,1,2,0,1,1,2,0,0,1,1,9,3,3,15
7196,119585,2023,Dominican Republic,Türkiye,1,0,14,15,18/06/2023,7,2,88,97,0,0,3,3,0,1,2,3,0,0,0,0,6,3,0,9
7197,119585,2023,Dominican Republic,Canada,0,1,14,15,17/06/2023,11,1,76,88,1,2,0,3,0,3,3,6,0,0,0,0,5,2,0,7
7198,119585,2023,Dominican Republic,Italy,0,0,18,18,15/06/2023,16,1,85,102,0,1,0,1,0,2,5,7,0,0,0,0,14,1,2,17
7199,119585,2023,Dominican Republic,Poland,0,1,18,19,13/06/2023,6,0,92,98,1,0,0,1,0,1,2,3,0,0,0,0,9,1,5,15
7200,119585,2023,Brazil,Dominican Republic,0,2,11,13,03/06/2023,10,1,87,98,0,0,1,1,1,1,2,4,0,0,0,0,4,0,1,5
7201,119585,2023,Dominican Republic,Netherlands,0,0,15,15,02/06/2023,5,3,108,116,1,0,1,2,0,0,2,2,0,0,0,0,13,0,3,16
7202,119585,2023,Bulgaria,Dominican Republic,0,1,20,21,01/06/2023,5,2,96,103,2,0,2,4,0,2,3,5,0,0,0,0,12,0,4,16
7203,119585,2023,Japan,Dominican Republic,0,0,9,9,30/05/2023,24,1,98,123,0,0,1,1,1,1,6,8,0,0,0,0,5,1,2,8
7204,183317,2023,Serbia,Dominican Republic,0,0,0,0,01/07/2023,0,0,0,0,0,0,2,2,0,0,0,0,0,0,0,0,0,0,0,0
7205,183317,2023,Dominican Republic,Korea,0,0,0,0,29/06/2023,0,0,0,0,0,0,0,0,0,0,0,0,0,0,0,0,0,0,0,0
7206,183317,2023,Germany,Dominican Republic,0,0,0,0,27/06/2023,0,0,0,0,0,0,0,0,0,0,0,0,0,0,0,0,0,0,0,0
7207,183317,2023,Dominican Republic,Türkiye,0,0,0,0,18/06/2023,0,0,0,0,0,0,0,0,0,0,0,0,0,0,0,0,0,0,0,0
7208,183317,2023,Dominican Republic,Canada,0,0,0,0,17/06/2023,0,0,0,0,0,0,0,0,0,0,0,0,0,0,0,0,0,0,0,0
7209,183317,2023,Dominican Republic,Italy,0,0,0,0,15/06/2023,0,0,0,0,0,0,1,1,0,1,1,2,0,0,0,0,0,0,0,0
7210,183317,2023,Dominican Republic,Poland,0,0,0,0,13/06/2023,0,0,0,0,1,0,1,2,0,0,1,1,0,0,0,0,0,0,0,0
7211,183317,2023,Brazil,Dominican Republic,0,0,0,0,03/06/2023,0,0,1,1,0,0,0,0,0,0,0,0,0,0,0,0,0,0,0,0
7212,183317,2023,Dominican Republic,Netherlands,0,0,0,0,02/06/2023,0,0,0,0,0,0,0,0,0,0,0,0,0,0,0,0,0,0,0,0
7213,183317,2023,Bulgaria,Dominican Republic,0,0,0,0,01/06/2023,0,0,0,0,0,0,0,0,0,0,0,0,0,0,0,0,0,0,0,0
7214,183317,2023,Japan,Dominican Republic,0,0,0,0,30/05/2023,0,0,0,0,0,0,0,0,0,0,0,0,0,0,0,0,0,0,0,0
7215,143961,2023,Serbia,Dominican Republic,0,0,0,0,01/07/2023,0,0,0,0,0,0,0,0,0,0,0,0,0,0,0,0,0,0,0,0
7216,143961,2023,China,Dominican Republic,0,0,0,0,30/06/2023,1,0,2,3,0,0,0,0,0,0,0,0,0,0,0,0,0,0,0,0
7217,143961,2023,Dominican Republic,Korea,0,0,0,0,29/06/2023,0,0,0,0,0,0,0,0,0,0,0,0,0,0,0,0,0,0,0,0
7218,143961,2023,Germany,Dominican Republic,1,1,6,8,27/06/2023,0,0,0,0,1,1,2,4,0,0,0,0,0,0,0,0,0,1,0,1
7219,143961,2023,Dominican Republic,Türkiye,0,0,0,0,18/06/2023,0,0,0,0,0,0,0,0,0,0,0,0,0,0,0,0,0,0,0,0
7220,143961,2023,Dominican Republic,Canada,0,0,0,0,17/06/2023,0,0,0,0,0,0,0,0,0,0,0,0,0,0,0,0,0,0,0,0
7221,143961,2023,Dominican Republic,Italy,0,0,0,0,15/06/2023,0,0,0,0,0,0,0,0,0,0,0,0,0,0,0,0,0,0,0,0
7222,143961,2023,Dominican Republic,Poland,0,0,0,0,13/06/2023,0,0,0,0,0,0,0,0,0,0,0,0,0,0,0,0,0,0,0,0
7223,143961,2023,Brazil,Dominican Republic,0,0,0,0,03/06/2023,0,0,0,0,0,0,0,0,0,0,0,0,0,0,0,0,0,0,0,0
7224,143961,2023,Dominican Republic,Netherlands,0,0,0,0,02/06/2023,0,0,0,0,0,0,0,0,0,0,0,0,0,0,0,0,0,0,0,0
7225,143961,2023,Bulgaria,Dominican Republic,0,0,0,0,01/06/2023,0,0,0,0,0,0,0,0,0,0,0,0,0,0,0,0,0,0,0,0
7226,143961,2023,Japan,Dominican Republic,0,0,0,0,30/05/2023,0,0,0,0,0,0,0,0,0,0,0,0,0,0,0,0,0,0,0,0
7227,149530,2023,Serbia,Dominican Republic,0,2,7,9,01/07/2023,0,0,2,2,1,3,5,9,1,4,4,9,0,0,4,4,1,1,0,2
7228,149530,2023,China,Dominican Republic,0,3,4,7,30/06/2023,0,0,2,2,3,1,7,11,2,4,5,11,0,0,0,0,2,1,1,4
7229,149530,2023,Dominican Republic,Korea,0,2,5,7,29/06/2023,0,0,0,0,3,0,3,6,2,6,3,11,0,0,1,1,1,0,0,1
7230,149530,2023,Germany,Dominican Republic,0,1,3,4,27/06/2023,0,0,2,2,1,1,1,3,0,1,0,1,0,2,1,3,1,0,1,2
7231,149530,2023,Dominican Republic,Türkiye,1,2,6,9,18/06/2023,0,0,1,1,7,0,6,13,0,2,2,4,0,0,0,0,2,0,0,2
7232,149530,2023,Dominican Republic,Canada,0,4,11,15,17/06/2023,0,0,2,2,1,2,5,8,4,8,5,17,0,0,0,0,3,1,2,6
7233,149530,2023,Dominican Republic,Italy,0,1,7,8,15/06/2023,0,0,4,4,7,2,4,13,5,5,8,18,0,1,4,5,1,1,0,2
7234,149530,2023,Dominican Republic,Poland,0,0,0,0,13/06/2023,0,0,0,0,0,0,0,0,0,0,0,0,0,0,0,0,1,0,0,1
7235,149530,2023,Brazil,Dominican Republic,0,0,0,0,03/06/2023,0,0,5,5,0,0,0,0,0,0,0,0,0,0,0,0,0,0,0,0
7236,149530,2023,Dominican Republic,Netherlands,0,0,0,0,02/06/2023,0,0,1,1,0,0,0,0,0,1,0,1,0,0,0,0,0,0,0,0
7237,149530,2023,Bulgaria,Dominican Republic,0,0,0,0,01/06/2023,0,0,0,0,0,0,0,0,0,0,0,0,0,0,0,0,0,0,0,0
7238,149530,2023,Japan,Dominican Republic,0,0,0,0,30/05/2023,0,0,0,0,0,0,0,0,0,0,1,1,0,0,0,0,0,0,0,0
7239,139912,2023,Serbia,Dominican Republic,0,0,0,0,01/07/2023,0,0,0,0,0,0,0,0,0,0,0,0,0,0,0,0,0,0,0,0
7240,139912,2023,China,Dominican Republic,0,0,0,0,30/06/2023,0,0,0,0,0,0,0,0,0,0,0,0,0,0,0,0,0,0,0,0
7241,139912,2023,Dominican Republic,Korea,0,0,0,0,29/06/2023,0,0,0,0,0,0,0,0,0,0,0,0,0,0,0,0,0,0,0,0
7242,139912,2023,Germany,Dominican Republic,0,0,0,0,27/06/2023,0,0,6,6,0,0,0,0,0,0,0,0,0,0,0,0,0,1,0,1
7243,139912,2023,Dominican Republic,Türkiye,0,0,0,0,18/06/2023,0,0,0,0,0,0,0,0,0,0,0,0,0,0,0,0,0,0,0,0
7244,139912,2023,Dominican Republic,Canada,0,0,1,1,17/06/2023,1,0,3,4,0,0,0,0,0,0,0,0,0,0,0,0,0,0,0,0
7245,139912,2023,Dominican Republic,Italy,0,0,0,0,15/06/2023,0,0,6,6,0,0,0,0,0,0,0,0,0,0,0,0,0,1,0,1
7246,139912,2023,Dominican Republic,Poland,0,0,0,0,13/06/2023,1,0,0,1,0,0,0,0,0,0,0,0,0,0,0,0,0,0,0,0
7247,139912,2023,Brazil,Dominican Republic,0,0,1,1,03/06/2023,0,0,0,0,0,0,0,0,0,0,0,0,0,0,0,0,0,0,0,0
7248,139912,2023,Dominican Republic,Netherlands,0,0,0,0,02/06/2023,0,0,2,2,0,0,0,0,0,0,0,0,0,0,0,0,0,0,0,0
7249,139912,2023,Bulgaria,Dominican Republic,0,0,1,1,01/06/2023,0,0,5,5,0,0,0,0,0,0,0,0,0,0,0,0,0,0,0,0
7250,139912,2023,Japan,Dominican Republic,0,0,0,0,30/05/2023,0,0,0,0,0,0,0,0,0,0,0,0,0,0,0,0,0,0,0,0
7251,123978,2023,Serbia,Dominican Republic,1,1,27,29,01/07/2023,0,0,1,1,19,3,16,38,0,3,2,5,5,2,31,38,6,4,1,11
7252,123978,2023,China,Dominican Republic,0,1,7,8,30/06/2023,0,0,0,0,4,5,11,20,3,2,0,5,7,0,20,27,7,2,0,9
7253,123978,2023,Dominican Republic,Korea,2,2,9,13,29/06/2023,0,0,2,2,10,2,4,16,1,1,2,4,2,1,11,14,6,0,2,8
7254,123978,2023,Germany,Dominican Republic,0,1,13,14,27/06/2023,0,0,4,4,7,4,17,28,2,1,1,4,7,3,21,31,5,2,2,9
7255,123978,2023,Dominican Republic,Türkiye,1,0,18,19,18/06/2023,0,0,0,0,12,9,7,28,0,3,0,3,7,2,39,48,9,3,0,12
7256,123978,2023,Dominican Republic,Canada,0,2,19,21,17/06/2023,0,0,3,3,18,1,13,32,2,1,4,7,3,1,37,41,14,2,2,18
7257,123978,2023,Dominican Republic,Italy,1,1,14,16,15/06/2023,0,0,3,3,11,7,15,33,2,2,3,7,6,0,31,37,14,4,0,18
7258,123978,2023,Dominican Republic,Poland,1,3,8,12,13/06/2023,0,0,3,3,12,7,9,28,1,5,4,10,5,1,34,40,9,6,1,16
7259,123978,2023,Brazil,Dominican Republic,1,1,19,21,03/06/2023,0,0,5,5,11,5,13,29,1,1,1,3,5,1,19,25,9,0,2,11
7260,123978,2023,Dominican Republic,Netherlands,1,3,13,17,02/06/2023,0,0,1,1,13,4,16,33,0,2,1,3,8,0,17,25,12,0,3,15
7261,123978,2023,Bulgaria,Dominican Republic,1,3,16,20,01/06/2023,0,0,3,3,13,7,14,34,2,2,5,9,7,1,28,36,19,0,3,22
7262,123978,2023,Japan,Dominican Republic,0,3,13,16,30/05/2023,0,0,4,4,12,12,16,40,1,4,2,7,4,2,27,33,18,2,2,22
7263,123982,2023,Serbia,Dominican Republic,1,2,12,15,01/07/2023,0,0,5,5,25,3,23,51,1,3,2,6,1,0,15,16,10,0,0,10
7264,123982,2023,China,Dominican Republic,1,2,15,18,30/06/2023,0,0,3,3,18,6,20,44,0,2,2,4,5,1,22,28,5,3,1,9
7265,123982,2023,Dominican Republic,Korea,0,0,2,2,29/06/2023,0,0,1,1,2,1,0,3,0,0,0,0,5,0,2,7,2,0,0,2
7266,123982,2023,Germany,Dominican Republic,0,1,15,16,27/06/2023,0,0,2,2,18,2,16,36,3,3,1,7,5,1,16,22,8,4,1,13
7267,123982,2023,Dominican Republic,Türkiye,0,1,9,10,18/06/2023,0,0,2,2,6,9,18,33,1,2,0,3,4,1,16,21,0,0,0,0
7268,123982,2023,Dominican Republic,Canada,1,2,18,21,17/06/2023,0,0,5,5,12,3,22,37,4,1,4,9,1,1,19,21,9,2,1,12
7269,123982,2023,Dominican Republic,Italy,1,2,17,20,15/06/2023,0,0,3,3,14,7,21,42,3,3,1,7,3,0,25,28,9,5,2,16
7270,123982,2023,Dominican Republic,Poland,0,1,13,14,13/06/2023,0,0,0,0,19,7,21,47,2,5,2,9,2,2,22,26,5,2,0,7
7271,123982,2023,Brazil,Dominican Republic,0,3,13,16,03/06/2023,0,0,2,2,12,5,14,31,3,3,2,8,6,2,18,26,16,1,2,19
7272,123982,2023,Dominican Republic,Netherlands,0,1,14,15,02/06/2023,0,0,2,2,22,2,22,46,3,3,3,9,1,3,17,21,12,1,7,20
7273,123982,2023,Bulgaria,Dominican Republic,0,1,10,11,01/06/2023,0,0,5,5,24,5,20,49,2,2,3,7,5,2,26,33,14,0,4,18
7274,123982,2023,Japan,Dominican Republic,2,0,13,15,30/05/2023,0,0,0,0,13,3,26,42,2,0,2,4,1,1,32,34,15,4,5,24
7275,139910,2023,Serbia,Dominican Republic,0,3,8,11,01/07/2023,0,0,2,2,5,2,6,13,4,3,7,14,0,0,1,1,2,0,0,2
7276,139910,2023,China,Dominican Republic,4,1,12,17,30/06/2023,0,0,3,3,17,1,3,21,1,2,9,12,0,0,1,1,4,1,0,5
7277,139910,2023,Dominican Republic,Korea,0,1,6,7,29/06/2023,0,0,1,1,11,2,6,19,3,1,1,5,0,0,1,1,1,1,0,2
7278,139910,2023,Germany,Dominican Republic,1,1,4,6,27/06/2023,0,0,1,1,4,3,8,15,2,4,10,16,0,1,2,3,5,1,0,6
7279,139910,2023,Dominican Republic,Türkiye,2,2,5,9,18/06/2023,0,0,1,1,12,4,5,21,2,6,3,11,0,0,0,0,2,0,0,2
7280,139910,2023,Dominican Republic,Canada,0,1,7,8,17/06/2023,0,0,0,0,11,1,8,20,7,7,9,23,0,0,0,0,2,1,0,3
7281,139910,2023,Dominican Republic,Italy,1,3,11,15,15/06/2023,0,0,3,3,12,2,2,16,3,4,9,16,0,0,2,2,2,1,0,3
7282,139910,2023,Dominican Republic,Poland,0,4,7,11,13/06/2023,0,0,2,2,4,1,5,10,3,4,10,17,0,0,0,0,0,2,0,2
7283,139910,2023,Brazil,Dominican Republic,1,2,8,11,03/06/2023,0,0,3,3,7,1,6,14,4,4,10,18,0,0,0,0,3,0,1,4
7284,139910,2023,Dominican Republic,Netherlands,1,3,11,15,02/06/2023,0,0,2,2,6,1,9,16,1,6,5,12,0,0,0,0,6,0,0,6
7285,139910,2023,Bulgaria,Dominican Republic,0,0,11,11,01/06/2023,0,0,4,4,14,1,4,19,2,1,5,8,0,0,0,0,3,0,2,5
7286,139910,2023,Japan,Dominican Republic,0,2,10,12,30/05/2023,0,0,5,5,6,0,7,13,3,3,4,10,0,0,2,2,2,0,0,2
7287,139927,2023,Serbia,Dominican Republic,3,3,13,19,01/07/2023,0,0,2,2,20,7,13,40,3,3,6,12,0,0,0,0,13,6,3,22
7288,139927,2023,China,Dominican Republic,3,3,12,18,30/06/2023,0,0,6,6,29,8,14,51,3,6,1,10,0,1,1,2,5,7,1,13
7289,139927,2023,Dominican Republic,Korea,1,2,8,11,29/06/2023,0,0,0,0,12,2,12,26,4,4,1,9,0,0,0,0,12,0,0,12
7290,139927,2023,Germany,Dominican Republic,1,4,7,12,27/06/2023,0,1,2,3,15,9,13,37,1,2,3,6,0,0,0,0,8,1,1,10
7291,139927,2023,Dominican Republic,Türkiye,0,2,15,17,18/06/2023,0,0,2,2,17,8,15,40,0,3,1,4,0,0,0,0,7,2,0,9
7292,139927,2023,Dominican Republic,Canada,0,3,16,19,17/06/2023,0,0,3,3,14,7,17,38,3,4,5,12,0,0,0,0,9,2,2,13
7293,139927,2023,Dominican Republic,Italy,0,4,12,16,15/06/2023,0,0,2,2,11,8,16,35,3,4,6,13,0,0,4,4,7,5,0,12
7294,139927,2023,Dominican Republic,Poland,1,2,12,15,13/06/2023,0,0,2,2,17,9,12,38,1,2,1,4,0,0,0,0,7,5,0,12
7295,139927,2023,Brazil,Dominican Republic,1,2,13,16,03/06/2023,0,0,1,1,18,12,18,48,3,4,3,10,3,0,1,4,3,0,3,6
7296,139927,2023,Dominican Republic,Netherlands,2,2,14,18,02/06/2023,0,0,1,1,17,5,16,38,3,2,2,7,1,0,2,3,5,0,2,7
7297,139927,2023,Bulgaria,Dominican Republic,2,3,15,20,01/06/2023,0,0,4,4,16,6,14,36,1,3,5,9,0,0,3,3,11,0,1,12
7298,139927,2023,Japan,Dominican Republic,0,5,13,18,30/05/2023,0,0,5,5,11,4,24,39,3,4,7,14,0,0,3,3,14,2,3,19
7299,139913,2023,Serbia,Dominican Republic,0,1,3,4,01/07/2023,0,0,0,0,0,0,0,0,0,0,0,0,0,0,4,4,2,2,0,4
7300,139913,2023,China,Dominican Republic,0,0,8,8,30/06/2023,0,0,0,0,0,0,0,0,0,0,0,0,1,0,0,1,4,0,0,4
7301,139913,2023,Dominican Republic,Korea,0,0,9,9,29/06/2023,0,0,1,1,0,0,0,0,0,0,0,0,0,0,0,0,2,1,1,4
7302,139913,2023,Germany,Dominican Republic,0,1,1,2,27/06/2023,0,0,0,0,0,0,0,0,0,0,0,0,0,0,0,0,0,0,0,0
7303,139913,2023,Dominican Republic,Türkiye,0,0,3,3,18/06/2023,0,0,0,0,0,0,0,0,0,0,0,0,0,0,0,0,1,0,0,1
7304,139913,2023,Dominican Republic,Canada,0,0,8,8,17/06/2023,0,0,0,0,0,0,0,0,0,0,0,0,0,0,1,1,1,1,0,2
7305,139913,2023,Dominican Republic,Italy,0,0,3,3,15/06/2023,0,1,0,1,0,0,0,0,0,0,0,0,1,0,0,1,1,0,0,1
7306,139913,2023,Dominican Republic,Poland,0,1,1,2,13/06/2023,0,0,0,0,0,0,0,0,0,0,0,0,0,0,1,1,0,0,0,0
7307,139913,2023,Brazil,Dominican Republic,0,0,0,0,03/06/2023,0,0,2,2,0,0,0,0,0,0,0,0,4,0,3,7,4,0,1,5
7308,139913,2023,Dominican Republic,Netherlands,0,0,0,0,02/06/2023,0,0,0,0,0,0,0,0,0,0,0,0,2,1,3,6,3,0,0,3
7309,139913,2023,Bulgaria,Dominican Republic,0,0,0,0,01/06/2023,0,0,1,1,0,0,0,0,0,0,0,0,0,0,0,0,0,0,0,0
7310,139913,2023,Japan,Dominican Republic,0,0,0,0,30/05/2023,0,0,0,0,0,0,0,0,0,0,0,0,0,0,0,0,0,0,0,0
7311,151011,2023,Poland,Germany,0,0,0,0,12/07/2023,0,0,0,0,0,0,0,0,0,0,0,0,0,0,0,0,0,0,0,0
7312,151011,2023,Germany,USA,0,1,0,1,01/07/2023,0,0,0,0,0,0,0,0,0,0,0,0,1,0,1,2,1,0,1,2
7313,151011,2023,Germany,Serbia,0,0,1,1,30/06/2023,0,0,0,0,1,0,0,1,0,0,0,0,0,0,2,2,0,0,0,0
7314,151011,2023,Poland,Germany,0,0,0,0,29/06/2023,0,0,0,0,0,0,0,0,0,0,0,0,0,0,0,0,0,0,0,0
7315,151011,2023,Germany,Dominican Republic,0,0,0,0,27/06/2023,0,0,0,0,0,0,0,0,0,0,0,0,0,0,0,0,0,0,0,0
7316,151011,2023,Germany,Korea,0,0,0,0,18/06/2023,0,0,0,0,0,0,0,0,0,0,0,0,0,0,0,0,0,0,0,0
7317,151011,2023,Brazil,Germany,1,0,14,15,17/06/2023,0,0,7,7,9,6,16,31,2,4,3,9,2,2,22,26,8,2,0,10
7318,151011,2023,Japan,Germany,0,0,0,0,16/06/2023,0,0,0,0,0,0,0,0,0,0,0,0,0,0,1,1,0,0,0,0
7319,151011,2023,Germany,Thailand,0,0,1,1,14/06/2023,0,0,0,0,0,0,0,0,0,0,0,0,0,0,0,0,0,0,0,0
7320,151011,2023,Germany,Bulgaria,0,0,0,0,04/06/2023,0,0,0,0,0,0,0,0,0,0,0,0,0,0,0,0,0,0,0,0
7321,151011,2023,China,Germany,0,0,0,0,02/06/2023,0,0,0,0,0,0,0,0,0,0,0,0,0,0,0,0,0,0,0,0
7322,151011,2023,Croatia,Germany,0,0,0,0,01/06/2023,0,0,0,0,0,0,0,0,0,0,0,0,0,0,0,0,0,0,0,0
7323,151011,2023,Germany,Netherlands,0,0,0,0,30/05/2023,0,0,2,2,0,0,0,0,0,0,0,0,0,0,1,1,1,0,1,2
7324,150973,2023,Poland,Germany,1,0,13,14,12/07/2023,33,3,89,125,0,0,3,3,0,2,5,7,0,0,0,0,4,1,2,7
7325,150973,2023,Germany,USA,1,0,12,13,01/07/2023,11,0,70,81,0,0,1,1,1,0,1,2,0,0,0,0,8,3,2,13
7326,150973,2023,Germany,Serbia,1,0,12,13,30/06/2023,23,0,60,83,1,0,1,2,0,0,2,2,0,0,1,1,7,10,0,17
7327,150973,2023,Poland,Germany,0,1,13,14,29/06/2023,25,1,92,118,0,0,1,1,0,2,2,4,0,0,0,0,10,6,0,16
7328,150973,2023,Germany,Dominican Republic,3,2,8,13,27/06/2023,41,1,60,102,1,0,0,1,0,1,2,3,0,0,0,0,9,6,3,18
7329,150973,2023,Germany,Korea,1,1,19,21,18/06/2023,28,0,64,92,1,0,1,2,1,1,3,5,0,0,0,0,18,1,2,21
7330,150973,2023,Brazil,Germany,0,0,0,0,17/06/2023,0,0,0,0,0,0,0,0,0,0,0,0,0,0,0,0,0,0,0,0
7331,150973,2023,Japan,Germany,1,0,16,17,16/06/2023,42,1,84,127,0,0,3,3,1,4,3,8,0,0,0,0,10,4,2,16
7332,150973,2023,Germany,Thailand,1,1,16,18,14/06/2023,40,2,70,112,1,0,0,1,3,0,5,8,0,0,0,0,6,2,2,10
7333,150973,2023,Germany,Bulgaria,1,2,17,20,04/06/2023,9,0,122,131,0,1,0,1,0,4,2,6,0,0,1,1,7,0,1,8
7334,150973,2023,China,Germany,2,0,8,10,02/06/2023,11,1,66,78,0,0,1,1,0,1,1,2,0,0,0,0,2,0,0,2
7335,150973,2023,Croatia,Germany,2,1,9,12,01/06/2023,8,0,89,97,0,0,1,1,0,0,2,2,0,0,0,0,7,0,1,8
7336,150973,2023,Germany,Netherlands,0,1,15,16,30/05/2023,26,0,81,107,0,0,1,1,0,5,2,7,0,0,0,0,10,3,3,16
7337,158238,2023,Poland,Germany,0,0,0,0,12/07/2023,0,0,0,0,0,0,0,0,0,0,0,0,0,0,0,0,0,0,0,0
7338,158238,2023,Germany,USA,0,0,0,0,01/07/2023,0,0,0,0,0,0,0,0,0,0,0,0,0,0,0,0,0,1,0,1
7339,158238,2023,Germany,Serbia,0,0,0,0,30/06/2023,0,0,0,0,0,0,0,0,0,0,0,0,0,0,0,0,0,0,0,0
7340,158238,2023,Poland,Germany,0,0,0,0,29/06/2023,0,0,0,0,0,0,0,0,0,0,0,0,0,0,0,0,0,0,0,0
7341,158238,2023,Germany,Dominican Republic,0,0,0,0,27/06/2023,0,0,0,0,0,0,0,0,0,0,0,0,0,0,0,0,0,0,0,0
7342,158238,2023,Germany,Korea,0,0,0,0,18/06/2023,0,0,0,0,0,0,0,0,0,0,0,0,0,0,0,0,0,0,0,0
7343,158238,2023,Brazil,Germany,0,0,0,0,17/06/2023,0,0,11,11,0,0,0,0,0,0,0,0,4,0,22,26,14,6,3,23
7344,158238,2023,Japan,Germany,0,0,0,0,16/06/2023,0,0,0,0,0,0,0,0,0,0,0,0,0,0,0,0,0,0,0,0
7345,158238,2023,Germany,Thailand,0,0,0,0,14/06/2023,0,0,0,0,0,0,0,0,0,0,0,0,0,0,0,0,0,0,1,1
7346,158238,2023,Germany,Bulgaria,0,0,0,0,04/06/2023,0,0,0,0,0,0,0,0,0,0,0,0,0,0,0,0,0,0,0,0
7347,158238,2023,China,Germany,0,0,0,0,02/06/2023,0,0,0,0,0,0,0,0,0,0,0,0,0,0,0,0,1,0,0,1
7348,158238,2023,Croatia,Germany,0,0,0,0,01/06/2023,0,0,0,0,0,0,0,0,0,0,0,0,0,0,0,0,0,0,0,0
7349,158238,2023,Germany,Netherlands,0,0,0,0,30/05/2023,0,0,0,0,0,0,0,0,0,0,0,0,0,0,0,0,0,0,0,0
7350,136671,2023,Poland,Germany,0,0,0,0,12/07/2023,0,0,6,6,0,0,0,0,0,0,0,0,8,1,11,20,14,10,2,26
7351,136671,2023,Germany,USA,0,0,0,0,01/07/2023,0,0,17,17,0,0,0,0,0,0,0,0,2,0,12,14,15,6,4,25
7352,136671,2023,Germany,Serbia,0,0,0,0,30/06/2023,0,0,8,8,0,0,0,0,0,0,0,0,3,0,20,23,11,6,0,17
7353,136671,2023,Poland,Germany,0,0,0,0,29/06/2023,0,0,13,13,0,0,0,0,0,0,0,0,7,0,16,23,15,11,2,28
7354,136671,2023,Germany,Dominican Republic,0,0,0,0,27/06/2023,0,0,13,13,0,0,0,0,0,0,0,0,14,1,13,28,15,7,4,26
7355,136671,2023,Germany,Korea,0,0,0,0,18/06/2023,1,0,18,19,0,0,0,0,0,0,0,0,4,0,8,12,18,9,2,29
7356,136671,2023,Brazil,Germany,0,0,0,0,17/06/2023,0,0,0,0,0,0,0,0,0,0,0,0,0,0,2,2,1,2,1,4
7357,136671,2023,Japan,Germany,0,0,0,0,16/06/2023,0,0,14,14,0,0,0,0,0,0,0,0,6,2,12,20,23,3,1,27
7358,136671,2023,Germany,Thailand,0,0,0,0,14/06/2023,0,0,10,10,0,0,0,0,0,0,0,0,5,0,13,18,12,5,3,20
7359,136671,2023,Germany,Bulgaria,0,0,0,0,04/06/2023,0,0,13,13,0,0,0,0,0,0,0,0,3,1,13,17,16,0,3,19
7360,136671,2023,China,Germany,0,0,0,0,02/06/2023,0,0,7,7,0,0,0,0,0,0,0,0,5,0,16,21,11,1,1,13
7361,136671,2023,Croatia,Germany,0,0,0,0,01/06/2023,0,0,6,6,0,0,0,0,0,0,0,0,7,0,11,18,12,0,1,13
7362,136671,2023,Germany,Netherlands,0,0,0,0,30/05/2023,0,0,11,11,0,0,0,0,0,0,0,0,6,1,7,14,9,8,7,24
7363,163661,2023,Poland,Germany,0,0,1,1,12/07/2023,0,0,2,2,0,0,0,0,0,0,0,0,0,0,0,0,0,0,0,0
7364,163661,2023,Germany,USA,0,0,2,2,01/07/2023,4,0,11,15,0,0,1,1,0,0,0,0,0,0,0,0,2,1,0,3
7365,163661,2023,Germany,Serbia,0,0,3,3,30/06/2023,3,0,17,20,0,0,0,0,1,0,2,3,0,0,0,0,1,2,2,5
7366,163661,2023,Poland,Germany,0,0,0,0,29/06/2023,0,0,0,0,0,0,0,0,0,0,0,0,0,0,0,0,0,0,0,0
7367,163661,2023,Germany,Dominican Republic,0,0,1,1,27/06/2023,2,0,4,6,0,0,0,0,0,0,1,1,0,0,0,0,1,0,0,1
7368,163661,2023,Germany,Korea,0,0,0,0,18/06/2023,0,0,0,0,0,0,0,0,0,0,0,0,0,0,0,0,0,0,0,0
7369,163661,2023,Brazil,Germany,0,2,11,13,17/06/2023,32,1,82,115,0,0,1,1,0,3,4,7,0,0,0,0,7,4,3,14
7370,163661,2023,Japan,Germany,0,0,0,0,16/06/2023,0,0,3,3,0,0,0,0,0,1,0,1,0,0,0,0,1,0,0,1
7371,163661,2023,Germany,Thailand,0,0,0,0,14/06/2023,0,0,0,0,0,0,0,0,0,0,0,0,0,0,0,0,0,0,0,0
7372,163661,2023,Germany,Bulgaria,0,0,0,0,04/06/2023,0,0,0,0,0,0,0,0,0,0,0,0,0,0,0,0,0,0,0,0
7373,163661,2023,China,Germany,0,0,0,0,02/06/2023,2,0,11,13,0,0,0,0,0,0,0,0,0,0,0,0,1,0,0,1
7374,163661,2023,Croatia,Germany,0,0,0,0,01/06/2023,0,0,0,0,0,0,0,0,0,0,0,0,0,0,0,0,0,0,0,0
7375,163661,2023,Germany,Netherlands,0,0,0,0,30/05/2023,0,0,0,0,0,0,0,0,0,0,0,0,0,0,0,0,0,0,0,0
7376,157403,2023,Poland,Germany,0,0,2,2,12/07/2023,0,0,0,0,0,0,0,0,0,0,0,0,0,0,0,0,0,0,0,0
7377,157403,2023,Germany,USA,0,2,4,6,01/07/2023,0,0,1,1,2,1,2,5,0,0,3,3,1,1,10,12,1,0,1,2
7378,157403,2023,Germany,Serbia,1,1,7,9,30/06/2023,0,0,1,1,0,1,1,2,0,1,0,1,2,0,7,9,0,2,0,2
7379,157403,2023,Poland,Germany,0,0,6,6,29/06/2023,0,0,0,0,0,0,0,0,0,0,0,0,0,0,0,0,1,1,0,2
7380,157403,2023,Germany,Dominican Republic,0,0,6,6,27/06/2023,0,0,1,1,1,2,3,6,0,0,0,0,0,0,2,2,5,1,0,6
7381,157403,2023,Germany,Korea,0,1,4,5,18/06/2023,0,0,0,0,0,0,0,0,0,0,0,0,0,0,0,0,0,0,0,0
7382,157403,2023,Brazil,Germany,1,2,11,14,17/06/2023,0,0,3,3,10,3,15,28,0,2,0,2,3,3,17,23,9,3,1,13
7383,157403,2023,Japan,Germany,0,1,6,7,16/06/2023,0,0,0,0,0,0,0,0,0,0,0,0,1,2,0,3,1,0,0,1
7384,157403,2023,Germany,Thailand,0,0,7,7,14/06/2023,0,0,1,1,0,0,3,3,0,0,1,1,0,0,4,4,1,2,0,3
7385,157403,2023,Germany,Bulgaria,0,0,9,9,04/06/2023,0,0,0,0,0,0,1,1,0,0,0,0,0,0,0,0,0,0,0,0
7386,157403,2023,China,Germany,0,2,2,4,02/06/2023,0,0,0,0,0,0,0,0,0,0,0,0,1,0,1,2,0,0,1,1
7387,157403,2023,Croatia,Germany,1,0,4,5,01/06/2023,0,0,0,0,0,0,0,0,0,0,0,0,0,0,0,0,1,0,0,1
7388,157403,2023,Germany,Netherlands,1,0,4,5,30/05/2023,0,0,0,0,0,0,0,0,0,0,0,0,0,0,0,0,0,0,0,0
7389,163658,2023,Poland,Germany,1,2,10,13,12/07/2023,0,0,3,3,14,3,23,40,0,1,0,1,5,0,13,18,12,5,1,18
7390,163658,2023,Germany,USA,0,2,10,12,01/07/2023,0,0,5,5,8,2,12,22,0,4,3,7,11,4,20,35,5,2,2,9
7391,163658,2023,Germany,Serbia,0,2,7,9,30/06/2023,0,0,3,3,13,2,17,32,1,3,2,6,5,2,5,12,3,3,1,7
7392,163658,2023,Poland,Germany,0,1,14,15,29/06/2023,0,0,1,1,20,6,12,38,2,1,1,4,11,1,16,28,9,3,2,14
7393,163658,2023,Germany,Dominican Republic,2,1,8,11,27/06/2023,0,0,1,1,2,3,21,26,0,2,2,4,2,0,4,6,11,3,0,14
7394,163658,2023,Germany,Korea,1,2,24,27,18/06/2023,1,0,5,6,14,2,14,30,4,1,2,7,5,2,9,16,12,3,0,15
7395,163658,2023,Brazil,Germany,0,0,0,0,17/06/2023,0,0,0,0,0,0,0,0,0,0,0,0,0,0,0,0,0,0,0,0
7396,163658,2023,Japan,Germany,1,0,17,18,16/06/2023,0,0,5,5,14,5,14,33,1,3,2,6,10,0,17,27,10,4,3,17
7397,163658,2023,Germany,Thailand,0,1,7,8,14/06/2023,1,0,2,3,6,4,11,21,2,4,2,8,2,0,2,4,9,1,3,13
7398,163658,2023,Germany,Bulgaria,2,3,12,17,04/06/2023,0,0,1,1,11,4,15,30,3,1,2,6,10,1,20,31,15,0,4,19
7399,163658,2023,China,Germany,0,2,7,9,02/06/2023,0,0,0,0,8,2,11,21,1,1,0,2,1,0,5,6,3,0,0,3
7400,163658,2023,Croatia,Germany,0,0,7,7,01/06/2023,0,0,2,2,6,9,14,29,0,0,0,0,10,2,18,30,11,1,4,16
7401,163658,2023,Germany,Netherlands,0,0,16,16,30/05/2023,0,0,1,1,10,4,18,32,5,2,2,9,8,3,22,33,4,3,7,14
7402,144980,2023,Poland,Germany,0,0,9,9,12/07/2023,0,0,2,2,8,3,9,20,2,3,4,9,16,0,23,39,7,5,1,13
7403,144980,2023,Germany,USA,0,1,5,6,01/07/2023,0,0,10,10,10,3,20,33,0,1,5,6,2,1,8,11,6,1,0,7
7404,144980,2023,Germany,Serbia,0,1,6,7,30/06/2023,0,0,2,2,7,4,11,22,0,1,1,2,14,1,18,33,7,4,1,12
7405,144980,2023,Poland,Germany,2,0,14,16,29/06/2023,0,0,5,5,13,4,14,31,1,4,4,9,6,2,23,31,11,2,0,13
7406,144980,2023,Germany,Dominican Republic,1,0,10,11,27/06/2023,0,0,1,1,17,4,10,31,1,1,1,3,6,0,8,14,5,4,0,9
7407,144980,2023,Germany,Korea,0,0,6,6,18/06/2023,0,0,1,1,13,2,11,26,2,2,3,7,5,2,18,25,7,3,4,14
7408,144980,2023,Brazil,Germany,0,0,3,3,17/06/2023,0,0,0,0,1,0,1,2,0,2,1,3,1,1,6,8,1,1,0,2
7409,144980,2023,Japan,Germany,0,1,11,12,16/06/2023,0,0,5,5,8,2,22,32,2,3,2,7,4,1,31,36,13,3,1,17
7410,144980,2023,Germany,Thailand,0,2,12,14,14/06/2023,0,0,2,2,12,0,11,23,1,3,1,5,5,0,22,27,8,4,1,13
7411,144980,2023,Germany,Bulgaria,1,0,10,11,04/06/2023,0,0,2,2,15,2,19,36,1,3,3,7,3,2,21,26,8,0,0,8
7412,144980,2023,China,Germany,0,0,7,7,02/06/2023,0,0,2,2,5,2,10,17,0,1,1,2,3,0,9,12,8,0,1,9
7413,144980,2023,Croatia,Germany,2,0,10,12,01/06/2023,0,0,4,4,8,2,9,19,1,1,0,2,1,0,6,7,4,0,0,4
7414,144980,2023,Germany,Netherlands,1,0,10,11,30/05/2023,0,0,2,2,8,6,14,28,0,2,4,6,9,2,17,28,7,0,4,11
7415,151016,2023,Poland,Germany,1,3,7,11,12/07/2023,0,0,1,1,21,8,21,50,0,0,4,4,4,0,7,11,6,1,1,8
7416,151016,2023,Germany,USA,0,1,5,6,01/07/2023,0,1,1,2,13,3,18,34,0,5,2,7,4,0,8,12,6,4,2,12
7417,151016,2023,Germany,Serbia,0,4,4,8,30/06/2023,0,0,2,2,7,4,12,23,1,2,1,4,1,0,6,7,4,6,1,11
7418,151016,2023,Poland,Germany,1,3,11,15,29/06/2023,0,0,7,7,16,9,25,50,2,1,4,7,0,1,6,7,8,4,1,13
7419,151016,2023,Germany,Dominican Republic,0,4,11,15,27/06/2023,0,0,2,2,16,8,12,36,3,2,2,7,11,1,8,20,5,0,0,5
7420,151016,2023,Germany,Korea,2,3,12,17,18/06/2023,0,0,2,2,21,4,14,39,0,2,4,6,5,0,6,11,6,1,2,9
7421,151016,2023,Brazil,Germany,0,0,0,0,17/06/2023,0,0,0,0,2,3,3,8,0,0,1,1,0,0,3,3,1,0,0,1
7422,151016,2023,Japan,Germany,1,4,7,12,16/06/2023,0,0,3,3,21,6,25,52,1,1,7,9,0,1,6,7,8,1,2,11
7423,151016,2023,Germany,Thailand,1,5,1,7,14/06/2023,0,0,0,0,13,5,15,33,2,3,1,6,7,1,14,22,9,1,1,11
7424,151016,2023,Germany,Bulgaria,0,6,8,14,04/06/2023,0,0,1,1,13,6,20,39,0,1,1,2,3,1,12,16,9,1,4,14
7425,151016,2023,China,Germany,2,2,7,11,02/06/2023,0,0,0,0,15,7,14,36,2,0,3,5,10,0,19,29,6,0,4,10
7426,151016,2023,Croatia,Germany,3,2,7,12,01/06/2023,0,0,1,1,20,4,13,37,0,3,0,3,0,0,4,4,7,1,0,8
7427,151016,2023,Germany,Netherlands,5,2,11,18,30/05/2023,0,0,2,2,18,5,14,37,1,1,5,7,0,0,0,0,8,1,3,12
7428,150812,2023,Poland,Germany,0,1,5,6,12/07/2023,0,0,2,2,4,2,4,10,0,2,4,6,0,0,0,0,2,0,0,2
7429,150812,2023,Germany,USA,0,1,4,5,01/07/2023,0,0,0,0,5,1,6,12,2,7,4,13,0,0,0,0,0,3,0,3
7430,150812,2023,Germany,Serbia,0,1,5,6,30/06/2023,0,0,1,1,5,0,2,7,0,1,2,3,0,0,0,0,2,0,1,3
7431,150812,2023,Poland,Germany,0,0,0,0,29/06/2023,0,0,0,0,0,0,0,0,0,0,0,0,0,0,0,0,0,0,0,0
7432,150812,2023,Germany,Dominican Republic,0,0,1,1,27/06/2023,0,0,0,0,2,2,1,5,0,3,2,5,0,0,0,0,1,0,0,1
7433,150812,2023,Germany,Korea,0,0,4,4,18/06/2023,0,0,1,1,3,2,4,9,1,2,3,6,1,0,0,1,2,1,1,4
7434,150812,2023,Brazil,Germany,0,0,0,0,17/06/2023,0,0,0,0,0,0,0,0,0,0,0,0,0,0,0,0,0,0,0,0
7435,150812,2023,Japan,Germany,0,1,8,9,16/06/2023,0,0,0,0,11,2,6,19,5,5,6,16,0,0,0,0,5,1,0,6
7436,150812,2023,Germany,Thailand,1,1,14,16,14/06/2023,0,0,1,1,12,3,10,25,1,3,4,8,0,0,0,0,1,1,0,2
7437,150812,2023,Germany,Bulgaria,0,1,7,8,04/06/2023,0,0,1,1,8,2,6,16,4,6,6,16,0,0,0,0,2,0,1,3
7438,150812,2023,China,Germany,0,0,3,3,02/06/2023,0,0,0,0,5,2,4,11,0,0,4,4,0,0,0,0,2,0,0,2
7439,150812,2023,Croatia,Germany,1,0,4,5,01/06/2023,0,0,2,2,7,1,4,12,1,5,2,8,1,0,0,1,4,1,0,5
7440,150812,2023,Germany,Netherlands,0,0,2,2,30/05/2023,0,0,0,0,2,2,1,5,0,3,2,5,0,0,0,0,0,0,1,1
7441,177765,2023,Poland,Germany,0,0,0,0,12/07/2023,0,0,1,1,0,0,0,0,0,0,0,0,0,0,0,0,0,0,0,0
7442,177765,2023,Germany,Korea,0,0,0,0,18/06/2023,0,0,0,0,0,0,0,0,0,0,0,0,0,0,0,0,0,0,0,0
7443,177765,2023,Brazil,Germany,0,3,5,8,17/06/2023,0,0,0,0,0,1,4,5,0,5,1,6,0,0,0,0,2,1,0,3
7444,177765,2023,Japan,Germany,0,0,0,0,16/06/2023,0,0,0,0,0,0,0,0,0,0,0,0,0,0,0,0,0,0,0,0
7445,177765,2023,Germany,Thailand,0,0,0,0,14/06/2023,0,0,0,0,0,0,0,0,0,0,0,0,0,0,0,0,0,0,0,0
7446,177765,2023,Germany,Bulgaria,0,0,0,0,04/06/2023,0,0,0,0,0,0,0,0,0,0,0,0,0,0,0,0,0,0,0,0
7447,177765,2023,China,Germany,0,0,0,0,02/06/2023,0,0,0,0,0,0,0,0,0,0,0,0,0,0,0,0,0,0,0,0
7448,177765,2023,Croatia,Germany,0,0,0,0,01/06/2023,0,0,0,0,0,0,0,0,0,0,0,0,0,0,0,0,0,0,0,0
7449,177765,2023,Germany,Netherlands,0,0,0,0,30/05/2023,0,0,0,0,0,0,0,0,0,0,0,0,0,0,0,0,0,0,0,0
7450,163939,2023,Poland,Germany,1,0,5,6,12/07/2023,0,0,0,0,0,2,3,5,0,2,0,2,0,0,0,0,0,0,0,0
7451,163939,2023,Germany,USA,2,1,6,9,01/07/2023,0,0,0,0,1,1,6,8,2,0,1,3,0,0,0,0,3,0,0,3
7452,163939,2023,Germany,Serbia,0,0,7,7,30/06/2023,0,0,0,0,3,4,4,11,1,0,0,1,0,0,0,0,2,2,0,4
7453,163939,2023,Poland,Germany,0,0,0,0,29/06/2023,0,0,0,0,0,0,0,0,0,0,1,1,0,0,0,0,0,0,0,0
7454,163939,2023,Germany,Dominican Republic,0,0,1,1,27/06/2023,0,0,0,0,2,2,3,7,0,0,1,1,0,0,0,0,1,0,0,1
7455,163939,2023,Germany,Korea,0,0,0,0,18/06/2023,0,0,0,0,0,0,0,0,0,0,0,0,0,0,0,0,0,0,0,0
7456,163939,2023,Brazil,Germany,0,1,11,12,17/06/2023,0,0,0,0,26,5,13,44,2,3,3,8,0,0,0,0,13,2,4,19
7457,163939,2023,Japan,Germany,0,0,2,2,16/06/2023,0,0,0,0,3,0,1,4,0,0,0,0,0,0,0,0,0,0,0,0
7458,163939,2023,Germany,Thailand,0,0,3,3,14/06/2023,0,0,0,0,0,1,3,4,1,0,1,2,0,0,0,0,3,0,1,4
7459,153929,2023,Poland,Germany,2,2,10,14,12/07/2023,0,0,1,1,10,0,3,13,1,4,6,11,0,1,0,1,4,0,0,4
7460,153929,2023,Germany,USA,0,2,14,16,01/07/2023,0,0,7,7,8,1,12,21,7,6,10,23,0,0,0,0,3,0,1,4
7461,153929,2023,Germany,Serbia,2,1,12,15,30/06/2023,0,1,6,7,14,1,11,26,0,3,9,12,0,0,0,0,3,1,2,6
7462,153929,2023,Poland,Germany,1,2,17,20,29/06/2023,0,0,5,5,11,0,8,19,4,10,8,22,1,0,0,1,7,0,1,8
7463,153929,2023,Germany,Dominican Republic,2,1,15,18,27/06/2023,0,0,1,1,5,0,9,14,0,5,7,12,0,0,0,0,1,0,0,1
7464,153929,2023,Germany,Korea,1,2,12,15,18/06/2023,0,0,1,1,8,3,2,13,3,4,9,16,0,0,0,0,2,1,0,3
7465,153929,2023,Brazil,Germany,1,0,4,5,17/06/2023,0,0,5,5,1,0,0,1,4,1,3,8,0,0,0,0,0,0,0,0
7466,153929,2023,Japan,Germany,3,2,13,18,16/06/2023,0,0,2,2,8,2,12,22,2,9,8,19,0,0,0,0,4,4,1,9
7467,153929,2023,Germany,Thailand,1,0,15,16,14/06/2023,0,0,3,3,13,0,11,24,3,5,9,17,0,0,0,0,4,0,1,5
7468,153929,2023,Germany,Bulgaria,2,1,16,19,04/06/2023,0,0,1,1,9,1,10,20,3,3,3,9,0,0,0,0,3,0,0,3
7469,153929,2023,China,Germany,1,3,10,14,02/06/2023,0,0,2,2,6,0,8,14,1,4,1,6,0,0,0,0,2,0,0,2
7470,153929,2023,Croatia,Germany,1,2,12,15,01/06/2023,0,0,1,1,9,1,9,19,3,1,8,12,1,0,1,2,5,0,0,5
7471,153929,2023,Germany,Netherlands,1,2,11,14,30/05/2023,0,0,2,2,7,2,5,14,4,4,9,17,0,0,0,0,2,1,3,6
7472,182628,2023,Poland,Germany,0,1,6,7,12/07/2023,0,0,2,2,0,1,2,3,2,3,4,9,0,0,0,0,4,0,1,5
7473,182628,2023,Germany,USA,2,0,5,7,01/07/2023,0,0,1,1,1,0,0,1,0,0,0,0,0,0,0,0,0,2,0,2
7474,182628,2023,Germany,Serbia,1,0,6,7,30/06/2023,0,0,0,0,0,1,2,3,1,1,3,5,0,0,0,0,1,1,1,3
7475,182628,2023,Poland,Germany,0,1,17,18,29/06/2023,0,0,2,2,5,2,5,12,3,9,9,21,0,0,0,0,3,1,2,6
7476,182628,2023,Germany,Dominican Republic,1,1,13,15,27/06/2023,0,0,1,1,3,1,3,7,2,2,6,10,0,0,0,0,2,0,0,2
7477,182628,2023,Germany,Korea,0,1,3,4,18/06/2023,0,0,1,1,0,0,1,1,0,1,2,3,0,0,1,1,0,1,0,1
7478,182628,2023,Brazil,Germany,0,1,12,13,17/06/2023,0,0,2,2,7,2,10,19,0,3,12,15,0,0,0,0,1,2,2,5
7479,182628,2023,Japan,Germany,0,0,3,3,16/06/2023,0,0,0,0,0,0,0,0,0,0,0,0,0,0,0,0,0,0,0,0
7480,182628,2023,Germany,Thailand,0,0,3,3,14/06/2023,0,0,1,1,0,0,0,0,0,0,0,0,0,0,0,0,1,0,0,1
7481,182628,2023,Germany,Bulgaria,0,1,2,3,04/06/2023,0,0,0,0,0,0,0,0,0,0,0,0,0,0,0,0,1,0,0,1
7482,182628,2023,China,Germany,0,0,4,4,02/06/2023,0,0,0,0,0,1,0,1,0,1,0,1,0,0,0,0,0,0,0,0
7483,182628,2023,Croatia,Germany,0,1,4,5,01/06/2023,0,0,1,1,0,0,0,0,0,1,1,2,0,0,0,0,0,0,0,0
7484,182628,2023,Germany,Netherlands,1,1,10,12,30/05/2023,0,0,0,0,3,1,4,8,1,1,2,4,0,0,0,0,1,0,1,2
7485,143370,2023,Türkiye,Italy,0,1,4,5,13/07/2023,0,0,1,1,7,2,2,11,0,1,0,1,1,0,7,8,2,2,0,4
7486,143370,2023,Italy,Japan,0,2,1,3,02/07/2023,0,0,1,1,5,3,7,15,1,0,1,2,2,0,13,15,6,0,1,7
7487,143370,2023,Italy,Croatia,2,2,8,12,01/07/2023,0,1,4,5,11,4,11,26,0,0,6,6,6,1,19,26,11,0,0,11
7488,143370,2023,Canada,Italy,4,1,15,20,30/06/2023,0,0,3,3,15,5,13,33,2,2,4,8,2,2,15,19,7,1,1,9
7489,143370,2023,Brazil,Italy,0,2,0,2,28/06/2023,0,0,2,2,2,3,3,8,0,0,1,1,1,1,6,8,0,0,1,1
7490,143370,2023,Italy,China,0,2,5,7,18/06/2023,0,0,0,0,14,4,4,22,0,0,0,0,2,0,19,21,3,2,1,6
7491,143370,2023,Netherlands,Italy,0,0,0,0,17/06/2023,0,0,0,0,0,0,0,0,0,0,0,0,0,0,0,0,0,0,0,0
7492,143370,2023,Dominican Republic,Italy,0,0,2,2,15/06/2023,0,0,0,0,1,1,1,3,0,1,0,1,0,0,4,4,0,1,0,1
7493,143370,2023,Italy,Bulgaria,0,0,0,0,14/06/2023,0,0,0,0,0,0,0,0,0,0,0,0,0,0,0,0,0,0,0,0
7494,143370,2023,Türkiye,Italy,0,3,7,10,03/06/2023,0,1,0,1,11,9,8,28,2,3,2,7,9,0,22,31,4,1,0,5
7495,143370,2023,USA,Italy,0,0,0,0,02/06/2023,0,0,0,0,0,0,0,0,0,0,0,0,0,0,0,0,0,0,0,0
7496,143370,2023,Poland,Italy,0,4,3,7,01/06/2023,0,0,1,1,9,5,11,25,2,2,4,8,5,0,18,23,3,1,0,4
7497,143370,2023,Italy,Thailand,2,2,6,10,30/05/2023,0,0,2,2,7,6,10,23,1,2,3,6,4,1,18,23,5,2,1,8
7498,142394,2023,Türkiye,Italy,2,1,7,10,13/07/2023,0,0,2,2,9,5,10,24,0,3,0,3,6,1,21,28,1,3,2,6
7499,142394,2023,Italy,Japan,0,1,0,1,02/07/2023,0,0,1,1,2,4,2,8,0,0,0,0,0,2,7,9,1,2,0,3
7500,142394,2023,Italy,Croatia,1,0,5,6,01/07/2023,0,0,7,7,3,2,6,11,1,0,1,2,4,0,4,8,1,0,0,1
7501,142394,2023,Canada,Italy,1,4,13,18,30/06/2023,0,0,4,4,19,6,13,38,1,1,1,3,12,2,23,37,11,2,1,14
7502,142394,2023,Brazil,Italy,0,2,11,13,28/06/2023,0,0,6,6,19,4,16,39,2,0,1,3,4,2,26,32,10,4,1,15
7503,151986,2023,Türkiye,Italy,0,3,9,12,13/07/2023,12,0,62,74,0,0,0,0,2,1,3,6,0,0,0,0,2,2,0,4
7504,151986,2023,Italy,Japan,1,0,16,17,02/07/2023,11,0,96,107,0,0,2,2,2,3,6,11,0,0,0,0,4,1,1,6
7505,151986,2023,Italy,Croatia,0,0,14,14,01/07/2023,11,0,63,74,2,1,0,3,2,1,2,5,0,0,0,0,11,0,1,12
7506,151986,2023,Canada,Italy,1,0,15,16,30/06/2023,26,0,95,121,0,0,0,0,2,1,0,3,0,0,0,0,3,4,0,7
7507,151986,2023,Brazil,Italy,0,1,11,12,28/06/2023,13,0,93,106,1,1,2,4,2,4,5,11,0,0,0,0,6,3,0,9
7508,151986,2023,Italy,China,0,1,12,13,18/06/2023,27,0,89,116,0,0,2,2,1,1,3,5,0,0,0,0,7,1,2,10
7509,151986,2023,Netherlands,Italy,0,0,15,15,17/06/2023,21,0,95,116,0,0,1,1,2,2,3,7,0,0,0,0,7,5,1,13
7510,151986,2023,Dominican Republic,Italy,0,0,12,12,15/06/2023,32,1,81,114,0,0,0,0,2,3,7,12,0,0,0,0,6,4,0,10
7511,151986,2023,Italy,Bulgaria,0,0,11,11,14/06/2023,12,0,57,69,2,1,0,3,1,5,8,14,0,1,0,1,9,3,0,12
7512,151986,2023,Türkiye,Italy,0,0,12,12,03/06/2023,9,0,67,76,0,0,0,0,0,3,1,4,0,0,0,0,3,1,1,5
7513,151986,2023,USA,Italy,0,1,13,14,02/06/2023,3,2,97,102,2,0,1,3,2,0,5,7,0,0,0,0,6,1,4,11
7514,151986,2023,Poland,Italy,2,0,10,12,01/06/2023,17,1,74,92,0,0,0,0,0,3,3,6,0,0,0,0,2,2,2,6
7515,151986,2023,Italy,Thailand,0,0,19,19,30/05/2023,25,0,110,135,1,0,0,1,2,3,4,9,0,0,0,0,5,4,4,13
7516,173402,2023,Türkiye,Italy,0,0,0,0,13/07/2023,0,0,3,3,0,0,0,0,0,0,0,0,0,1,8,9,8,2,0,10
7517,173402,2023,Italy,Croatia,0,0,0,0,01/07/2023,0,0,0,0,0,0,0,0,0,0,0,0,0,0,0,0,0,0,0,0
7518,173402,2023,Canada,Italy,0,0,0,0,30/06/2023,0,0,6,6,0,0,0,0,0,0,0,0,9,1,13,23,18,3,2,23
7519,173402,2023,Brazil,Italy,0,0,0,0,28/06/2023,0,0,12,12,0,0,0,0,0,0,0,0,3,0,11,14,8,4,4,16
7520,173402,2023,Italy,China,0,0,0,0,18/06/2023,0,1,4,5,0,0,0,0,0,0,0,0,4,0,4,8,15,2,3,20
7521,173402,2023,Netherlands,Italy,0,0,0,0,17/06/2023,0,0,1,1,0,0,0,0,0,0,0,0,2,1,2,5,0,0,2,2
7522,173402,2023,Dominican Republic,Italy,0,0,0,0,15/06/2023,0,0,3,3,0,0,0,0,0,0,0,0,1,0,2,3,1,2,0,3
7523,173402,2023,Italy,Bulgaria,0,0,0,0,14/06/2023,0,0,0,0,0,0,0,0,0,0,0,0,2,0,0,2,0,1,0,1
7524,136694,2023,Türkiye,Italy,0,0,5,5,13/07/2023,0,0,0,0,1,2,5,8,1,2,6,9,0,0,1,1,0,1,0,1
7525,136694,2023,Italy,Japan,1,1,15,17,02/07/2023,0,0,2,2,4,1,8,13,4,3,5,12,0,0,0,0,5,0,0,5
7526,136694,2023,Italy,Croatia,2,0,10,12,01/07/2023,0,0,1,1,3,1,3,7,4,2,2,8,1,0,0,1,1,1,0,2
7527,136694,2023,Canada,Italy,0,3,16,19,30/06/2023,0,0,0,0,7,2,4,13,3,6,4,13,0,0,0,0,3,1,0,4
7528,136694,2023,Brazil,Italy,0,0,12,12,28/06/2023,0,0,1,1,5,0,5,10,0,7,1,8,0,0,0,0,3,4,0,7
7529,136694,2023,Italy,China,0,0,15,15,18/06/2023,0,0,3,3,8,4,3,15,2,2,3,7,0,0,0,0,2,1,0,3
7530,136694,2023,Netherlands,Italy,2,1,14,17,17/06/2023,0,0,1,1,10,1,2,13,5,6,5,16,0,0,0,0,2,2,0,4
7531,136694,2023,Dominican Republic,Italy,1,3,11,15,15/06/2023,0,0,2,2,8,3,4,15,2,6,7,15,0,0,2,2,0,2,0,2
7532,136694,2023,Italy,Bulgaria,0,1,12,13,14/06/2023,0,0,0,0,6,0,2,8,0,0,4,4,2,0,1,3,0,0,1,1
7533,136694,2023,Türkiye,Italy,0,0,0,0,03/06/2023,0,0,0,0,0,0,0,0,0,0,0,0,0,0,0,0,0,0,0,0
7534,136694,2023,USA,Italy,0,1,10,11,02/06/2023,0,0,1,1,2,2,3,7,2,3,4,9,0,1,1,2,0,2,0,2
7535,136694,2023,Poland,Italy,0,0,10,10,01/06/2023,0,0,0,0,5,1,4,10,2,4,3,9,0,0,0,0,0,0,0,0
7536,136694,2023,Italy,Thailand,0,1,14,15,30/05/2023,0,0,1,1,9,2,4,15,3,6,9,18,0,0,0,0,3,2,0,5
7537,151661,2023,Türkiye,Italy,0,1,4,5,13/07/2023,0,0,0,0,4,1,1,6,0,2,1,3,0,0,0,0,0,0,1,1
7538,151661,2023,Italy,Japan,0,1,9,10,02/07/2023,0,0,0,0,2,0,0,2,2,1,3,6,0,1,1,2,3,0,2,5
7539,151661,2023,Italy,Croatia,1,2,8,11,01/07/2023,0,0,2,2,3,1,3,7,0,1,3,4,1,0,1,2,2,0,0,2
7540,151661,2023,Canada,Italy,0,0,11,11,30/06/2023,0,0,1,1,7,1,2,10,6,0,7,13,0,0,0,0,5,3,1,9
7541,151661,2023,Brazil,Italy,0,0,11,11,28/06/2023,0,0,3,3,5,0,2,7,3,4,9,16,0,0,0,0,3,0,1,4
7542,151661,2023,Italy,China,1,2,10,13,18/06/2023,0,0,1,1,6,0,4,10,3,3,4,10,0,0,0,0,5,1,2,8
7543,151661,2023,Netherlands,Italy,0,0,13,13,17/06/2023,0,0,0,0,3,1,4,8,1,2,4,7,0,0,1,1,3,1,2,6
7544,151661,2023,Dominican Republic,Italy,0,1,5,6,15/06/2023,0,0,0,0,2,0,1,3,0,1,2,3,0,0,0,0,1,0,0,1
7545,151661,2023,Italy,Bulgaria,1,1,13,15,14/06/2023,0,0,0,0,3,0,6,9,4,3,2,9,0,0,0,0,3,0,1,4
7546,151661,2023,Türkiye,Italy,0,0,11,11,03/06/2023,0,0,2,2,4,0,2,6,1,5,1,7,0,0,1,1,3,0,0,3
7547,151661,2023,USA,Italy,0,1,2,3,02/06/2023,0,0,0,0,1,0,0,1,0,1,1,2,0,0,0,0,0,0,0,0
7548,151661,2023,Poland,Italy,0,0,1,1,01/06/2023,0,0,0,0,0,0,0,0,0,2,0,2,0,0,0,0,0,0,0,0
7549,151661,2023,Italy,Thailand,1,1,21,23,30/05/2023,0,0,1,1,7,1,7,15,0,2,5,7,0,0,0,0,6,2,4,12
7550,151664,2023,Türkiye,Italy,0,1,6,7,13/07/2023,0,0,1,1,8,8,9,25,2,1,3,6,0,0,0,0,5,5,1,11
7551,151664,2023,Italy,Japan,0,1,14,15,02/07/2023,0,0,4,4,18,6,18,42,5,5,10,20,0,0,0,0,9,3,1,13
7552,151664,2023,Italy,Croatia,0,0,10,10,01/07/2023,0,0,1,1,17,7,10,34,3,2,1,6,0,0,0,0,8,1,1,10
7553,151664,2023,Canada,Italy,0,4,15,19,30/06/2023,0,0,2,2,14,6,17,37,3,3,0,6,0,0,0,0,3,1,0,4
7554,151664,2023,Brazil,Italy,0,2,15,17,28/06/2023,0,0,0,0,20,7,14,41,1,3,3,7,0,0,1,1,5,6,4,15
7555,151664,2023,Italy,China,0,3,11,14,18/06/2023,0,0,3,3,12,5,16,33,3,0,0,3,0,0,0,0,8,0,1,9
7556,151664,2023,Netherlands,Italy,0,1,17,18,17/06/2023,0,0,1,1,22,9,16,47,1,5,0,6,0,0,0,0,10,6,2,18
7557,151664,2023,Dominican Republic,Italy,0,2,16,18,15/06/2023,0,0,4,4,18,7,17,42,3,3,5,11,0,0,0,0,10,2,0,12
7558,151664,2023,Italy,Bulgaria,1,1,14,16,14/06/2023,0,0,3,3,15,2,8,25,2,6,6,14,0,0,0,0,5,4,1,10
7559,151664,2023,Türkiye,Italy,0,2,9,11,03/06/2023,0,0,0,0,15,5,10,30,2,0,0,2,0,0,0,0,6,5,1,12
7560,151664,2023,USA,Italy,0,2,20,22,02/06/2023,0,0,1,1,17,7,15,39,3,3,1,7,0,0,0,0,15,1,2,18
7561,151664,2023,Poland,Italy,1,1,10,12,01/06/2023,0,0,1,1,15,3,13,31,1,2,6,9,0,0,0,0,4,3,1,8
7562,151664,2023,Italy,Thailand,1,3,7,11,30/05/2023,0,0,2,2,19,5,17,41,4,1,2,7,0,0,0,0,2,2,0,4
7563,143391,2023,Türkiye,Italy,0,0,0,0,13/07/2023,0,0,0,0,0,0,0,0,0,0,0,0,0,0,0,0,0,0,0,0
7564,143391,2023,Italy,Japan,0,2,2,4,02/07/2023,0,0,2,2,8,2,9,19,0,2,3,5,4,4,18,26,5,0,1,6
7565,143391,2023,Italy,Croatia,0,0,2,2,01/07/2023,0,0,1,1,2,0,1,3,0,0,0,0,0,0,1,1,3,0,0,3
7566,143391,2023,Canada,Italy,0,0,0,0,30/06/2023,0,0,0,0,0,0,0,0,0,0,0,0,0,0,0,0,0,0,0,0
7567,143391,2023,Brazil,Italy,0,2,0,2,28/06/2023,0,0,0,0,0,0,0,0,0,0,0,0,1,1,1,3,1,0,0,1
7568,143391,2023,Italy,China,1,0,3,4,18/06/2023,0,0,0,0,0,0,0,0,0,0,0,0,1,1,0,2,2,0,0,2
7569,143391,2023,Netherlands,Italy,0,0,0,0,17/06/2023,0,0,0,0,0,0,0,0,0,0,0,0,0,0,0,0,0,0,0,0
7570,143391,2023,Dominican Republic,Italy,0,0,0,0,15/06/2023,0,0,0,0,0,0,0,0,0,0,0,0,0,0,0,0,0,0,0,0
7571,143391,2023,Italy,Bulgaria,0,0,0,0,14/06/2023,0,0,0,0,0,0,0,0,0,0,0,0,0,0,0,0,0,0,0,0
7572,143391,2023,Türkiye,Italy,0,0,2,2,03/06/2023,0,0,1,1,3,2,3,8,0,0,0,0,0,0,3,3,3,0,0,3
7573,143391,2023,USA,Italy,0,0,0,0,02/06/2023,0,0,0,0,0,0,0,0,0,0,0,0,0,0,0,0,0,0,0,0
7574,143391,2023,Poland,Italy,0,2,4,6,01/06/2023,0,0,1,1,3,2,6,11,1,2,0,3,2,1,10,13,2,0,0,2
7575,143391,2023,Italy,Thailand,0,3,8,11,30/05/2023,0,0,3,3,8,2,7,17,1,0,2,3,6,0,17,23,6,3,3,12
7576,136701,2023,Türkiye,Italy,1,0,3,4,13/07/2023,0,0,2,2,3,5,7,15,1,1,0,2,6,0,13,19,3,0,0,3
7577,136701,2023,Italy,China,0,0,16,16,18/06/2023,0,0,8,8,15,2,20,37,0,0,1,1,11,1,24,36,5,5,2,12
7578,136701,2023,Netherlands,Italy,1,2,16,19,17/06/2023,0,0,6,6,23,5,12,40,2,5,1,8,11,3,42,56,11,7,3,21
7579,136701,2023,Dominican Republic,Italy,0,1,17,18,15/06/2023,0,0,7,7,14,5,17,36,1,2,1,4,18,2,35,55,11,6,3,20
7580,136701,2023,Italy,Bulgaria,0,1,6,7,14/06/2023,0,0,6,6,10,3,6,19,0,1,4,5,3,2,18,23,8,3,0,11
7581,136701,2023,Türkiye,Italy,0,0,0,0,03/06/2023,0,0,0,0,0,0,0,0,0,0,0,0,0,0,0,0,0,0,0,0
7582,136701,2023,USA,Italy,0,1,13,14,02/06/2023,0,0,11,11,16,6,15,37,0,4,1,5,1,0,10,11,6,5,5,16
7583,136701,2023,Poland,Italy,0,0,0,0,01/06/2023,0,0,0,0,0,0,0,0,0,0,0,0,0,0,0,0,0,0,0,0
7584,136701,2023,Italy,Thailand,0,0,0,0,30/05/2023,0,0,0,0,0,0,0,0,0,0,0,0,0,0,0,0,0,0,0,0
7585,173917,2023,Türkiye,Italy,1,1,1,3,13/07/2023,0,0,0,0,0,0,0,0,0,0,0,0,0,0,0,0,0,1,0,1
7586,173917,2023,Italy,Japan,0,2,2,4,02/07/2023,0,0,0,0,1,2,0,3,2,0,4,6,0,0,0,0,0,0,1,1
7587,173917,2023,Italy,Croatia,0,0,0,0,01/07/2023,0,0,0,0,0,0,0,0,0,0,0,0,0,0,0,0,0,0,0,0
7588,173917,2023,Canada,Italy,0,2,3,5,30/06/2023,0,0,0,0,0,0,0,0,0,0,0,0,0,0,0,0,0,0,0,0
7589,173917,2023,Brazil,Italy,0,0,0,0,28/06/2023,0,0,0,0,0,0,0,0,0,0,0,0,0,0,0,0,0,0,0,0
7590,173917,2023,Italy,China,0,3,5,8,18/06/2023,0,0,0,0,4,0,0,4,0,0,0,0,0,0,2,2,0,1,0,1
7591,173917,2023,Netherlands,Italy,0,3,5,8,17/06/2023,0,0,0,0,2,0,1,3,0,1,0,1,0,0,0,0,0,0,0,0
7592,173917,2023,Dominican Republic,Italy,0,5,8,13,15/06/2023,0,0,0,0,4,1,5,10,2,1,3,6,0,0,0,0,1,1,0,2
7593,173917,2023,Italy,Bulgaria,0,0,0,0,14/06/2023,0,0,0,0,0,0,0,0,0,0,0,0,0,0,0,0,0,0,0,0
7594,173917,2023,Türkiye,Italy,2,1,3,6,03/06/2023,0,0,1,1,0,1,0,1,1,0,0,1,0,0,0,0,2,0,0,2
7595,173917,2023,USA,Italy,3,6,7,16,02/06/2023,0,0,2,2,5,4,9,18,2,6,6,14,0,0,0,0,1,0,1,2
7596,173917,2023,Poland,Italy,1,5,4,10,01/06/2023,0,0,0,0,7,3,5,15,2,5,5,12,0,0,0,0,1,0,0,1
7597,173917,2023,Italy,Thailand,1,2,3,6,30/05/2023,0,0,0,0,0,0,0,0,0,0,0,0,0,0,0,0,1,1,0,2
7598,136689,2023,Türkiye,Italy,0,0,0,0,13/07/2023,0,0,0,0,0,0,0,0,0,0,0,0,0,0,0,0,0,0,0,0
7599,136689,2023,Italy,Japan,0,0,0,0,02/07/2023,0,0,11,11,0,0,0,0,0,0,0,0,5,1,9,15,22,4,1,27
7600,136689,2023,Italy,Croatia,0,0,0,0,01/07/2023,0,0,6,6,0,0,0,0,0,0,0,0,1,0,3,4,18,2,0,20
7601,136689,2023,Canada,Italy,0,0,0,0,30/06/2023,0,0,0,0,0,0,0,0,0,0,0,0,0,0,0,0,0,0,0,0
7602,136689,2023,Brazil,Italy,0,0,0,0,28/06/2023,0,0,0,0,0,0,0,0,0,0,0,0,0,0,0,0,0,0,0,0
7603,136689,2023,Italy,China,0,0,0,0,18/06/2023,0,0,0,0,0,0,0,0,0,0,0,0,0,0,0,0,0,0,0,0
7604,136689,2023,Netherlands,Italy,0,0,0,0,17/06/2023,0,0,12,12,0,0,0,0,0,0,0,0,3,2,10,15,11,5,0,16
7605,136689,2023,Dominican Republic,Italy,0,0,0,0,15/06/2023,0,0,6,6,0,0,0,0,0,0,0,0,1,0,6,7,21,9,1,31
7606,136689,2023,Italy,Bulgaria,0,0,0,0,14/06/2023,0,0,11,11,0,0,0,0,0,0,0,0,0,0,2,2,12,2,0,14
7607,136689,2023,Türkiye,Italy,0,0,0,0,03/06/2023,0,0,10,10,0,0,0,0,0,0,0,0,5,0,4,9,5,2,0,7
7608,136689,2023,USA,Italy,0,0,0,0,02/06/2023,0,0,0,0,0,0,0,0,0,0,0,0,0,0,0,0,0,0,0,0
7609,136689,2023,Italy,Thailand,0,0,0,0,30/05/2023,0,0,8,8,0,0,0,0,0,0,0,0,6,0,18,24,21,9,2,32
7610,173730,2023,Türkiye,Italy,0,0,1,1,13/07/2023,0,0,0,0,1,0,1,2,0,0,0,0,1,1,1,3,1,0,0,1
7611,173730,2023,Italy,Japan,0,1,14,15,02/07/2023,0,0,4,4,16,4,16,36,2,1,2,5,6,0,14,20,11,0,0,11
7612,173730,2023,Italy,Croatia,0,1,5,6,01/07/2023,0,0,4,4,3,2,8,13,1,2,4,7,1,1,2,4,2,0,0,2
7613,173730,2023,Canada,Italy,0,0,2,2,30/06/2023,0,0,0,0,2,0,6,8,0,2,0,2,0,2,7,9,4,2,0,6
7614,173730,2023,Brazil,Italy,1,2,26,29,28/06/2023,0,0,3,3,11,8,14,33,2,2,2,6,7,1,36,44,7,6,1,14
7615,173730,2023,Italy,China,0,1,5,6,18/06/2023,0,0,5,5,6,6,9,21,2,1,1,4,5,1,26,32,4,1,0,5
7616,173730,2023,Netherlands,Italy,1,1,16,18,17/06/2023,0,0,3,3,16,4,16,36,2,3,2,7,2,2,20,24,6,7,1,14
7617,173730,2023,Dominican Republic,Italy,0,1,14,15,15/06/2023,0,0,1,1,11,5,17,33,3,0,0,3,3,1,12,16,7,2,2,11
7618,173730,2023,Italy,Bulgaria,1,1,10,12,14/06/2023,0,0,0,0,6,5,12,23,1,3,1,5,3,2,15,20,8,6,2,16
7619,173730,2023,Türkiye,Italy,1,0,7,8,03/06/2023,0,0,1,1,4,5,5,14,0,1,1,2,3,2,14,19,3,2,1,6
7620,173730,2023,USA,Italy,1,1,10,12,02/06/2023,0,0,4,4,16,3,14,33,0,5,2,7,6,2,53,61,7,2,2,11
7621,173730,2023,Poland,Italy,1,1,13,15,01/06/2023,0,0,2,2,7,5,11,23,1,2,1,4,6,2,31,39,13,2,1,16
7622,173730,2023,Italy,Thailand,2,0,18,20,30/05/2023,0,0,3,3,16,4,18,38,4,2,1,7,6,1,25,32,18,2,1,21
7623,143396,2023,Türkiye,Italy,0,2,1,3,13/07/2023,1,0,9,10,0,0,0,0,0,0,0,0,0,0,0,0,0,1,1,2
7624,143396,2023,Italy,Japan,1,0,3,4,02/07/2023,1,0,13,14,0,0,0,0,0,1,0,1,0,0,0,0,0,1,0,1
7625,143396,2023,Italy,Croatia,0,0,0,0,01/07/2023,1,0,1,2,0,0,0,0,0,0,0,0,0,0,0,0,0,2,0,2
7626,143396,2023,Canada,Italy,0,1,0,1,30/06/2023,0,0,2,2,0,0,0,0,0,0,0,0,0,0,0,0,1,0,0,1
7627,143396,2023,Brazil,Italy,0,1,4,5,28/06/2023,5,0,17,22,0,0,0,0,1,0,2,3,0,0,0,0,4,0,1,5
7628,143396,2023,Italy,China,1,0,3,4,18/06/2023,0,0,1,1,0,0,0,0,0,0,0,0,0,0,0,0,0,0,0,0
7629,143396,2023,Netherlands,Italy,0,1,0,1,17/06/2023,0,0,0,0,0,0,0,0,0,0,0,0,0,0,0,0,0,0,0,0
7630,143396,2023,Dominican Republic,Italy,0,0,0,0,15/06/2023,3,0,5,8,0,0,0,0,0,0,0,0,0,0,0,0,2,0,0,2
7631,143396,2023,Italy,Bulgaria,0,0,0,0,14/06/2023,0,0,0,0,0,0,0,0,0,0,0,0,0,0,0,0,0,0,0,0
7632,173731,2023,Türkiye,Italy,0,0,0,0,13/07/2023,0,0,0,0,1,1,2,4,0,1,2,3,0,0,0,0,1,0,0,1
7633,173731,2023,Italy,Japan,0,0,1,1,02/07/2023,0,0,0,0,2,1,3,6,0,1,0,1,0,0,1,1,0,0,0,0
7634,173731,2023,Italy,Croatia,0,0,0,0,01/07/2023,0,0,0,0,1,0,0,1,0,0,0,0,0,0,0,0,0,0,0,0
7635,173731,2023,Canada,Italy,0,0,0,0,30/06/2023,0,0,0,0,0,0,1,1,0,0,0,0,0,0,0,0,1,0,0,1
7636,173731,2023,Brazil,Italy,0,0,1,1,28/06/2023,0,0,0,0,6,2,5,13,0,1,2,3,0,0,0,0,1,0,0,1
7637,173731,2023,Italy,China,0,2,3,5,18/06/2023,0,0,1,1,3,2,1,6,0,2,0,2,0,0,0,0,0,1,0,1
7638,173731,2023,Netherlands,Italy,0,0,0,0,17/06/2023,0,0,0,0,0,0,0,0,0,0,0,0,0,0,0,0,0,0,0,0
7639,173731,2023,Dominican Republic,Italy,0,0,2,2,15/06/2023,0,0,0,0,1,3,0,4,0,0,1,1,0,0,0,0,0,0,0,0
7640,173731,2023,Italy,Bulgaria,0,0,0,0,14/06/2023,0,0,0,0,0,0,0,0,0,0,0,0,0,0,0,0,0,0,0,0
7641,173731,2023,Türkiye,Italy,0,0,0,0,03/06/2023,0,0,0,0,0,0,1,1,0,0,0,0,0,0,0,0,0,0,0,0
7642,173731,2023,USA,Italy,0,2,1,3,02/06/2023,0,0,0,0,1,1,0,2,0,1,0,1,0,0,0,0,0,0,0,0
7643,173731,2023,Poland,Italy,0,1,1,2,01/06/2023,0,0,0,0,1,2,3,6,0,1,0,1,0,0,0,0,0,0,0,0
7644,173731,2023,Italy,Thailand,0,1,3,4,30/05/2023,0,0,2,2,4,4,5,13,1,1,0,2,0,0,0,0,2,0,0,2
7645,119385,2023,USA,Japan,0,0,0,0,13/07/2023,0,0,0,0,0,0,0,0,0,0,0,0,0,0,0,0,0,0,0,0
7646,119385,2023,Italy,Japan,0,0,12,12,02/07/2023,0,0,4,4,13,6,24,43,2,3,3,8,0,0,0,0,10,6,4,20
7647,119385,2023,Thailand,Japan,0,0,0,0,01/07/2023,0,0,0,0,0,0,0,0,0,0,0,0,0,0,0,0,0,0,0,0
7648,119385,2023,Netherlands,Japan,0,1,0,1,30/06/2023,0,0,0,0,0,0,0,0,0,0,0,0,0,0,0,0,0,0,0,0
7649,119385,2023,Japan,Türkiye,1,2,8,11,28/06/2023,0,0,3,3,10,2,12,24,1,2,3,6,0,0,0,0,10,1,2,13
7650,151953,2023,USA,Japan,0,0,6,6,13/07/2023,0,0,4,4,4,4,6,14,0,1,5,6,2,0,7,9,6,1,0,7
7651,151953,2023,Italy,Japan,0,0,0,0,02/07/2023,0,0,0,0,0,0,0,0,0,0,0,0,4,0,5,9,2,0,0,2
7652,151953,2023,Thailand,Japan,0,0,6,6,01/07/2023,0,0,1,1,13,1,14,28,0,0,4,4,2,0,7,9,10,1,0,11
7653,151953,2023,Netherlands,Japan,1,1,12,14,30/06/2023,0,0,5,5,7,8,6,21,0,2,0,2,12,1,15,28,7,2,2,11
7654,151953,2023,Japan,Türkiye,0,0,2,2,28/06/2023,0,0,0,0,4,0,6,10,0,0,1,1,2,0,8,10,3,0,0,3
7655,151953,2023,Japan,USA,0,0,0,0,17/06/2023,0,0,0,0,0,0,0,0,0,0,0,0,0,0,0,0,0,0,0,0
7656,151953,2023,Japan,Germany,0,0,9,9,16/06/2023,0,0,8,8,12,2,18,32,0,4,1,5,5,2,18,25,14,3,1,18
7657,151953,2023,Japan,Korea,0,1,7,8,15/06/2023,0,0,2,2,9,5,2,16,1,2,0,3,1,1,6,8,13,0,1,14
7658,151953,2023,Japan,Serbia,0,2,15,17,14/06/2023,0,0,7,7,12,6,15,33,0,5,5,10,4,1,6,11,12,4,1,17
7659,151953,2023,Japan,China,0,0,11,11,04/06/2023,0,0,6,6,13,3,7,23,0,1,1,2,2,0,7,9,7,0,3,10
7660,151953,2023,Bulgaria,Japan,0,1,3,4,03/06/2023,0,0,1,1,10,1,7,18,1,1,1,3,6,1,6,13,5,1,0,6
7661,151953,2023,Croatia,Japan,0,1,8,9,02/06/2023,0,0,2,2,11,1,10,22,1,0,3,4,4,0,2,6,6,0,7,13
7662,151953,2023,Japan,Dominican Republic,1,1,19,21,30/05/2023,0,0,5,5,9,3,13,25,0,1,4,5,2,0,5,7,23,2,1,26
7663,143437,2023,USA,Japan,1,0,11,12,13/07/2023,0,0,3,3,8,5,30,43,1,2,5,8,3,0,11,14,5,2,1,8
7664,143437,2023,Italy,Japan,1,1,7,9,02/07/2023,0,0,0,0,6,4,12,22,1,3,0,4,5,1,9,15,2,0,1,3
7665,143437,2023,Thailand,Japan,2,0,12,14,01/07/2023,0,0,3,3,14,3,20,37,3,1,4,8,1,0,12,13,13,0,1,14
7666,143437,2023,Netherlands,Japan,2,2,10,14,30/06/2023,0,0,3,3,13,4,18,35,1,3,2,6,3,1,10,14,8,5,2,15
7667,143437,2023,Japan,Türkiye,2,4,17,23,28/06/2023,0,0,6,6,22,9,28,59,1,3,0,4,6,0,21,27,7,1,1,9
7668,143437,2023,Japan,USA,0,1,22,23,17/06/2023,0,0,4,4,12,5,26,43,0,0,1,1,6,1,13,20,17,9,1,27
7669,143437,2023,Japan,Germany,2,2,21,25,16/06/2023,0,0,5,5,20,6,31,57,2,1,0,3,1,1,8,10,12,1,0,13
7670,143437,2023,Japan,Korea,0,0,2,2,15/06/2023,0,0,1,1,1,0,1,2,0,0,0,0,0,0,4,4,2,0,0,2
7671,143437,2023,Japan,Serbia,1,2,15,18,14/06/2023,0,0,3,3,19,6,23,48,1,2,5,8,3,0,13,16,11,4,1,16
7672,143437,2023,Japan,China,2,1,10,13,04/06/2023,0,0,1,1,16,4,13,33,1,0,0,1,1,1,10,12,10,0,3,13
7673,143437,2023,Bulgaria,Japan,1,2,11,14,03/06/2023,0,0,2,2,11,4,10,25,2,1,2,5,5,2,6,13,9,0,3,12
7674,143437,2023,Croatia,Japan,3,2,10,15,02/06/2023,0,0,3,3,13,4,14,31,2,1,1,4,2,2,9,13,11,1,1,13
7675,143437,2023,Japan,Dominican Republic,1,2,12,15,30/05/2023,0,0,4,4,18,7,26,51,3,4,2,9,1,1,12,14,11,1,0,12
7676,162218,2023,USA,Japan,1,1,7,9,13/07/2023,0,0,3,3,4,3,8,15,0,1,1,2,4,0,6,10,6,1,0,7
7677,162218,2023,Italy,Japan,2,0,13,15,02/07/2023,0,0,2,2,5,2,7,14,0,1,2,3,7,0,12,19,6,2,2,10
7678,162218,2023,Thailand,Japan,0,2,12,14,01/07/2023,0,0,3,3,8,5,16,29,1,1,2,4,2,0,5,7,10,2,0,12
7679,162218,2023,Netherlands,Japan,0,1,8,9,30/06/2023,0,0,2,2,6,2,17,25,0,2,3,5,3,0,5,8,3,3,1,7
7680,162218,2023,Japan,Türkiye,1,1,14,16,28/06/2023,0,0,8,8,16,9,17,42,2,0,2,4,6,1,34,41,13,3,0,16
7681,162218,2023,Japan,USA,2,2,11,15,17/06/2023,0,0,3,3,16,7,24,47,1,0,1,2,6,0,11,17,16,12,1,29
7682,162218,2023,Japan,Germany,2,1,6,9,16/06/2023,0,0,0,0,0,1,1,2,0,0,0,0,0,0,1,1,0,0,1,1
7683,162218,2023,Japan,Korea,2,3,7,12,15/06/2023,0,0,1,1,9,4,8,21,0,2,3,5,2,0,6,8,6,5,1,12
7684,162218,2023,Japan,Serbia,0,2,2,4,14/06/2023,0,0,0,0,4,1,0,5,0,0,0,0,0,0,1,1,0,0,0,0
7685,151944,2023,USA,Japan,0,0,11,11,13/07/2023,11,0,96,107,2,0,0,2,0,1,4,5,0,0,0,0,13,6,3,22
7686,151944,2023,Italy,Japan,3,1,20,24,02/07/2023,11,1,114,126,0,0,1,1,0,2,4,6,0,0,0,0,5,3,2,10
7687,151944,2023,Thailand,Japan,1,2,12,15,01/07/2023,23,3,67,93,0,1,2,3,0,4,2,6,0,0,0,0,12,2,1,15
7688,151944,2023,Netherlands,Japan,1,0,5,6,30/06/2023,11,1,21,33,0,0,0,0,0,0,0,0,0,1,0,1,3,3,1,7
7689,151944,2023,Japan,Türkiye,0,1,0,1,28/06/2023,10,0,9,19,0,0,0,0,0,0,0,0,0,0,0,0,1,0,0,1
7690,151944,2023,Japan,USA,0,1,0,1,17/06/2023,0,0,0,0,0,0,0,0,0,0,0,0,0,0,0,0,0,0,0,0
7691,151944,2023,Japan,Germany,2,1,15,18,16/06/2023,52,0,79,131,2,0,1,3,0,1,1,2,0,0,0,0,18,4,1,23
7692,151944,2023,Japan,Korea,0,0,9,9,15/06/2023,29,0,50,79,0,0,0,0,0,2,3,5,0,0,0,0,4,5,0,9
7693,151944,2023,Japan,Serbia,1,1,14,16,14/06/2023,24,0,94,118,2,0,2,4,0,3,4,7,0,0,0,0,13,7,0,20
7694,151944,2023,Japan,China,1,1,8,10,04/06/2023,13,1,72,86,0,0,1,1,0,0,0,0,0,0,1,1,5,0,1,6
7695,151944,2023,Bulgaria,Japan,1,0,12,13,03/06/2023,4,1,58,63,0,0,1,1,0,1,1,2,0,0,0,0,6,0,2,8
7696,151944,2023,Croatia,Japan,1,2,13,16,02/06/2023,2,0,79,81,1,0,1,2,0,0,2,2,0,1,0,1,5,0,1,6
7697,151944,2023,Japan,Dominican Republic,2,0,18,20,30/05/2023,41,0,87,128,2,1,2,5,1,3,2,6,0,0,1,1,8,2,0,10
7698,152457,2023,USA,Japan,0,0,1,1,13/07/2023,3,0,19,22,0,0,0,0,0,0,1,1,0,0,0,0,4,1,0,5
7699,152457,2023,Japan,USA,1,0,20,21,17/06/2023,12,1,117,130,2,1,2,5,0,1,2,3,0,0,0,0,20,8,3,31
7700,152457,2023,Japan,Germany,0,0,0,0,16/06/2023,2,0,1,3,0,0,0,0,0,0,0,0,0,0,0,0,0,1,0,1
7701,152457,2023,Japan,Korea,0,0,2,2,15/06/2023,0,0,2,2,0,0,0,0,0,0,0,0,0,0,0,0,2,0,0,2
7702,152457,2023,Japan,Serbia,0,0,1,1,14/06/2023,2,0,7,9,0,0,0,0,0,0,0,0,0,0,0,0,1,1,0,2
7703,142372,2023,USA,Japan,0,1,10,11,13/07/2023,0,0,1,1,12,2,21,35,0,1,1,2,1,0,9,10,13,4,0,17
7704,142372,2023,Italy,Japan,1,1,6,8,02/07/2023,0,0,1,1,4,3,13,20,0,0,3,3,2,0,9,11,4,0,0,4
7705,142372,2023,Thailand,Japan,0,0,0,0,01/07/2023,0,0,0,0,0,0,0,0,0,0,0,0,0,0,0,0,0,0,0,0
7706,142372,2023,Netherlands,Japan,0,0,2,2,30/06/2023,0,0,0,0,0,1,4,5,0,1,0,1,0,0,0,0,1,2,0,3
7707,142372,2023,Japan,Türkiye,0,0,3,3,28/06/2023,0,0,1,1,1,2,3,6,0,0,1,1,0,0,1,1,1,1,0,2
7708,142372,2023,Japan,USA,0,0,0,0,17/06/2023,0,0,0,0,0,0,0,0,0,0,0,0,0,0,0,0,0,0,0,0
7709,142372,2023,Japan,Germany,0,2,8,10,16/06/2023,0,0,2,2,20,8,21,49,0,3,5,8,1,1,7,9,8,2,1,11
7710,142372,2023,Japan,Korea,3,1,12,16,15/06/2023,0,0,2,2,9,1,12,22,0,1,2,3,1,0,6,7,5,4,0,9
7711,142372,2023,Japan,Serbia,1,1,16,18,14/06/2023,0,0,3,3,16,4,20,40,1,2,2,5,2,1,10,13,8,6,0,14
7712,142372,2023,Japan,China,0,0,2,2,04/06/2023,0,0,0,0,1,1,5,7,0,0,1,1,0,0,5,5,1,0,0,1
7713,142372,2023,Bulgaria,Japan,0,2,6,8,03/06/2023,0,1,2,3,13,4,12,29,1,2,0,3,2,1,4,7,7,0,0,7
7714,142372,2023,Croatia,Japan,0,1,13,14,02/06/2023,0,0,1,1,9,2,13,24,0,0,2,2,2,0,5,7,11,0,5,16
7715,142372,2023,Japan,Dominican Republic,0,2,8,10,30/05/2023,0,0,4,4,14,2,29,45,1,0,4,5,0,2,10,12,14,3,1,18
7716,162227,2023,USA,Japan,0,1,13,14,13/07/2023,0,0,1,1,2,0,3,5,2,8,4,14,0,0,1,1,1,1,0,2
7717,162227,2023,Italy,Japan,0,0,6,6,02/07/2023,0,0,1,1,4,3,6,13,1,5,9,15,0,0,0,0,2,1,1,4
7718,162227,2023,Thailand,Japan,0,1,9,10,01/07/2023,0,0,4,4,8,1,5,14,3,2,4,9,0,0,0,0,1,0,2,3
7719,162227,2023,Netherlands,Japan,2,1,8,11,30/06/2023,0,0,3,3,7,1,8,16,0,3,3,6,0,0,0,0,0,1,1,2
7720,162227,2023,Japan,Türkiye,0,0,11,11,28/06/2023,0,0,1,1,6,1,13,20,2,3,4,9,0,0,0,0,3,1,1,5
7721,162227,2023,Japan,USA,0,1,11,12,17/06/2023,0,0,0,0,6,3,4,13,2,7,4,13,0,0,3,3,7,1,0,8
7722,162227,2023,Japan,Germany,0,1,15,16,16/06/2023,0,0,2,2,6,1,7,14,4,3,1,8,0,0,1,1,7,2,1,10
7723,162227,2023,Japan,Korea,0,2,3,5,15/06/2023,0,0,1,1,9,1,6,16,2,3,6,11,0,0,0,0,2,0,0,2
7724,162227,2023,Japan,Serbia,2,1,10,13,14/06/2023,0,0,0,0,3,1,5,9,2,4,4,10,1,1,3,5,3,0,2,5
7725,189198,2023,USA,Japan,0,0,0,0,13/07/2023,0,0,1,1,0,0,0,0,0,0,0,0,0,0,0,0,4,1,0,5
7726,189198,2023,Italy,Japan,0,0,0,0,02/07/2023,0,0,5,5,0,0,0,0,0,0,0,0,1,2,6,9,11,2,1,14
7727,189198,2023,Thailand,Japan,0,0,0,0,01/07/2023,0,0,0,0,0,0,0,0,0,0,0,0,0,0,0,0,0,0,0,0
7728,189198,2023,Netherlands,Japan,0,0,0,0,30/06/2023,0,0,8,8,0,0,0,0,0,0,0,0,3,0,10,13,5,2,2,9
7729,189198,2023,Japan,Türkiye,0,0,0,0,28/06/2023,0,0,13,13,0,0,0,0,0,0,0,0,4,0,11,15,22,9,1,32
7730,187806,2023,USA,Japan,0,0,3,3,13/07/2023,0,0,2,2,0,0,0,0,0,0,0,0,2,1,1,4,2,0,0,2
7731,187806,2023,Japan,USA,0,0,0,0,17/06/2023,0,0,0,0,0,0,0,0,0,0,0,0,0,0,0,0,0,0,0,0
7732,187806,2023,Japan,Germany,0,0,0,0,16/06/2023,0,0,0,0,0,0,0,0,0,0,0,0,0,0,0,0,0,0,0,0
7733,187806,2023,Japan,Korea,0,0,0,0,15/06/2023,0,0,4,4,0,0,0,0,0,0,0,0,2,1,12,15,10,1,0,11
7734,187806,2023,Japan,Serbia,0,0,0,0,14/06/2023,0,0,0,0,0,0,0,0,0,0,0,0,0,0,0,0,0,0,0,0
7735,146519,2023,USA,Japan,0,2,13,15,13/07/2023,0,0,3,3,5,1,9,15,5,5,6,16,2,0,3,5,1,2,0,3
7736,146519,2023,Italy,Japan,1,3,7,11,02/07/2023,0,0,1,1,10,2,10,22,5,6,6,17,0,0,1,1,4,0,0,4
7737,146519,2023,Thailand,Japan,0,0,0,0,01/07/2023,0,0,1,1,0,0,0,0,0,0,0,0,0,0,0,0,0,0,0,0
7738,146519,2023,Netherlands,Japan,0,0,3,3,30/06/2023,0,0,0,0,0,0,0,0,0,2,0,2,0,0,0,0,0,0,0,0
7739,146519,2023,Japan,Türkiye,0,2,6,8,28/06/2023,0,0,2,2,5,0,10,15,2,4,7,13,0,0,0,0,3,3,0,6
7740,151947,2023,USA,Japan,0,0,0,0,13/07/2023,0,0,0,0,0,0,0,0,0,0,0,0,0,0,0,0,0,0,0,0
7741,151947,2023,Italy,Japan,0,0,0,0,02/07/2023,0,0,0,0,0,0,0,0,0,0,0,0,0,0,0,0,0,0,0,0
7742,151947,2023,Thailand,Japan,1,0,5,6,01/07/2023,0,0,0,0,1,1,1,3,0,2,3,5,0,0,0,0,1,0,0,1
7743,151947,2023,Netherlands,Japan,0,1,3,4,30/06/2023,0,0,0,0,1,1,3,5,0,1,0,1,0,0,0,0,1,0,0,1
7744,151947,2023,Japan,Türkiye,0,2,2,4,28/06/2023,0,0,0,0,0,2,2,4,0,2,1,3,1,0,1,2,0,0,0,0
7745,151947,2023,Japan,USA,1,1,6,8,17/06/2023,0,0,0,0,0,0,0,0,0,0,0,0,0,0,0,0,0,1,0,1
7746,151947,2023,Japan,Germany,0,0,0,0,16/06/2023,0,0,0,0,0,0,0,0,0,1,0,1,0,0,0,0,0,0,0,0
7747,151947,2023,Japan,Korea,0,0,0,0,15/06/2023,0,0,0,0,0,0,0,0,0,0,0,0,0,0,0,0,0,0,0,0
7748,151947,2023,Japan,Serbia,1,1,2,4,14/06/2023,0,0,1,1,1,0,2,3,0,4,3,7,0,0,0,0,1,0,0,1
7749,151947,2023,Japan,China,1,2,7,10,04/06/2023,0,0,0,0,1,3,3,7,0,1,4,5,1,0,1,2,1,0,0,1
7750,151947,2023,Bulgaria,Japan,0,1,11,12,03/06/2023,0,0,0,0,2,1,2,5,0,1,3,4,0,0,0,0,3,0,0,3
7751,151947,2023,Croatia,Japan,0,3,5,8,02/06/2023,0,0,0,0,2,0,1,3,1,1,1,3,0,0,0,0,1,0,0,1
7752,151947,2023,Japan,Dominican Republic,0,1,7,8,30/05/2023,0,0,2,2,7,4,2,13,4,3,10,17,0,0,0,0,3,0,0,3
7753,189509,2023,USA,Japan,0,0,0,0,13/07/2023,0,0,13,13,0,0,0,0,0,0,0,0,2,1,21,24,16,5,2,23
7754,189509,2023,Italy,Japan,0,0,0,0,02/07/2023,0,0,8,8,0,0,0,0,0,0,0,0,2,0,6,8,9,4,0,13
7755,189509,2023,Thailand,Japan,0,0,0,0,01/07/2023,0,0,11,11,0,0,0,0,0,0,0,0,7,1,18,26,10,3,2,15
7756,189509,2023,Netherlands,Japan,0,0,0,0,30/06/2023,0,0,7,7,0,0,0,0,0,0,0,0,4,0,14,18,7,3,2,12
7757,189509,2023,Japan,Türkiye,0,0,0,0,28/06/2023,0,0,0,0,0,0,0,0,0,0,0,0,0,0,0,0,0,0,0,0
7758,189509,2023,Japan,USA,0,0,0,0,17/06/2023,0,0,26,26,0,0,0,0,0,0,0,0,10,2,30,42,17,7,2,26
7759,189509,2023,Japan,Germany,0,0,0,0,16/06/2023,0,0,17,17,0,0,0,0,0,0,0,0,11,2,28,41,19,9,2,30
7760,189509,2023,Japan,Korea,0,0,0,0,15/06/2023,0,0,0,0,0,0,0,0,0,0,0,0,0,0,0,0,1,0,0,1
7761,189509,2023,Japan,Serbia,0,0,0,0,14/06/2023,0,0,16,16,0,0,0,0,0,0,0,0,5,1,33,39,24,10,1,35
7762,189509,2023,Japan,China,0,0,0,0,04/06/2023,0,0,4,4,0,0,0,0,0,0,0,0,8,1,25,34,8,1,1,10
7763,189509,2023,Bulgaria,Japan,0,0,0,0,03/06/2023,0,0,5,5,0,0,0,0,0,0,0,0,5,0,12,17,13,0,0,13
7764,189509,2023,Croatia,Japan,0,0,0,0,02/06/2023,0,0,2,2,0,0,0,0,0,0,0,0,7,0,14,21,17,0,2,19
7765,189509,2023,Japan,Dominican Republic,0,0,0,0,30/05/2023,0,0,9,9,0,0,0,0,0,0,0,0,8,0,30,38,26,2,5,33
7766,174243,2023,USA,Japan,0,2,4,6,13/07/2023,0,0,3,3,13,7,18,38,1,1,0,2,0,0,2,2,5,2,1,8
7767,174243,2023,Italy,Japan,0,0,9,9,02/07/2023,0,0,0,0,8,4,6,18,0,1,1,2,2,0,6,8,6,3,0,9
7768,174243,2023,Thailand,Japan,0,1,1,2,01/07/2023,0,0,0,0,0,0,0,0,0,0,0,0,0,0,0,0,0,0,0,0
7769,174243,2023,Netherlands,Japan,0,2,7,9,30/06/2023,0,0,1,1,17,5,12,34,1,0,0,1,0,0,6,6,5,3,1,9
7770,174243,2023,Japan,Türkiye,0,1,1,2,28/06/2023,0,0,0,0,0,0,0,0,0,0,0,0,0,0,0,0,0,0,0,0
7771,174243,2023,Japan,USA,1,3,16,20,17/06/2023,0,0,5,5,28,3,21,52,3,1,3,7,0,0,2,2,8,5,1,14
7772,174243,2023,Japan,Germany,0,1,4,5,16/06/2023,0,0,0,0,1,0,1,2,0,0,0,0,0,0,0,0,1,0,0,1
7773,174243,2023,Japan,Korea,1,2,1,4,15/06/2023,0,0,0,0,3,0,3,6,0,0,1,1,0,0,0,0,3,0,0,3
7774,174243,2023,Japan,Serbia,0,0,1,1,14/06/2023,0,0,2,2,2,2,3,7,0,0,0,0,0,0,0,0,2,0,0,2
7775,174243,2023,Japan,China,0,3,1,4,04/06/2023,0,0,0,0,9,4,6,19,0,1,0,1,0,0,4,4,0,0,0,0
7776,174243,2023,Bulgaria,Japan,1,0,1,2,03/06/2023,0,0,1,1,3,0,4,7,0,0,2,2,0,0,0,0,0,0,0,0
7777,174243,2023,Croatia,Japan,0,0,1,1,02/06/2023,0,0,0,0,2,1,1,4,0,0,0,0,0,0,0,0,1,0,1,2
7778,174243,2023,Japan,Dominican Republic,0,0,1,1,30/05/2023,0,0,0,0,0,0,0,0,0,0,0,0,0,0,0,0,0,0,0,0
7779,163830,2023,Poland,Korea,2,2,4,8,02/07/2023,0,0,1,1,11,7,8,26,0,2,3,5,0,0,6,6,3,0,2,5
7780,163830,2023,Korea,China,1,3,9,13,01/07/2023,1,0,6,7,16,6,16,38,0,1,2,3,0,0,8,8,8,1,3,12
7781,163830,2023,Dominican Republic,Korea,1,2,3,6,29/06/2023,0,0,0,0,7,3,9,19,0,4,4,8,0,0,0,0,1,2,0,3
7782,163830,2023,Bulgaria,Korea,0,3,7,10,27/06/2023,0,0,4,4,18,7,24,49,1,1,4,6,0,0,1,1,10,2,0,12
7783,163830,2023,Germany,Korea,0,2,4,6,18/06/2023,0,2,4,6,8,6,22,36,1,7,1,9,0,0,0,0,3,0,0,3
7784,163830,2023,Korea,Croatia,0,0,5,5,16/06/2023,0,0,1,1,2,2,9,13,0,2,1,3,0,0,0,0,8,0,2,10
7785,163830,2023,Japan,Korea,0,0,3,3,15/06/2023,0,0,2,2,4,3,1,8,0,2,1,3,0,0,0,0,2,0,0,2
7786,163830,2023,Brazil,Korea,2,0,8,10,15/06/2023,0,0,1,1,8,5,10,23,1,0,1,2,0,0,0,0,8,3,1,12
7787,163760,2023,Poland,Korea,1,1,9,11,02/07/2023,0,0,1,1,3,1,6,10,1,4,1,6,0,0,0,0,1,2,0,3
7788,163760,2023,Korea,China,0,1,11,12,01/07/2023,0,0,1,1,9,1,3,13,1,3,4,8,0,0,3,3,6,0,0,6
7789,163760,2023,Dominican Republic,Korea,0,0,6,6,29/06/2023,0,0,0,0,4,1,8,13,1,5,3,9,0,0,0,0,2,0,0,2
7790,163760,2023,Bulgaria,Korea,0,1,8,9,27/06/2023,0,0,1,1,6,1,7,14,1,2,4,7,0,0,0,0,4,1,0,5
7791,163760,2023,Germany,Korea,0,0,0,0,18/06/2023,0,0,0,0,0,0,0,0,0,0,0,0,0,0,0,0,0,0,0,0
7792,163760,2023,Korea,Croatia,1,0,1,2,16/06/2023,0,0,0,0,2,1,1,4,0,1,1,2,0,0,0,0,1,0,0,1
7793,163760,2023,Japan,Korea,0,0,2,2,15/06/2023,0,0,0,0,1,0,5,6,1,0,3,4,0,0,1,1,2,1,0,3
7794,163760,2023,Brazil,Korea,0,0,0,0,15/06/2023,0,0,0,0,0,0,1,1,0,1,0,1,0,0,0,0,0,0,0,0
7795,163760,2023,Thailand,Korea,1,1,7,9,04/06/2023,0,0,1,1,6,1,4,11,1,3,2,6,0,0,0,0,2,0,0,2
7796,163760,2023,USA,Korea,0,0,0,0,03/06/2023,0,0,0,0,0,0,1,1,0,1,0,1,0,0,0,0,0,0,0,0
7797,163760,2023,Canada,Korea,0,0,4,4,02/06/2023,0,0,0,0,4,1,4,9,0,1,1,2,0,0,1,1,0,0,1,1
7798,163760,2023,Korea,Türkiye,0,1,8,9,31/05/2023,0,0,2,2,3,0,6,9,1,2,1,4,0,0,0,0,0,1,0,1
7799,120148,2023,Poland,Korea,0,0,0,0,02/07/2023,0,0,0,0,0,0,0,0,0,0,0,0,0,0,0,0,0,0,0,0
7800,120148,2023,Korea,China,0,0,1,1,01/07/2023,0,0,0,0,0,0,0,0,0,0,0,0,0,0,0,0,0,1,0,1
7801,120148,2023,Dominican Republic,Korea,0,0,2,2,29/06/2023,2,0,5,7,0,0,0,0,0,0,0,0,0,0,0,0,1,1,2,4
7802,120148,2023,Bulgaria,Korea,0,0,0,0,27/06/2023,0,0,0,0,0,0,0,0,0,0,0,0,0,0,0,0,0,0,0,0
7803,120148,2023,Germany,Korea,0,2,6,8,18/06/2023,3,0,10,13,0,0,0,0,0,0,0,0,0,0,1,1,1,0,0,1
7804,120148,2023,Korea,Croatia,1,0,3,4,16/06/2023,13,1,40,54,0,1,0,1,0,0,1,1,0,0,0,0,4,1,2,7
7805,120148,2023,Japan,Korea,0,1,3,4,15/06/2023,8,0,22,30,0,0,0,0,0,0,0,0,0,0,0,0,2,1,0,3
7806,120148,2023,Brazil,Korea,0,1,1,2,15/06/2023,2,0,8,10,0,0,0,0,0,0,0,0,0,0,0,0,0,1,1,2
7807,120148,2023,Thailand,Korea,0,0,10,10,04/06/2023,3,0,46,49,0,1,1,2,0,0,2,2,0,0,0,0,7,0,1,8
7808,120148,2023,USA,Korea,0,0,2,2,03/06/2023,0,0,3,3,0,0,0,0,0,0,0,0,0,0,0,0,0,0,0,0
7809,120148,2023,Canada,Korea,0,1,2,3,02/06/2023,3,1,29,33,0,0,0,0,0,0,0,0,0,0,0,0,1,3,3,7
7810,120148,2023,Korea,Türkiye,0,2,5,7,31/05/2023,11,1,52,64,1,0,0,1,0,0,0,0,0,0,1,1,4,4,1,9
7811,181159,2023,Poland,Korea,1,3,3,7,02/07/2023,11,0,62,73,0,0,1,1,0,3,3,6,0,0,0,0,2,3,0,5
7812,181159,2023,Korea,China,0,2,7,9,01/07/2023,26,0,83,109,0,0,3,3,0,1,1,2,0,0,1,1,5,2,0,7
7813,181159,2023,Dominican Republic,Korea,0,1,7,8,29/06/2023,24,0,40,64,0,0,1,1,0,0,2,2,0,0,0,0,5,2,1,8
7814,181159,2023,Bulgaria,Korea,3,2,16,21,27/06/2023,13,1,102,116,1,1,1,3,0,1,0,1,0,0,0,0,4,3,3,10
7815,181159,2023,Thailand,Korea,0,0,6,6,04/06/2023,10,0,45,55,0,0,2,2,0,1,1,2,0,0,0,0,3,1,1,5
7816,181159,2023,USA,Korea,0,2,6,8,03/06/2023,6,2,81,89,1,0,1,2,0,0,1,1,0,0,0,0,1,1,5,7
7817,181159,2023,Canada,Korea,0,0,7,7,02/06/2023,3,2,54,59,0,1,0,1,0,0,1,1,0,0,0,0,1,2,2,5
7818,181159,2023,Korea,Türkiye,0,0,0,0,31/05/2023,0,1,3,4,0,0,0,0,0,0,0,0,0,0,0,0,0,0,0,0
7819,200723,2023,Poland,Korea,0,0,1,1,02/07/2023,2,0,16,18,0,0,0,0,0,0,0,0,0,0,0,0,1,1,0,2
7820,200723,2023,Korea,China,0,0,0,0,01/07/2023,1,0,2,3,0,0,0,0,0,0,0,0,0,0,0,0,0,0,0,0
7821,200723,2023,Dominican Republic,Korea,0,0,0,0,29/06/2023,2,0,6,8,0,0,0,0,0,0,0,0,0,0,0,0,0,0,0,0
7822,200723,2023,Bulgaria,Korea,0,0,0,0,27/06/2023,1,0,4,5,0,0,0,0,0,0,0,0,0,0,0,0,0,0,0,0
7823,200723,2023,Germany,Korea,1,2,8,11,18/06/2023,17,0,84,101,1,0,1,2,0,0,0,0,0,0,0,0,10,2,0,12
7824,200723,2023,Korea,Croatia,1,1,2,4,16/06/2023,6,0,42,48,1,0,0,1,0,0,1,1,0,0,0,0,2,0,0,2
7825,200723,2023,Japan,Korea,1,1,3,5,15/06/2023,11,1,34,46,0,0,1,1,0,1,1,2,0,0,0,0,8,2,0,10
7826,200723,2023,Brazil,Korea,0,1,12,13,15/06/2023,17,1,54,72,0,0,2,2,1,1,2,4,0,0,1,1,11,3,0,14
7827,133479,2023,Poland,Korea,0,0,0,0,02/07/2023,0,0,4,4,0,0,0,0,0,0,0,0,3,1,11,15,9,5,2,16
7828,133479,2023,Korea,China,0,0,0,0,01/07/2023,0,0,7,7,0,0,0,0,0,0,0,0,5,3,13,21,9,5,2,16
7829,133479,2023,Dominican Republic,Korea,0,0,0,0,29/06/2023,0,0,7,7,0,0,0,0,0,0,0,0,6,5,18,29,8,5,1,14
7830,133479,2023,Bulgaria,Korea,0,0,0,0,27/06/2023,0,0,13,13,0,0,0,0,0,0,0,0,3,0,9,12,18,6,0,24
7831,133479,2023,Germany,Korea,0,0,0,0,18/06/2023,0,0,15,15,0,0,0,0,0,0,0,0,10,3,24,37,17,8,2,27
7832,133479,2023,Korea,Croatia,0,0,0,0,16/06/2023,0,0,12,12,0,0,0,0,0,0,0,0,8,0,11,19,16,5,3,24
7833,133479,2023,Japan,Korea,0,0,0,0,15/06/2023,0,1,11,12,0,0,0,0,0,0,0,0,4,1,8,13,5,6,1,12
7834,133479,2023,Brazil,Korea,0,0,0,0,15/06/2023,0,0,16,16,0,0,0,0,0,0,0,0,4,1,13,18,8,15,3,26
7835,133479,2023,Thailand,Korea,0,0,0,0,04/06/2023,0,0,13,13,0,0,0,0,0,0,0,0,3,1,9,13,12,5,2,19
7836,133479,2023,USA,Korea,0,0,0,0,03/06/2023,0,0,8,8,0,0,0,0,0,0,0,0,6,0,5,11,7,8,3,18
7837,133479,2023,Canada,Korea,0,0,0,0,02/06/2023,0,0,5,5,0,0,0,0,0,0,0,0,1,0,7,8,6,7,3,16
7838,133479,2023,Korea,Türkiye,0,0,0,0,31/05/2023,0,0,1,1,0,0,0,0,0,0,0,0,0,0,0,0,0,0,0,0
7839,131893,2023,Poland,Korea,0,0,4,4,02/07/2023,0,0,0,0,2,6,6,14,0,0,1,1,1,1,6,8,2,1,0,3
7840,131893,2023,Korea,China,0,0,0,0,01/07/2023,0,0,0,0,0,0,0,0,0,0,0,0,0,0,0,0,0,0,0,0
7841,131893,2023,Dominican Republic,Korea,0,0,0,0,29/06/2023,0,0,0,0,0,0,0,0,0,0,0,0,0,0,0,0,0,0,0,0
7842,131893,2023,Bulgaria,Korea,0,0,3,3,27/06/2023,0,0,1,1,2,3,5,10,0,0,1,1,1,0,3,4,3,1,0,4
7843,131893,2023,Germany,Korea,0,0,0,0,18/06/2023,0,0,0,0,2,1,4,7,0,4,1,5,0,0,0,0,0,1,0,1
7844,131893,2023,Korea,Croatia,0,0,3,3,16/06/2023,0,0,0,0,1,3,5,9,1,0,1,2,0,0,6,6,1,0,0,1
7845,131893,2023,Japan,Korea,1,0,3,4,15/06/2023,0,0,0,0,1,3,13,17,0,2,0,2,0,1,11,12,2,1,1,4
7846,131893,2023,Brazil,Korea,0,0,0,0,15/06/2023,0,0,0,0,0,0,0,0,0,0,0,0,0,0,0,0,0,0,0,0
7847,131893,2023,Thailand,Korea,0,0,12,12,04/06/2023,0,0,2,2,11,2,22,35,3,2,3,8,2,1,18,21,8,2,1,11
7848,131893,2023,USA,Korea,0,0,0,0,03/06/2023,0,0,0,0,0,0,0,0,0,0,0,0,0,0,0,0,0,0,0,0
7849,131893,2023,Canada,Korea,0,1,3,4,02/06/2023,0,0,2,2,7,3,10,20,0,1,0,1,1,2,7,10,4,1,3,8
7850,131893,2023,Korea,Türkiye,0,2,5,7,31/05/2023,0,0,2,2,5,4,12,21,1,1,2,4,2,0,15,17,3,3,5,11
7851,163822,2023,Poland,Korea,0,0,8,8,02/07/2023,0,0,0,0,2,1,5,8,1,2,4,7,0,0,1,1,1,1,0,2
7852,163822,2023,Korea,China,4,2,12,18,01/07/2023,0,0,1,1,7,5,6,18,1,1,5,7,0,1,1,2,3,1,0,4
7853,163822,2023,Dominican Republic,Korea,0,1,6,7,29/06/2023,0,0,2,2,4,0,2,6,1,4,0,5,0,0,0,0,0,1,0,1
7854,163822,2023,Bulgaria,Korea,0,0,0,0,27/06/2023,0,0,0,0,0,0,1,1,0,0,0,0,0,0,0,0,0,0,0,0
7855,163822,2023,Germany,Korea,1,0,10,11,18/06/2023,0,0,1,1,4,1,10,15,2,8,9,19,0,0,1,1,2,1,0,3
7856,163822,2023,Korea,Croatia,0,0,5,5,16/06/2023,0,0,1,1,4,2,6,12,0,0,2,2,0,0,0,0,1,0,0,1
7857,163822,2023,Japan,Korea,0,0,3,3,15/06/2023,0,0,1,1,1,0,1,2,2,1,2,5,0,0,1,1,1,1,1,3
7858,163822,2023,Brazil,Korea,0,2,8,10,15/06/2023,0,1,0,1,5,1,5,11,2,1,2,5,0,0,0,0,0,3,0,3
7859,163822,2023,Thailand,Korea,0,0,0,0,04/06/2023,0,0,0,0,0,0,0,0,0,0,0,0,0,0,0,0,0,0,0,0
7860,163822,2023,USA,Korea,0,0,0,0,03/06/2023,0,0,0,0,0,0,0,0,0,0,0,0,0,0,0,0,0,0,0,0
7861,163822,2023,Canada,Korea,0,1,5,6,02/06/2023,0,0,0,0,4,0,7,11,2,2,0,4,0,0,0,0,3,0,1,4
7862,163822,2023,Korea,Türkiye,0,0,2,2,31/05/2023,0,0,0,0,1,0,1,2,1,1,2,4,1,1,0,2,0,0,0,0
7863,163832,2023,Poland,Korea,0,1,4,5,02/07/2023,0,0,0,0,3,6,9,18,1,3,2,6,2,1,7,10,2,0,0,2
7864,163832,2023,Korea,China,0,1,11,12,01/07/2023,0,0,1,1,8,6,18,32,1,0,4,5,2,1,19,22,5,2,1,8
7865,163832,2023,Dominican Republic,Korea,1,2,10,13,29/06/2023,0,0,1,1,9,6,10,25,0,2,1,3,5,0,10,15,4,2,2,8
7866,163832,2023,Bulgaria,Korea,0,1,3,4,27/06/2023,0,0,1,1,3,8,15,26,1,5,2,8,4,1,13,18,8,2,1,11
7867,163832,2023,Germany,Korea,0,1,11,12,18/06/2023,0,1,3,4,16,4,15,35,0,2,1,3,3,1,26,30,6,4,2,12
7868,163832,2023,Korea,Croatia,0,1,2,3,16/06/2023,0,0,2,2,5,1,7,13,0,2,2,4,0,1,10,11,5,3,0,8
7869,163832,2023,Japan,Korea,0,0,5,5,15/06/2023,0,0,3,3,5,2,5,12,1,3,1,5,1,0,11,12,0,3,0,3
7870,163832,2023,Brazil,Korea,0,1,6,7,15/06/2023,0,0,4,4,6,5,14,25,0,2,1,3,5,3,27,35,5,2,0,7
7871,163832,2023,Thailand,Korea,0,2,2,4,04/06/2023,0,0,3,3,2,2,5,9,0,2,1,3,1,0,0,1,3,0,1,4
7872,163832,2023,USA,Korea,0,0,1,1,03/06/2023,0,0,0,0,0,1,0,1,0,0,0,0,0,0,0,0,0,0,0,0
7873,163832,2023,Canada,Korea,0,2,7,9,02/06/2023,0,0,2,2,2,4,9,15,0,0,0,0,0,0,0,0,1,2,2,5
7874,163832,2023,Korea,Türkiye,0,1,12,13,31/05/2023,0,0,3,3,9,5,12,26,1,2,0,3,0,0,0,0,5,5,1,11
7875,168184,2023,Poland,Korea,0,0,0,0,02/07/2023,0,0,0,0,0,0,0,0,0,0,0,0,0,0,0,0,0,0,0,0
7876,168184,2023,Korea,China,0,0,0,0,01/07/2023,0,0,0,0,0,0,0,0,0,0,0,0,0,0,0,0,0,0,0,0
7877,168184,2023,Dominican Republic,Korea,0,0,0,0,29/06/2023,0,0,0,0,0,0,0,0,0,0,0,0,0,0,0,0,0,0,0,0
7878,168184,2023,Bulgaria,Korea,0,3,10,13,27/06/2023,0,0,1,1,0,1,4,5,1,5,7,13,0,0,2,2,0,1,1,2
7879,168184,2023,Germany,Korea,0,0,0,0,18/06/2023,0,0,0,0,0,0,0,0,0,0,0,0,0,0,0,0,0,0,0,0
7880,168184,2023,Korea,Croatia,1,0,11,12,16/06/2023,0,0,2,2,7,2,3,12,2,3,4,9,0,1,0,1,2,0,2,4
7881,168184,2023,Japan,Korea,0,0,6,6,15/06/2023,0,0,1,1,1,1,2,4,2,1,4,7,0,0,1,1,1,1,0,2
7882,168184,2023,Brazil,Korea,0,0,0,0,15/06/2023,0,0,0,0,0,0,0,0,0,0,0,0,0,0,0,0,0,0,0,0
7883,168184,2023,Thailand,Korea,1,1,5,7,04/06/2023,0,0,3,3,5,3,7,15,1,5,5,11,0,0,0,0,0,1,1,2
7884,168184,2023,USA,Korea,0,0,10,10,03/06/2023,0,0,2,2,7,1,2,10,0,2,3,5,0,0,0,0,1,0,0,1
7885,168184,2023,Canada,Korea,0,0,0,0,02/06/2023,0,0,0,0,0,0,0,0,0,0,0,0,0,0,0,0,0,0,0,0
7886,168184,2023,Korea,Türkiye,0,0,4,4,31/05/2023,0,0,1,1,2,0,5,7,0,5,3,8,0,0,0,0,1,1,1,3
7887,135949,2023,Poland,Korea,0,0,0,0,02/07/2023,0,0,0,0,0,0,0,0,0,0,0,0,0,0,0,0,0,0,0,0
7888,135949,2023,Germany,Korea,0,1,3,4,18/06/2023,0,0,0,0,0,0,0,0,0,0,0,0,0,0,2,2,2,0,0,2
7889,135949,2023,Korea,Croatia,0,0,3,3,16/06/2023,0,0,0,0,0,0,0,0,0,0,0,0,0,0,3,3,0,0,0,0
7890,135949,2023,Japan,Korea,0,0,0,0,15/06/2023,0,0,1,1,0,0,0,0,0,0,0,0,1,1,3,5,3,3,1,7
7891,135949,2023,Brazil,Korea,0,0,3,3,15/06/2023,0,0,0,0,0,0,0,0,0,0,0,0,1,0,0,1,0,2,0,2
7892,135949,2023,Thailand,Korea,1,0,3,4,04/06/2023,0,0,0,0,1,2,4,7,0,0,0,0,1,0,7,8,0,1,0,1
7893,135949,2023,USA,Korea,0,0,9,9,03/06/2023,0,1,1,2,6,6,13,25,1,1,3,5,0,3,21,24,10,3,1,14
7894,135949,2023,Canada,Korea,0,1,3,4,02/06/2023,0,0,3,3,8,3,1,12,0,0,1,1,0,1,10,11,2,3,3,8
7895,135949,2023,Korea,Türkiye,0,1,0,1,31/05/2023,0,0,0,0,0,0,0,0,0,0,0,0,0,0,0,0,0,0,0,0
7896,133482,2023,Poland,Korea,0,0,1,1,02/07/2023,0,0,0,0,1,0,1,2,0,0,0,0,0,0,1,1,0,0,0,0
7897,133482,2023,Korea,China,0,0,0,0,01/07/2023,0,0,0,0,0,0,1,1,0,0,1,1,1,0,1,2,0,0,0,0
7898,133482,2023,Dominican Republic,Korea,0,0,2,2,29/06/2023,0,0,0,0,0,1,3,4,0,0,2,2,0,0,3,3,2,0,0,2
7899,133482,2023,Bulgaria,Korea,1,1,5,7,27/06/2023,0,0,0,0,1,2,2,5,0,0,2,2,1,1,5,7,2,1,0,3
7900,133482,2023,Germany,Korea,0,0,0,0,18/06/2023,0,0,0,0,0,0,0,0,0,0,0,0,0,0,0,0,0,0,0,0
7901,133482,2023,Korea,Croatia,1,2,7,10,16/06/2023,0,0,0,0,8,5,13,26,0,2,0,2,7,2,7,16,6,3,2,11
7902,133482,2023,Japan,Korea,0,2,4,6,15/06/2023,0,0,1,1,2,1,7,10,0,2,1,3,3,2,8,13,2,2,2,6
7903,133482,2023,Brazil,Korea,0,0,0,0,15/06/2023,0,0,0,0,0,0,0,0,0,0,0,0,0,0,0,0,0,0,0,0
7904,133482,2023,Thailand,Korea,0,0,6,6,04/06/2023,0,0,0,0,5,6,3,14,0,3,0,3,1,0,14,15,5,1,1,7
7905,133482,2023,USA,Korea,0,2,3,5,03/06/2023,0,0,2,2,9,3,14,26,2,0,0,2,3,2,19,24,8,2,1,11
7906,133482,2023,Canada,Korea,1,0,4,5,02/06/2023,0,0,1,1,4,2,10,16,0,2,0,2,3,0,14,17,3,2,0,5
7907,133482,2023,Korea,Türkiye,0,1,3,4,31/05/2023,0,0,2,2,3,0,2,5,0,0,1,1,0,1,7,8,4,1,1,6
7908,163833,2023,Poland,Korea,0,0,2,2,02/07/2023,0,0,0,0,1,2,1,4,0,0,0,0,0,0,0,0,2,0,0,2
7909,163833,2023,Korea,China,0,0,0,0,01/07/2023,0,0,0,0,0,1,0,1,0,0,0,0,0,0,0,0,1,0,0,1
7910,163833,2023,Dominican Republic,Korea,0,0,0,0,29/06/2023,0,0,0,0,1,0,2,3,0,0,0,0,0,0,0,0,1,0,1,2
7911,163833,2023,Bulgaria,Korea,0,0,0,0,27/06/2023,0,0,0,0,0,2,0,2,0,0,0,0,0,0,0,0,0,1,0,1
7912,163833,2023,Germany,Korea,0,0,0,0,18/06/2023,0,0,0,0,0,0,0,0,0,0,0,0,0,0,0,0,0,0,0,0
7913,163833,2023,Korea,Croatia,0,2,2,4,16/06/2023,0,0,0,0,3,4,7,14,2,0,1,3,0,0,0,0,3,0,0,3
7914,163833,2023,Japan,Korea,0,1,5,6,15/06/2023,0,0,0,0,8,3,10,21,0,0,1,1,0,0,0,0,8,2,0,10
7915,163833,2023,Brazil,Korea,0,0,0,0,15/06/2023,0,0,0,0,2,2,1,5,0,0,0,0,0,0,0,0,0,0,0,0
7916,163833,2023,Thailand,Korea,0,1,4,5,04/06/2023,0,0,2,2,9,2,6,17,0,1,2,3,0,0,0,0,2,2,1,5
7917,163833,2023,USA,Korea,0,3,7,10,03/06/2023,0,0,3,3,6,10,10,26,0,0,0,0,0,0,0,0,7,1,2,10
7918,163833,2023,Canada,Korea,0,1,3,4,02/06/2023,0,0,1,1,2,1,2,5,1,1,0,2,0,0,0,0,1,3,1,5
7919,163833,2023,Korea,Türkiye,0,0,0,0,31/05/2023,0,0,0,0,1,0,0,1,0,0,0,0,0,0,0,0,0,0,0,0
7920,156286,2023,Poland,Korea,3,1,7,11,02/07/2023,0,0,1,1,9,0,8,17,0,0,0,0,6,0,19,25,7,2,0,9
7921,156286,2023,Korea,China,0,0,10,10,01/07/2023,0,0,3,3,12,6,14,32,0,0,0,0,6,1,24,31,8,7,0,15
7922,156286,2023,Dominican Republic,Korea,1,0,8,9,29/06/2023,0,0,4,4,4,5,13,22,1,2,5,8,7,0,11,18,6,0,0,6
7923,156286,2023,Bulgaria,Korea,2,2,11,15,27/06/2023,0,0,4,4,10,4,15,29,0,0,4,4,4,4,34,42,9,1,2,12
7924,156286,2023,Germany,Korea,2,2,10,14,18/06/2023,0,0,4,4,11,7,15,33,2,2,1,5,2,1,15,18,12,2,2,16
7925,156286,2023,Korea,Croatia,2,1,3,6,16/06/2023,0,0,1,1,3,3,8,14,0,0,3,3,1,2,13,16,3,2,1,6
7926,156286,2023,Japan,Korea,0,1,4,5,15/06/2023,0,0,2,2,2,3,7,12,0,1,1,2,1,1,3,5,5,4,0,9
7927,156286,2023,Brazil,Korea,1,1,8,10,15/06/2023,0,0,4,4,8,3,16,27,0,1,0,1,1,0,15,16,6,6,1,13
7928,156286,2023,Thailand,Korea,0,1,2,3,04/06/2023,0,0,0,0,2,2,8,12,0,1,0,1,3,1,8,12,2,1,0,3
7929,156286,2023,USA,Korea,0,0,1,1,03/06/2023,0,0,0,0,1,2,1,4,0,0,0,0,0,0,5,5,2,0,0,2
7930,156286,2023,Canada,Korea,0,1,4,5,02/06/2023,0,0,1,1,3,1,3,7,0,1,0,1,3,0,7,10,1,1,0,2
7931,156286,2023,Korea,Türkiye,1,0,9,10,31/05/2023,0,0,3,3,3,2,7,12,0,1,0,1,2,1,16,19,4,2,2,8
7932,124071,2023,Netherlands,Canada,0,0,1,1,01/07/2023,0,0,5,5,0,0,0,0,0,0,0,0,4,1,14,19,4,4,0,8
7933,124071,2023,Netherlands,Japan,0,0,0,0,30/06/2023,0,0,0,0,0,0,0,0,0,0,0,0,0,0,0,0,1,0,0,1
7934,124071,2023,Croatia,Netherlands,0,0,0,0,29/06/2023,0,0,3,3,0,0,0,0,0,0,0,0,2,0,6,8,13,3,1,17
7935,124071,2023,Thailand,Netherlands,0,0,0,0,27/06/2023,0,0,0,0,0,0,0,0,0,0,0,0,0,0,0,0,0,0,0,0
7936,124071,2023,Bulgaria,Netherlands,0,0,0,0,18/06/2023,0,0,6,6,0,0,0,0,0,0,0,0,3,4,16,23,9,3,1,13
7937,124071,2023,Netherlands,Italy,0,0,0,0,17/06/2023,0,0,0,0,0,0,0,0,0,0,0,0,0,0,0,0,0,0,0,0
7938,124071,2023,Poland,Netherlands,0,0,0,0,16/06/2023,0,0,0,0,0,0,0,0,0,0,0,0,0,0,0,0,0,0,0,0
7939,124071,2023,Netherlands,Türkiye,0,0,0,0,14/06/2023,0,0,11,11,0,0,0,0,0,0,0,0,3,2,14,19,5,8,1,14
7940,124071,2023,China,Netherlands,0,0,0,0,03/06/2023,0,0,0,0,0,0,0,0,0,0,0,0,0,0,0,0,0,0,0,0
7941,124071,2023,Dominican Republic,Netherlands,0,0,0,0,02/06/2023,0,0,7,7,0,0,0,0,0,0,0,0,5,1,28,34,15,0,1,16
7942,124071,2023,Brazil,Netherlands,0,0,0,0,01/06/2023,0,0,4,4,0,0,0,0,0,0,0,0,2,0,6,8,8,2,2,12
7943,124071,2023,Germany,Netherlands,0,0,0,0,30/05/2023,0,0,5,5,0,0,0,0,0,0,0,0,1,2,9,12,7,7,6,20
7944,167778,2023,Netherlands,Canada,0,0,0,0,01/07/2023,0,0,0,0,0,0,0,0,0,0,0,0,0,0,0,0,0,0,0,0
7945,167778,2023,Netherlands,Japan,0,0,0,0,30/06/2023,0,0,0,0,0,0,0,0,0,0,0,0,0,0,0,0,0,0,0,0
7946,167778,2023,Croatia,Netherlands,0,0,0,0,29/06/2023,0,0,2,2,0,0,0,0,0,0,0,0,0,1,2,3,0,0,0,0
7947,167778,2023,Thailand,Netherlands,0,0,0,0,27/06/2023,0,0,0,0,0,0,0,0,0,0,0,0,0,0,0,0,0,0,0,0
7948,167778,2023,China,Netherlands,0,0,0,0,03/06/2023,0,0,0,0,0,0,0,0,0,0,0,0,0,0,0,0,0,0,0,0
7949,167778,2023,Dominican Republic,Netherlands,0,0,0,0,02/06/2023,0,0,0,0,0,0,0,0,0,0,0,0,0,0,1,1,0,0,0,0
7950,167778,2023,Brazil,Netherlands,0,0,0,0,01/06/2023,0,0,0,0,0,0,0,0,0,0,0,0,0,0,0,0,1,0,0,1
7951,167778,2023,Germany,Netherlands,0,2,7,9,30/05/2023,0,0,2,2,5,5,9,19,0,1,0,1,3,1,15,19,7,1,2,10
7952,142880,2023,Netherlands,Canada,0,1,9,10,01/07/2023,0,0,1,1,2,3,6,11,1,5,1,7,0,0,0,0,1,0,0,1
7953,142880,2023,Netherlands,Japan,0,0,12,12,30/06/2023,0,0,3,3,20,3,12,35,4,12,5,21,0,0,0,0,9,3,0,12
7954,142880,2023,Croatia,Netherlands,0,1,5,6,29/06/2023,0,0,1,1,10,0,9,19,3,0,4,7,0,0,0,0,7,0,1,8
7955,142880,2023,Thailand,Netherlands,0,2,10,12,27/06/2023,0,0,0,0,7,1,16,24,2,3,2,7,0,0,0,0,9,1,1,11
7956,142880,2023,Bulgaria,Netherlands,0,1,4,5,18/06/2023,0,0,0,0,9,3,6,18,1,2,4,7,0,0,1,1,3,3,1,7
7957,142880,2023,Netherlands,Italy,0,0,0,0,17/06/2023,0,0,0,0,0,0,0,0,0,0,0,0,0,0,0,0,0,0,0,0
7958,142880,2023,Poland,Netherlands,0,0,0,0,16/06/2023,0,0,0,0,0,0,0,0,0,0,0,0,0,0,0,0,0,0,0,0
7959,142880,2023,Netherlands,Türkiye,0,0,0,0,14/06/2023,0,0,0,0,0,0,0,0,0,0,0,0,0,0,0,0,0,0,0,0
7960,167482,2023,Netherlands,Japan,0,0,0,0,30/06/2023,0,0,0,0,0,0,0,0,0,0,0,0,0,0,0,0,0,0,0,0
7961,167482,2023,Croatia,Netherlands,2,0,9,11,29/06/2023,0,0,1,1,8,1,3,12,2,0,0,2,4,0,12,16,3,1,3,7
7962,167482,2023,Thailand,Netherlands,1,1,8,10,27/06/2023,0,0,0,0,12,1,6,19,2,1,2,5,4,0,23,27,9,3,1,13
7963,167482,2023,Bulgaria,Netherlands,0,0,9,9,18/06/2023,0,0,3,3,7,3,9,19,4,1,2,7,1,0,10,11,3,1,1,5
7964,167482,2023,Netherlands,Italy,1,0,13,14,17/06/2023,0,0,0,0,9,3,7,19,0,2,0,2,5,0,15,20,8,0,1,9
7965,167482,2023,Poland,Netherlands,1,0,14,15,16/06/2023,0,0,1,1,14,3,10,27,2,2,7,11,9,0,13,22,3,4,1,8
7966,167482,2023,Netherlands,Türkiye,0,0,1,1,14/06/2023,0,0,0,0,1,0,0,1,0,0,0,0,1,0,4,5,0,0,0,0
7967,167482,2023,China,Netherlands,1,2,13,16,03/06/2023,0,0,2,2,14,5,12,31,2,0,0,2,6,3,27,36,9,0,2,11
7968,167482,2023,Dominican Republic,Netherlands,1,2,16,19,02/06/2023,0,0,2,2,11,4,12,27,2,1,2,5,11,4,25,40,14,1,4,19
7969,167482,2023,Brazil,Netherlands,1,1,12,14,01/06/2023,0,0,0,0,8,6,12,26,2,0,1,3,3,5,19,27,16,2,1,19
7970,167482,2023,Germany,Netherlands,0,0,10,10,30/05/2023,0,0,1,1,11,3,20,34,2,0,1,3,6,5,28,39,5,1,6,12
7971,151194,2023,Netherlands,Canada,0,0,8,8,01/07/2023,0,0,2,2,6,1,1,8,1,2,7,10,0,0,0,0,3,1,0,4
7972,151194,2023,Netherlands,Japan,0,1,18,19,30/06/2023,0,0,4,4,2,0,3,5,7,4,6,17,0,0,0,0,3,1,1,5
7973,151194,2023,Croatia,Netherlands,0,0,0,0,29/06/2023,0,0,0,0,0,0,0,0,0,0,0,0,0,0,0,0,0,0,0,0
7974,151194,2023,Thailand,Netherlands,1,1,10,12,27/06/2023,0,0,5,5,5,0,6,11,1,2,7,10,0,0,1,1,1,0,1,2
7975,151194,2023,Bulgaria,Netherlands,0,0,10,10,18/06/2023,0,0,1,1,3,0,6,9,5,3,9,17,0,0,0,0,0,0,1,1
7976,151194,2023,Netherlands,Italy,2,0,10,12,17/06/2023,0,0,0,0,3,0,0,3,1,2,4,7,0,0,0,0,3,2,1,6
7977,151194,2023,Poland,Netherlands,0,1,4,5,16/06/2023,0,0,0,0,0,0,0,0,0,0,0,0,0,0,0,0,1,0,0,1
7978,151194,2023,Netherlands,Türkiye,1,0,9,10,14/06/2023,0,0,1,1,2,0,9,11,1,5,4,10,0,0,0,0,2,1,1,4
7979,162356,2023,Netherlands,Canada,0,1,16,17,01/07/2023,16,1,98,115,0,0,0,0,0,5,2,7,0,2,0,2,5,2,2,9
7980,162356,2023,Netherlands,Japan,1,0,4,5,30/06/2023,4,1,29,34,0,0,0,0,0,2,4,6,0,0,0,0,1,1,0,2
7981,162356,2023,Croatia,Netherlands,1,0,10,11,29/06/2023,9,0,49,58,2,1,1,4,0,0,0,0,0,0,0,0,3,1,1,5
7982,162356,2023,Thailand,Netherlands,0,0,0,0,27/06/2023,0,0,0,0,0,0,0,0,0,0,0,0,0,0,0,0,0,0,0,0
7983,162356,2023,Bulgaria,Netherlands,0,0,3,3,18/06/2023,7,1,9,17,0,0,0,0,1,1,1,3,0,0,0,0,0,0,0,0
7984,162356,2023,Netherlands,Italy,0,0,9,9,17/06/2023,11,0,47,58,0,0,1,1,1,0,0,1,0,0,0,0,1,1,0,2
7985,162356,2023,Poland,Netherlands,0,0,0,0,16/06/2023,2,0,5,7,1,0,0,1,0,0,2,2,0,0,0,0,0,0,0,0
7986,162356,2023,Netherlands,Türkiye,0,0,12,12,14/06/2023,18,2,56,76,0,0,1,1,0,3,2,5,0,0,0,0,8,2,1,11
7987,162356,2023,China,Netherlands,0,1,13,14,03/06/2023,6,2,105,113,0,1,0,1,1,2,4,7,0,0,1,1,3,0,1,4
7988,162356,2023,Dominican Republic,Netherlands,1,3,11,15,02/06/2023,5,1,69,75,3,1,1,5,0,2,1,3,0,0,1,1,3,0,0,3
7989,162356,2023,Brazil,Netherlands,1,1,8,10,01/06/2023,4,0,60,64,1,0,0,1,1,2,0,3,0,0,0,0,3,0,1,4
7990,162356,2023,Germany,Netherlands,0,0,4,4,30/05/2023,7,0,43,50,1,0,0,1,0,2,1,3,0,0,0,0,1,0,3,4
7991,147432,2023,Netherlands,Canada,0,0,4,4,01/07/2023,0,1,14,15,0,0,0,0,0,0,0,0,0,0,0,0,0,1,0,1
7992,147432,2023,Netherlands,Japan,0,0,9,9,30/06/2023,21,2,44,67,0,0,0,0,1,3,0,4,0,0,0,0,4,3,0,7
7993,147432,2023,Croatia,Netherlands,0,0,4,4,29/06/2023,2,0,5,7,0,0,0,0,1,0,0,1,0,0,0,0,0,0,0,0
7994,147432,2023,Thailand,Netherlands,4,1,13,18,27/06/2023,26,0,66,92,0,0,3,3,1,3,2,6,0,0,0,0,6,2,0,8
7995,147432,2023,Bulgaria,Netherlands,0,0,11,11,18/06/2023,18,0,27,45,1,0,2,3,2,3,1,6,0,0,0,0,3,3,1,7
7996,147432,2023,Netherlands,Italy,1,1,10,12,17/06/2023,18,0,54,72,0,0,1,1,0,6,2,8,0,0,0,0,3,4,1,8
7997,147432,2023,Poland,Netherlands,0,0,11,11,16/06/2023,22,1,56,79,5,0,2,7,0,2,6,8,0,0,0,0,8,5,0,13
7998,147432,2023,Netherlands,Türkiye,0,1,4,5,14/06/2023,1,0,12,13,0,0,0,0,0,0,0,0,0,0,0,0,2,1,0,3
7999,168148,2023,Netherlands,Canada,2,4,6,12,01/07/2023,0,0,0,0,13,3,3,19,4,5,2,11,0,0,0,0,0,0,0,0
8000,168148,2023,Netherlands,Japan,1,0,10,11,30/06/2023,0,0,0,0,10,1,5,16,0,2,4,6,0,0,0,0,1,2,1,4
8001,168148,2023,Croatia,Netherlands,2,0,8,10,29/06/2023,0,0,0,0,9,0,4,13,5,5,10,20,0,0,1,1,0,1,0,1
8002,168148,2023,Thailand,Netherlands,0,2,5,7,27/06/2023,0,0,1,1,9,2,6,17,4,6,7,17,0,0,0,0,2,0,1,3
8003,168148,2023,Bulgaria,Netherlands,0,1,0,1,18/06/2023,0,0,0,0,2,0,1,3,0,1,0,1,0,0,0,0,0,0,0,0
8004,168148,2023,Netherlands,Italy,0,0,11,11,17/06/2023,0,0,0,0,9,3,5,17,1,4,8,13,0,0,0,0,1,2,0,3
8005,168148,2023,Poland,Netherlands,0,2,5,7,16/06/2023,0,0,0,0,8,1,5,14,2,2,3,7,0,0,1,1,1,0,1,2
8006,168148,2023,Netherlands,Türkiye,0,0,6,6,14/06/2023,0,0,1,1,8,1,2,11,2,2,1,5,0,0,0,0,3,2,1,6
8007,168148,2023,China,Netherlands,0,2,5,7,03/06/2023,0,0,0,0,7,3,4,14,1,0,1,2,0,0,0,0,2,0,0,2
8008,168148,2023,Dominican Republic,Netherlands,0,2,7,9,02/06/2023,0,0,1,1,9,4,8,21,3,5,6,14,0,0,0,0,3,0,2,5
8009,168148,2023,Brazil,Netherlands,0,2,1,3,01/06/2023,0,0,0,0,6,2,4,12,0,0,0,0,0,0,1,1,1,0,0,1
8010,168148,2023,Germany,Netherlands,0,4,5,9,30/05/2023,0,0,1,1,14,3,6,23,3,5,6,14,0,0,1,1,2,1,2,5
8011,181648,2023,Netherlands,Canada,0,0,0,0,01/07/2023,0,0,0,0,0,0,0,0,0,0,0,0,0,0,0,0,0,0,0,0
8012,181648,2023,Netherlands,Japan,0,0,0,0,30/06/2023,0,0,0,0,0,0,0,0,0,0,0,0,0,0,0,0,0,0,0,0
8013,181648,2023,Croatia,Netherlands,0,0,0,0,29/06/2023,0,0,0,0,0,1,3,4,0,0,1,1,0,0,0,0,0,1,0,1
8014,181648,2023,Thailand,Netherlands,0,0,0,0,27/06/2023,0,0,0,0,0,0,0,0,0,0,0,0,0,0,0,0,0,0,0,0
8015,181648,2023,Bulgaria,Netherlands,0,1,0,1,18/06/2023,0,0,0,0,0,0,2,2,0,0,1,1,0,1,0,1,0,1,0,1
8016,181648,2023,Netherlands,Italy,0,0,0,0,17/06/2023,0,0,0,0,0,0,0,0,0,0,0,0,0,0,0,0,0,0,0,0
8017,181648,2023,Poland,Netherlands,0,0,0,0,16/06/2023,0,0,0,0,0,0,0,0,0,0,0,0,0,0,0,0,0,0,0,0
8018,181648,2023,Netherlands,Türkiye,0,1,0,1,14/06/2023,0,0,0,0,1,1,1,3,0,0,0,0,1,0,1,2,0,0,0,0
8019,181648,2023,China,Netherlands,0,0,0,0,03/06/2023,0,0,0,0,0,0,0,0,0,0,0,0,0,0,0,0,0,0,0,0
8020,181648,2023,Dominican Republic,Netherlands,0,0,0,0,02/06/2023,0,0,0,0,0,0,0,0,0,0,0,0,0,0,1,1,1,0,0,1
8021,181648,2023,Brazil,Netherlands,0,0,0,0,01/06/2023,0,0,0,0,0,0,0,0,0,0,0,0,0,1,2,3,0,0,0,0
8022,181648,2023,Germany,Netherlands,0,0,2,2,30/05/2023,0,0,0,0,0,0,1,1,0,0,0,0,0,0,1,1,1,0,2,3
8023,150809,2023,Netherlands,Canada,1,3,12,16,01/07/2023,0,0,2,2,13,9,15,37,3,4,3,10,10,0,23,33,8,4,2,14
8024,150809,2023,Netherlands,Japan,0,2,10,12,30/06/2023,0,0,2,2,12,2,13,27,4,3,3,10,9,4,31,44,11,5,4,20
8025,150809,2023,Croatia,Netherlands,0,0,0,0,29/06/2023,0,0,0,0,0,0,0,0,0,0,0,0,0,0,0,0,0,0,0,0
8026,150809,2023,Thailand,Netherlands,1,2,11,14,27/06/2023,0,0,0,0,9,3,20,32,1,4,4,9,2,0,13,15,10,3,0,13
8027,150809,2023,Bulgaria,Netherlands,0,0,0,0,18/06/2023,0,0,0,0,0,0,0,0,0,0,0,0,0,0,0,0,0,0,0,0
8028,150809,2023,Netherlands,Italy,2,2,11,15,17/06/2023,0,0,3,3,19,6,13,38,1,7,4,12,3,0,24,27,12,3,3,18
8029,150809,2023,Poland,Netherlands,0,1,11,12,16/06/2023,0,0,2,2,13,2,10,25,0,1,1,2,5,1,14,20,4,3,0,7
8030,150809,2023,Netherlands,Türkiye,1,0,11,12,14/06/2023,0,0,1,1,11,7,11,29,0,3,2,5,2,2,24,28,4,1,0,5
8031,172894,2023,Netherlands,Canada,0,1,4,5,01/07/2023,0,0,0,0,2,2,5,9,2,2,3,7,0,0,1,1,3,0,0,3
8032,172894,2023,Netherlands,Japan,1,0,2,3,30/06/2023,0,0,0,0,0,0,0,0,0,0,0,0,0,0,0,0,0,1,0,1
8033,172894,2023,Croatia,Netherlands,1,1,18,20,29/06/2023,0,0,1,1,4,2,1,7,2,2,9,13,0,0,0,0,3,1,0,4
8034,172894,2023,Thailand,Netherlands,0,0,4,4,27/06/2023,0,0,0,0,0,0,0,0,0,1,0,1,0,0,0,0,0,0,0,0
8035,172894,2023,Bulgaria,Netherlands,3,0,19,22,18/06/2023,0,0,1,1,1,0,1,2,3,2,2,7,0,0,0,0,4,1,0,5
8036,172894,2023,Netherlands,Italy,1,0,8,9,17/06/2023,0,0,0,0,4,1,4,9,1,9,3,13,0,0,1,1,1,1,0,2
8037,172894,2023,Poland,Netherlands,0,1,6,7,16/06/2023,0,0,0,0,6,0,3,9,0,6,4,10,1,0,0,1,2,1,1,4
8038,172894,2023,Netherlands,Türkiye,0,1,0,1,14/06/2023,0,0,0,0,0,0,0,0,0,0,1,1,0,0,0,0,0,0,0,0
8039,172894,2023,China,Netherlands,0,1,15,16,03/06/2023,0,0,2,2,7,0,7,14,0,0,1,1,0,0,0,0,4,0,0,4
8040,172894,2023,Dominican Republic,Netherlands,2,2,17,21,02/06/2023,0,0,0,0,3,1,4,8,1,5,8,14,0,0,2,2,7,0,2,9
8041,172894,2023,Brazil,Netherlands,0,1,11,12,01/06/2023,0,0,1,1,2,3,4,9,1,1,2,4,0,0,0,0,1,0,0,1
8042,172894,2023,Germany,Netherlands,1,3,10,14,30/05/2023,0,0,1,1,10,0,4,14,2,5,8,15,1,0,0,1,3,1,3,7
8043,148581,2023,Netherlands,Canada,0,0,0,0,01/07/2023,0,0,6,6,0,0,0,0,0,0,0,0,4,1,5,10,9,4,0,13
8044,148581,2023,Netherlands,Japan,0,0,0,0,30/06/2023,0,0,7,7,0,0,0,0,0,0,0,0,3,0,4,7,12,8,4,24
8045,148581,2023,Croatia,Netherlands,0,0,0,0,29/06/2023,0,0,0,0,0,0,0,0,0,0,0,0,0,0,0,0,0,0,0,0
8046,148581,2023,Thailand,Netherlands,0,0,0,0,27/06/2023,0,0,6,6,0,0,0,0,0,0,0,0,7,0,6,13,10,7,1,18
8047,148581,2023,Bulgaria,Netherlands,0,0,0,0,18/06/2023,0,0,0,0,0,0,0,0,0,0,0,0,0,0,0,0,0,0,0,0
8048,148581,2023,Netherlands,Italy,0,0,0,0,17/06/2023,0,0,8,8,0,0,0,0,0,0,0,0,14,2,22,38,8,9,5,22
8049,148581,2023,Poland,Netherlands,0,0,0,0,16/06/2023,0,0,6,6,0,0,0,0,0,0,0,0,5,1,9,15,13,9,4,26
8050,148581,2023,Netherlands,Türkiye,0,0,0,0,14/06/2023,0,0,0,0,0,0,0,0,0,0,0,0,0,0,0,0,0,0,0,0
8051,148581,2023,China,Netherlands,0,0,0,0,03/06/2023,0,0,8,8,0,0,0,0,0,0,0,0,4,2,8,14,9,2,2,13
8052,148581,2023,Dominican Republic,Netherlands,0,0,0,0,02/06/2023,0,0,0,0,0,0,0,0,0,0,0,0,0,0,0,0,1,0,0,1
8053,148581,2023,Brazil,Netherlands,0,0,0,0,01/06/2023,0,0,0,0,0,0,0,0,0,0,0,0,0,1,1,2,0,0,0,0
8054,148581,2023,Germany,Netherlands,0,0,0,0,30/05/2023,0,0,0,0,0,0,0,0,0,0,0,0,0,0,0,0,0,0,0,0
8055,162372,2023,Netherlands,Canada,0,2,7,9,01/07/2023,0,0,1,1,5,4,11,20,1,0,3,4,0,0,0,0,8,0,0,8
8056,162372,2023,Netherlands,Japan,0,0,0,0,30/06/2023,0,0,0,0,0,0,0,0,0,0,0,0,0,0,0,0,0,0,0,0
8057,162372,2023,Croatia,Netherlands,0,0,0,0,29/06/2023,0,0,0,0,0,1,1,2,0,0,0,0,0,0,0,0,0,0,0,0
8058,162372,2023,Thailand,Netherlands,0,0,0,0,27/06/2023,0,0,0,0,0,0,0,0,0,0,0,0,0,0,0,0,0,0,0,0
8059,162372,2023,Bulgaria,Netherlands,0,0,5,5,18/06/2023,0,0,0,0,2,2,2,6,0,2,0,2,0,0,0,0,1,1,0,2
8060,162372,2023,Netherlands,Italy,0,0,1,1,17/06/2023,0,0,0,0,4,1,0,5,0,3,0,3,0,0,0,0,0,0,0,0
8061,162372,2023,Poland,Netherlands,0,0,1,1,16/06/2023,0,0,0,0,1,0,1,2,0,1,0,1,0,0,0,0,1,1,1,3
8062,162372,2023,Netherlands,Türkiye,0,0,1,1,14/06/2023,0,0,0,0,4,2,3,9,1,1,1,3,0,0,0,0,1,0,0,1
8063,164777,2023,Netherlands,Canada,0,3,16,19,01/07/2023,0,0,2,2,15,7,25,47,2,0,0,2,6,1,26,33,11,1,0,12
8064,164777,2023,Netherlands,Japan,1,4,20,25,30/06/2023,0,0,1,1,10,5,13,28,1,0,3,4,4,2,16,22,6,1,3,10
8065,164777,2023,Croatia,Netherlands,0,1,11,12,29/06/2023,0,0,1,1,7,2,8,17,1,4,1,6,1,1,14,16,3,6,1,10
8066,164777,2023,Thailand,Netherlands,0,0,0,0,27/06/2023,0,0,0,0,0,0,0,0,0,0,0,0,0,0,0,0,0,0,0,0
8067,164777,2023,Bulgaria,Netherlands,0,1,7,8,18/06/2023,0,0,2,2,7,1,9,17,0,3,1,4,2,0,7,9,12,2,2,16
8068,164777,2023,Netherlands,Italy,1,3,6,10,17/06/2023,0,0,0,0,9,3,5,17,0,2,0,2,3,2,9,14,4,0,1,5
8069,164777,2023,Poland,Netherlands,0,0,1,1,16/06/2023,0,0,0,0,0,0,0,0,0,0,0,0,0,0,0,0,0,0,0,0
8070,164777,2023,Netherlands,Türkiye,0,1,11,12,14/06/2023,0,0,0,0,10,3,12,25,1,3,0,4,5,0,13,18,9,3,2,14
8071,164777,2023,China,Netherlands,4,3,20,27,03/06/2023,0,0,1,1,17,4,8,29,0,1,1,2,8,1,28,37,12,0,4,16
8072,164777,2023,Dominican Republic,Netherlands,2,3,11,16,02/06/2023,0,0,5,5,13,8,20,41,1,2,3,6,6,1,11,18,13,1,2,16
8073,164777,2023,Brazil,Netherlands,1,0,8,9,01/06/2023,0,0,0,0,8,4,15,27,0,0,0,0,2,0,22,24,6,0,0,6
8074,164777,2023,Germany,Netherlands,2,2,9,13,30/05/2023,0,0,1,1,8,1,7,16,0,0,1,1,2,1,10,13,1,0,1,2
8075,152233,2023,Poland,USA,0,0,0,0,16/07/2023,0,1,15,16,0,0,0,0,0,0,0,0,12,0,12,24,17,4,0,21
8076,152233,2023,Poland,China,0,0,0,0,15/07/2023,0,0,12,12,0,0,0,0,0,0,0,0,6,0,16,22,8,2,1,11
8077,152233,2023,Poland,Germany,0,0,0,0,12/07/2023,0,0,15,15,0,0,0,0,0,0,0,0,3,1,9,13,15,4,1,20
8078,152233,2023,Poland,Korea,0,0,0,0,02/07/2023,0,0,0,0,0,0,0,0,0,0,0,0,0,0,0,0,0,0,0,0
8079,152233,2023,Bulgaria,Poland,0,0,0,0,30/06/2023,0,0,12,12,0,0,0,0,0,0,0,0,3,2,10,15,10,1,0,11
8080,152233,2023,Poland,Germany,0,0,0,0,29/06/2023,0,2,11,13,0,0,0,0,0,0,0,0,8,0,11,19,15,9,2,26
8081,152233,2023,USA,Poland,0,0,0,0,28/06/2023,0,0,19,19,0,0,0,0,0,0,0,0,9,0,17,26,18,8,2,28
8082,152233,2023,Poland,China,0,0,0,0,17/06/2023,0,0,7,7,0,0,0,0,0,0,0,0,6,0,9,15,10,3,0,13
8083,152233,2023,Poland,Netherlands,0,0,0,0,16/06/2023,0,0,11,11,0,0,0,0,0,0,0,0,3,0,14,17,12,2,3,17
8084,152233,2023,Poland,Türkiye,0,0,0,0,15/06/2023,0,0,8,8,0,0,0,0,0,0,0,0,4,1,12,17,9,1,1,11
8085,152233,2023,Dominican Republic,Poland,0,0,0,0,13/06/2023,0,0,9,9,0,0,0,0,0,0,0,0,11,1,14,26,12,7,1,20
8086,152233,2023,Poland,Serbia,0,0,0,0,03/06/2023,0,0,8,8,0,0,0,0,0,0,0,0,6,1,10,17,8,2,2,12
8087,152233,2023,Thailand,Poland,0,0,0,0,02/06/2023,0,0,5,5,0,0,0,0,0,0,0,0,3,0,6,9,9,3,1,13
8088,152233,2023,Poland,Italy,0,0,0,0,01/06/2023,0,0,12,12,0,0,0,0,0,0,0,0,2,2,16,20,16,2,0,18
8089,152233,2023,Poland,Canada,0,0,0,0,30/05/2023,1,0,19,20,0,0,0,0,0,0,0,0,7,1,17,25,16,3,3,22
8090,136317,2023,Poland,USA,1,2,10,13,16/07/2023,0,0,3,3,9,2,3,14,3,8,2,13,0,0,0,0,3,2,1,6
8091,136317,2023,Poland,China,2,2,5,9,15/07/2023,0,0,0,0,9,2,3,14,2,3,3,8,0,0,0,0,0,0,1,1
8092,136317,2023,Poland,Germany,0,3,11,14,12/07/2023,0,0,1,1,8,1,2,11,0,4,5,9,0,0,0,0,1,1,0,2
8093,136317,2023,Poland,Korea,1,1,12,14,02/07/2023,0,0,4,4,5,1,0,6,3,6,3,12,0,0,0,0,1,1,0,2
8094,136317,2023,Bulgaria,Poland,0,2,12,14,30/06/2023,0,0,1,1,8,1,3,12,3,5,6,14,0,0,0,0,1,3,2,6
8095,136317,2023,Poland,Germany,0,0,12,12,29/06/2023,0,0,1,1,10,2,7,19,5,7,2,14,0,0,0,0,2,1,0,3
8096,136317,2023,USA,Poland,1,3,13,17,28/06/2023,0,0,5,5,12,0,8,20,5,3,5,13,0,0,0,0,4,2,1,7
8097,136317,2023,Poland,China,1,0,12,13,17/06/2023,0,0,5,5,6,0,1,7,3,7,6,16,0,0,0,0,2,2,0,4
8098,136317,2023,Poland,Netherlands,0,1,6,7,16/06/2023,0,1,0,1,5,2,4,11,0,2,8,10,0,0,0,0,2,3,0,5
8099,136317,2023,Poland,Türkiye,2,2,14,18,15/06/2023,0,1,1,2,7,0,4,11,4,5,7,16,0,0,0,0,2,0,1,3
8100,136317,2023,Dominican Republic,Poland,1,2,18,21,13/06/2023,0,0,2,2,6,0,11,17,4,5,3,12,0,0,0,0,3,0,2,5
8101,136317,2023,Poland,Serbia,0,1,12,13,03/06/2023,0,0,4,4,6,1,4,11,7,2,9,18,0,0,0,0,5,1,3,9
8102,136317,2023,Thailand,Poland,2,1,19,22,02/06/2023,0,0,4,4,6,3,0,9,1,1,3,5,0,0,0,0,0,0,0,0
8103,136317,2023,Poland,Italy,2,0,16,18,01/06/2023,0,0,3,3,7,0,6,13,4,7,8,19,0,0,0,0,2,0,1,3
8104,136317,2023,Poland,Canada,0,1,23,24,30/05/2023,0,0,6,6,11,1,7,19,4,10,7,21,0,0,0,0,4,2,0,6
8105,143465,2023,Poland,USA,0,0,2,2,16/07/2023,0,0,1,1,3,2,3,8,0,2,0,2,0,0,0,0,1,0,0,1
8106,143465,2023,Poland,China,1,0,2,3,15/07/2023,0,0,0,0,1,1,3,5,0,0,0,0,0,0,0,0,2,1,0,3
8107,143465,2023,Poland,Germany,0,0,0,0,12/07/2023,0,0,0,0,0,0,1,1,0,0,0,0,0,0,0,0,0,0,0,0
8108,143465,2023,Poland,Korea,0,0,0,0,02/07/2023,0,0,1,1,3,0,2,5,1,0,1,2,0,0,0,0,0,0,0,0
8109,143465,2023,Bulgaria,Poland,1,0,3,4,30/06/2023,0,0,1,1,2,1,3,6,0,1,1,2,0,0,0,0,0,0,0,0
8110,143465,2023,Poland,Germany,0,1,0,1,29/06/2023,0,0,0,0,4,0,3,7,0,0,2,2,0,0,0,0,2,0,1,3
8111,143465,2023,USA,Poland,0,0,0,0,28/06/2023,0,0,0,0,0,2,3,5,0,0,1,1,0,0,0,0,1,0,0,1
8112,143465,2023,Poland,China,0,0,0,0,17/06/2023,0,0,0,0,2,0,2,4,0,1,1,2,0,0,0,0,1,0,0,1
8113,143465,2023,Poland,Netherlands,0,0,1,1,16/06/2023,0,0,0,0,2,1,1,4,0,1,0,1,0,0,0,0,1,0,0,1
8114,143465,2023,Poland,Türkiye,0,0,0,0,15/06/2023,0,0,0,0,4,0,1,5,0,2,1,3,0,0,1,1,0,0,0,0
8115,143465,2023,Dominican Republic,Poland,0,0,0,0,13/06/2023,0,0,0,0,2,1,3,6,1,1,1,3,0,0,0,0,0,1,0,1
8116,143465,2023,Poland,Serbia,0,0,0,0,03/06/2023,0,0,0,0,0,0,2,2,0,0,0,0,0,0,0,0,0,0,0,0
8117,143465,2023,Thailand,Poland,0,0,2,2,02/06/2023,0,0,0,0,2,0,2,4,1,1,1,3,0,0,0,0,0,1,0,1
8118,143465,2023,Poland,Italy,0,0,0,0,01/06/2023,0,0,0,0,0,0,0,0,0,0,0,0,0,0,0,0,0,0,0,0
8119,143465,2023,Poland,Canada,0,0,4,4,30/05/2023,0,0,0,0,1,2,6,9,1,2,1,4,0,0,0,0,1,0,0,1
8120,152217,2023,Poland,USA,2,3,12,17,16/07/2023,0,0,3,3,20,13,20,53,1,1,7,9,0,0,0,0,10,2,1,13
8121,152217,2023,Poland,China,0,3,5,8,15/07/2023,0,0,0,0,15,5,14,34,0,4,3,7,0,0,0,0,4,1,1,6
8122,152217,2023,Poland,Germany,1,2,13,16,12/07/2023,0,0,2,2,17,4,17,38,0,4,2,6,0,0,0,0,21,1,0,22
8123,152217,2023,Poland,Korea,0,3,2,5,02/07/2023,0,0,0,0,13,3,10,26,3,5,5,13,0,0,0,0,6,3,2,11
8124,152217,2023,Bulgaria,Poland,0,3,14,17,30/06/2023,0,0,3,3,14,5,8,27,5,4,5,14,0,0,0,0,16,2,2,20
8125,152217,2023,Poland,Germany,1,3,13,17,29/06/2023,0,0,2,2,19,8,16,43,2,2,3,7,0,0,0,0,9,2,1,12
8126,152217,2023,USA,Poland,1,5,13,19,28/06/2023,0,0,2,2,24,6,20,50,3,4,4,11,0,0,0,0,7,6,0,13
8127,152217,2023,Poland,China,0,2,4,6,17/06/2023,0,0,1,1,19,5,11,35,1,0,5,6,0,0,0,0,7,2,0,9
8128,152217,2023,Poland,Netherlands,1,1,8,10,16/06/2023,0,0,1,1,15,2,12,29,2,0,0,2,0,0,0,0,7,4,2,13
8129,152217,2023,Poland,Türkiye,0,1,5,6,15/06/2023,0,0,2,2,15,5,10,30,2,2,3,7,0,0,0,0,6,9,1,16
8130,152217,2023,Dominican Republic,Poland,0,5,12,17,13/06/2023,0,0,1,1,24,5,20,49,4,2,0,6,0,0,0,0,11,4,1,16
8131,152217,2023,Poland,Serbia,0,4,4,8,03/06/2023,0,0,3,3,17,10,11,38,3,1,1,5,0,0,0,0,6,3,2,11
8132,152217,2023,Thailand,Poland,0,1,4,5,02/06/2023,0,0,0,0,9,4,9,22,0,1,1,2,0,0,0,0,3,1,3,7
8133,152217,2023,Poland,Italy,0,2,9,11,01/06/2023,0,0,0,0,22,8,19,49,2,3,4,9,0,0,0,0,7,1,0,8
8134,152217,2023,Poland,Canada,1,1,12,14,30/05/2023,0,1,0,1,15,10,25,50,5,2,3,10,0,0,0,0,7,1,1,9
8135,152231,2023,Poland,USA,1,1,1,3,16/07/2023,0,0,0,0,0,1,1,2,0,0,0,0,0,0,3,3,2,1,0,3
8136,152231,2023,Poland,China,0,0,1,1,15/07/2023,0,0,0,0,0,0,0,0,0,0,0,0,0,0,0,0,0,0,0,0
8137,152231,2023,Poland,Germany,0,0,3,3,12/07/2023,0,0,0,0,0,0,0,0,0,0,0,0,1,1,2,4,0,2,0,2
8138,152231,2023,Poland,Korea,0,1,0,1,02/07/2023,0,0,0,0,0,0,0,0,0,0,0,0,0,0,1,1,2,0,0,2
8139,152231,2023,Bulgaria,Poland,1,0,1,2,30/06/2023,0,0,1,1,0,0,0,0,0,0,0,0,0,0,4,4,0,0,0,0
8140,152231,2023,Poland,Germany,0,0,0,0,29/06/2023,0,0,0,0,0,0,0,0,0,0,0,0,0,0,0,0,0,0,0,0
8141,152231,2023,USA,Poland,0,1,0,1,28/06/2023,0,0,0,0,0,0,0,0,0,1,1,2,1,0,5,6,0,1,0,1
8142,152231,2023,Poland,China,0,1,1,2,17/06/2023,0,0,1,1,0,0,0,0,0,0,0,0,0,0,0,0,0,0,0,0
8143,152231,2023,Poland,Netherlands,0,0,7,7,16/06/2023,0,0,1,1,4,2,4,10,0,1,0,1,2,0,9,11,4,2,0,6
8144,152231,2023,Poland,Türkiye,0,1,6,7,15/06/2023,0,0,0,0,0,0,0,0,0,0,0,0,1,2,1,4,0,1,0,1
8145,152231,2023,Dominican Republic,Poland,0,0,3,3,13/06/2023,0,0,0,0,0,0,0,0,0,0,0,0,0,0,0,0,0,1,1,2
8146,152231,2023,Poland,Serbia,0,0,1,1,03/06/2023,0,0,0,0,2,0,0,2,0,0,0,0,1,0,1,2,0,1,0,1
8147,152231,2023,Thailand,Poland,0,1,1,2,02/06/2023,0,0,0,0,1,2,1,4,2,0,0,2,0,0,1,1,1,0,0,1
8148,152231,2023,Poland,Italy,0,0,0,0,01/06/2023,0,0,0,0,0,0,0,0,0,0,0,0,0,0,0,0,0,0,0,0
8149,152231,2023,Poland,Canada,0,0,1,1,30/05/2023,0,0,0,0,0,0,0,0,0,0,0,0,0,1,1,2,0,0,0,0
8150,163098,2023,Poland,USA,1,3,14,18,16/07/2023,0,0,4,4,12,4,17,33,1,0,6,7,5,2,16,23,6,3,3,12
8151,163098,2023,Poland,China,1,3,10,14,15/07/2023,0,0,2,2,8,1,9,18,0,1,0,1,8,1,18,27,3,1,1,5
8152,163098,2023,Poland,Germany,0,0,27,27,12/07/2023,0,0,5,5,15,2,12,29,0,6,2,8,9,3,24,36,8,5,1,14
8153,163098,2023,Poland,Korea,0,0,0,0,02/07/2023,0,0,0,0,0,0,0,0,0,0,0,0,0,0,0,0,0,0,0,0
8154,163098,2023,Bulgaria,Poland,0,0,4,4,30/06/2023,0,1,2,3,2,2,11,15,0,1,0,1,1,1,11,13,0,0,0,0
8155,163098,2023,Poland,Germany,0,0,3,3,29/06/2023,0,0,2,2,5,1,4,10,0,0,1,1,6,2,14,22,2,4,0,6
8156,163098,2023,USA,Poland,0,0,16,16,28/06/2023,0,0,6,6,13,3,21,37,3,1,5,9,17,2,32,51,5,3,1,9
8157,163098,2023,Poland,China,0,1,9,10,17/06/2023,0,0,1,1,10,1,8,19,3,2,0,5,3,2,17,22,6,1,0,7
8158,163098,2023,Poland,Netherlands,0,0,0,0,16/06/2023,0,0,1,1,0,1,5,6,0,1,0,1,0,0,1,1,1,0,1,2
8159,163098,2023,Poland,Türkiye,0,1,9,10,15/06/2023,0,0,3,3,11,2,9,22,0,3,3,6,11,0,13,24,6,1,1,8
8160,163098,2023,Dominican Republic,Poland,2,2,16,20,13/06/2023,0,0,4,4,7,3,5,15,1,6,3,10,10,1,19,30,6,4,1,11
8161,163098,2023,Poland,Serbia,1,0,11,12,03/06/2023,0,0,2,2,10,2,11,23,0,1,2,3,1,1,5,7,7,4,1,12
8162,163098,2023,Thailand,Poland,2,0,12,14,02/06/2023,0,0,2,2,7,1,12,20,2,2,1,5,2,0,12,14,8,1,1,10
8163,163098,2023,Poland,Italy,0,2,9,11,01/06/2023,0,0,1,1,10,5,13,28,3,1,3,7,12,2,17,31,10,4,0,14
8164,163098,2023,Poland,Canada,0,1,5,6,30/05/2023,0,0,4,4,10,5,14,29,0,1,2,3,2,0,13,15,10,3,3,16
8165,185609,2023,Poland,USA,0,0,0,0,16/07/2023,0,0,1,1,0,0,0,0,0,0,0,0,1,0,2,3,0,0,0,0
8166,185609,2023,Poland,China,0,0,0,0,15/07/2023,0,0,0,0,0,0,0,0,0,0,0,0,0,0,0,0,0,0,0,0
8167,185609,2023,Poland,Germany,0,0,0,0,12/07/2023,0,0,0,0,0,0,0,0,0,0,0,0,0,0,0,0,0,0,0,0
8168,185609,2023,Poland,Korea,0,0,0,0,02/07/2023,0,0,7,7,0,0,0,0,0,0,0,0,5,0,9,14,5,2,0,7
8169,185609,2023,Bulgaria,Poland,0,0,0,0,30/06/2023,0,0,1,1,0,0,0,0,0,0,0,0,0,0,0,0,2,0,0,2
8170,185609,2023,Poland,Germany,0,0,0,0,29/06/2023,0,0,0,0,0,0,0,0,0,0,0,0,2,0,1,3,2,0,0,2
8171,185609,2023,USA,Poland,0,0,0,0,28/06/2023,0,0,0,0,0,0,0,0,0,0,0,0,0,0,0,0,0,0,0,0
8172,185609,2023,Poland,China,0,0,0,0,17/06/2023,0,0,1,1,0,0,0,0,0,0,0,0,0,0,1,1,0,0,0,0
8173,185609,2023,Poland,Netherlands,0,0,0,0,16/06/2023,0,0,0,0,0,0,0,0,0,0,0,0,2,1,1,4,1,0,0,1
8174,185609,2023,Poland,Türkiye,0,0,0,0,15/06/2023,0,0,0,0,0,0,0,0,0,0,0,0,0,0,0,0,0,0,0,0
8175,185609,2023,Dominican Republic,Poland,0,0,0,0,13/06/2023,0,0,0,0,0,0,0,0,0,0,0,0,0,0,1,1,0,0,0,0
8176,185609,2023,Poland,Serbia,0,0,0,0,03/06/2023,0,0,0,0,0,0,0,0,0,0,0,0,1,0,1,2,0,0,0,0
8177,185609,2023,Thailand,Poland,0,0,0,0,02/06/2023,0,0,0,0,0,0,0,0,0,0,0,0,0,0,0,0,0,0,0,0
8178,185609,2023,Poland,Italy,0,0,0,0,01/06/2023,0,0,2,2,0,0,0,0,0,0,0,0,0,0,1,1,0,1,0,1
8179,185609,2023,Poland,Canada,0,0,0,0,30/05/2023,0,0,1,1,0,0,0,0,0,0,0,0,2,0,4,6,0,1,0,1
8180,181268,2023,Poland,USA,0,0,0,0,16/07/2023,0,0,0,0,0,0,0,0,0,0,0,0,0,0,0,0,0,0,0,0
8181,181268,2023,Poland,China,0,3,7,10,15/07/2023,0,0,0,0,5,1,7,13,0,1,3,4,3,0,11,14,3,0,0,3
8182,181268,2023,Poland,Germany,0,0,1,1,12/07/2023,0,0,2,2,2,2,2,6,1,0,0,1,0,0,1,1,0,1,1,2
8183,181268,2023,Poland,Korea,0,1,14,15,02/07/2023,0,0,3,3,7,4,7,18,1,1,1,3,2,2,7,11,8,1,1,10
8184,181268,2023,Bulgaria,Poland,1,1,5,7,30/06/2023,0,0,1,1,11,1,6,18,2,1,0,3,1,0,8,9,8,1,1,10
8185,181268,2023,Poland,Germany,3,3,7,13,29/06/2023,0,0,2,2,6,5,13,24,1,1,1,3,7,1,14,22,7,1,6,14
8186,181268,2023,USA,Poland,1,2,6,9,28/06/2023,0,0,3,3,9,3,9,21,0,2,0,2,2,0,2,4,8,2,0,10
8187,181268,2023,Poland,China,0,0,1,1,17/06/2023,0,0,0,0,0,0,0,0,0,0,0,0,1,0,1,2,0,0,0,0
8188,181268,2023,Poland,Netherlands,0,1,2,3,16/06/2023,0,0,1,1,4,0,5,9,1,0,1,2,0,0,3,3,3,1,0,4
8189,181268,2023,Poland,Türkiye,0,0,0,0,15/06/2023,0,0,0,0,0,0,0,0,0,0,0,0,0,0,0,0,0,0,0,0
8190,181268,2023,Dominican Republic,Poland,0,1,0,1,13/06/2023,0,0,0,0,0,0,0,0,0,0,0,0,0,0,0,0,0,0,0,0
8191,181268,2023,Poland,Serbia,0,2,4,6,03/06/2023,0,0,0,0,0,0,4,4,1,1,0,2,4,0,5,9,3,1,1,5
8192,181268,2023,Thailand,Poland,0,0,0,0,02/06/2023,0,0,0,0,0,0,0,0,0,0,0,0,0,0,0,0,0,0,0,0
8193,181268,2023,Poland,Italy,1,3,12,16,01/06/2023,0,0,2,2,6,4,7,17,1,3,1,5,0,0,8,8,5,1,0,6
8194,181268,2023,Poland,Canada,1,0,2,3,30/05/2023,0,0,0,0,4,1,5,10,0,0,0,0,1,0,2,3,2,1,0,3
8195,181963,2023,Poland,USA,0,0,0,0,16/07/2023,0,0,0,0,0,0,0,0,0,0,0,0,0,0,0,0,0,0,0,0
8196,181963,2023,Poland,China,0,0,0,0,15/07/2023,0,0,0,0,0,0,0,0,0,0,0,0,0,0,0,0,0,0,0,0
8197,181963,2023,Poland,Germany,0,0,0,0,12/07/2023,0,0,0,0,0,0,0,0,0,0,0,0,0,0,0,0,0,0,0,0
8198,181963,2023,Poland,Korea,0,0,0,0,02/07/2023,0,0,0,0,0,0,0,0,0,0,0,0,0,0,0,0,0,0,0,0
8199,181963,2023,Bulgaria,Poland,0,0,0,0,30/06/2023,0,0,0,0,0,0,0,0,0,0,0,0,0,0,0,0,0,0,0,0
8200,181963,2023,Poland,Germany,0,0,0,0,29/06/2023,0,0,0,0,0,0,0,0,0,0,0,0,0,0,0,0,0,0,0,0
8201,181963,2023,USA,Poland,0,0,0,0,28/06/2023,0,0,0,0,0,0,0,0,0,0,0,0,0,0,0,0,0,0,0,0
8202,181963,2023,Poland,China,0,0,0,0,17/06/2023,0,0,0,0,0,0,0,0,0,0,0,0,0,0,0,0,0,0,0,0
8203,181963,2023,Poland,Netherlands,0,0,0,0,16/06/2023,0,0,0,0,0,0,0,0,0,0,0,0,0,0,0,0,0,0,0,0
8204,181963,2023,Poland,Türkiye,0,0,0,0,15/06/2023,0,0,0,0,0,0,0,0,0,0,0,0,0,0,0,0,0,0,0,0
8205,181963,2023,Dominican Republic,Poland,0,0,0,0,13/06/2023,0,0,0,0,0,0,0,0,0,0,0,0,0,0,0,0,0,0,0,0
8206,181263,2023,Poland,USA,1,2,15,18,16/07/2023,9,1,78,88,1,0,0,1,1,3,4,8,0,0,0,0,10,3,0,13
8207,181263,2023,Poland,China,0,0,10,10,15/07/2023,15,0,60,75,0,0,0,0,0,2,0,2,0,0,0,0,3,1,1,5
8208,181263,2023,Poland,Germany,0,1,11,12,12/07/2023,18,1,87,106,1,0,2,3,2,4,3,9,0,0,0,0,10,2,0,12
8209,181263,2023,Poland,Korea,1,0,4,5,02/07/2023,1,0,9,10,0,0,0,0,0,0,0,0,0,0,0,0,1,0,0,1
8210,181263,2023,Bulgaria,Poland,0,3,14,17,30/06/2023,25,0,60,85,0,0,2,2,0,4,4,8,0,0,0,0,11,4,1,16
8211,181263,2023,Poland,Germany,0,0,12,12,29/06/2023,25,0,83,108,0,0,1,1,0,2,3,5,0,0,0,0,6,3,2,11
8212,181263,2023,USA,Poland,0,0,22,22,28/06/2023,22,1,101,124,0,0,2,2,2,8,4,14,0,0,0,0,12,4,2,18
8213,181263,2023,Poland,China,0,1,12,13,17/06/2023,12,0,59,71,0,0,1,1,0,2,1,3,0,0,0,0,9,6,1,16
8214,181263,2023,Poland,Netherlands,0,2,11,13,16/06/2023,11,0,46,57,0,0,1,1,0,2,1,3,0,0,0,0,4,1,0,5
8215,181263,2023,Poland,Türkiye,0,1,12,13,15/06/2023,15,0,56,71,0,0,0,0,0,2,1,3,0,0,0,0,4,3,5,12
8216,181263,2023,Dominican Republic,Poland,0,1,11,12,13/06/2023,27,2,73,102,1,0,0,1,0,1,4,5,0,0,1,1,7,5,1,13
8217,181263,2023,Poland,Serbia,1,0,19,20,03/06/2023,2,1,80,83,1,0,0,1,2,2,1,5,0,0,0,0,6,4,4,14
8218,181263,2023,Thailand,Poland,1,0,6,7,02/06/2023,8,0,56,64,0,0,0,0,1,1,1,3,0,0,0,0,6,3,1,10
8219,181263,2023,Poland,Italy,2,0,22,24,01/06/2023,13,0,84,97,1,0,0,1,0,0,0,0,0,0,0,0,11,5,3,19
8220,181263,2023,Poland,Canada,0,2,15,17,30/05/2023,27,1,103,131,1,0,3,4,1,5,5,11,0,0,0,0,13,3,0,16
8221,143460,2023,Poland,USA,0,0,0,0,16/07/2023,0,0,0,0,0,0,0,0,0,0,0,0,0,0,0,0,0,0,0,0
8222,143460,2023,Poland,China,0,0,0,0,15/07/2023,0,0,0,0,0,0,0,0,2,0,1,3,0,0,0,0,0,0,0,0
8223,143460,2023,Poland,Germany,0,0,9,9,12/07/2023,0,1,0,1,3,0,4,7,6,2,5,13,0,0,1,1,1,2,0,3
8224,143460,2023,Poland,Korea,0,0,2,2,02/07/2023,0,0,0,0,3,0,1,4,1,2,2,5,0,0,0,0,0,0,0,0
8225,143460,2023,Bulgaria,Poland,0,0,0,0,30/06/2023,0,0,0,0,2,0,0,2,0,0,1,1,0,0,0,0,0,0,0,0
8226,143460,2023,Poland,Germany,0,0,4,4,29/06/2023,0,0,0,0,2,0,1,3,0,0,0,0,0,0,1,1,1,0,0,1
8227,143460,2023,USA,Poland,0,0,0,0,28/06/2023,0,0,0,0,0,0,0,0,0,0,0,0,0,0,0,0,0,0,0,0
8228,143460,2023,Poland,China,0,0,0,0,17/06/2023,0,0,0,0,0,0,0,0,0,0,0,0,0,0,0,0,0,0,0,0
8229,143460,2023,Poland,Netherlands,0,0,1,1,16/06/2023,0,0,1,1,1,1,0,2,0,1,0,1,0,0,0,0,0,1,0,1
8230,143460,2023,Poland,Türkiye,0,0,0,0,15/06/2023,0,0,0,0,0,0,0,0,0,0,0,0,0,0,0,0,0,0,0,0
8231,143460,2023,Dominican Republic,Poland,0,0,0,0,13/06/2023,0,0,0,0,0,0,0,0,0,0,0,0,0,0,0,0,0,0,0,0
8232,143460,2023,Poland,Serbia,0,0,1,1,03/06/2023,0,0,0,0,1,0,1,2,0,2,1,3,0,0,0,0,0,0,0,0
8233,143460,2023,Thailand,Poland,0,0,0,0,02/06/2023,0,0,0,0,2,0,0,2,0,1,1,2,0,0,0,0,0,0,1,1
8234,143460,2023,Poland,Italy,0,0,0,0,01/06/2023,0,0,0,0,0,0,0,0,0,0,0,0,0,0,0,0,0,0,0,0
8235,143460,2023,Poland,Canada,0,0,0,0,30/05/2023,0,0,0,0,0,0,0,0,0,0,0,0,0,0,0,0,0,0,0,0
8236,151231,2023,Poland,USA,1,2,12,15,16/07/2023,0,0,3,3,10,3,15,28,3,4,5,12,3,3,30,36,10,3,0,13
8237,151231,2023,Poland,China,0,1,1,2,15/07/2023,0,0,0,0,2,3,3,8,0,0,0,0,1,0,7,8,1,0,0,1
8238,151231,2023,Poland,Germany,1,1,9,11,12/07/2023,0,0,3,3,16,1,18,35,1,0,1,2,2,1,15,18,8,3,0,11
8239,151231,2023,Poland,Korea,0,1,9,10,02/07/2023,0,0,0,0,6,2,7,15,1,1,1,3,6,5,13,24,6,0,0,6
8240,151231,2023,Bulgaria,Poland,1,4,10,15,30/06/2023,0,0,3,3,13,1,10,24,2,0,9,11,1,2,28,31,3,4,0,7
8241,151231,2023,Poland,Germany,0,4,18,22,29/06/2023,0,0,3,3,11,1,18,30,1,6,3,10,5,1,23,29,8,5,0,13
8242,151231,2023,USA,Poland,0,5,5,10,28/06/2023,0,0,3,3,8,3,14,25,0,3,5,8,2,2,14,18,3,1,1,5
8243,151231,2023,Poland,China,1,2,13,16,17/06/2023,0,0,1,1,9,4,13,26,0,3,2,5,1,1,18,20,4,3,0,7
8244,151231,2023,Poland,Netherlands,0,5,7,12,16/06/2023,0,0,1,1,14,0,16,30,0,4,4,8,4,0,27,31,6,3,1,10
8245,151231,2023,Poland,Türkiye,1,2,7,10,15/06/2023,0,0,3,3,8,3,10,21,0,4,0,4,1,1,16,18,6,2,0,8
8246,151231,2023,Dominican Republic,Poland,0,6,7,13,13/06/2023,0,0,2,2,17,4,14,35,2,4,2,8,5,1,14,20,5,3,0,8
8247,151231,2023,Poland,Serbia,0,3,7,10,03/06/2023,0,0,2,2,3,2,11,16,1,1,2,4,3,1,17,21,6,3,2,11
8248,151231,2023,Thailand,Poland,1,2,8,11,02/06/2023,0,0,0,0,6,3,7,16,0,1,1,2,1,0,20,21,11,2,1,14
8249,151231,2023,Poland,Italy,0,0,3,3,01/06/2023,0,0,1,1,2,1,4,7,0,2,3,5,0,1,1,2,0,1,0,1
8250,151231,2023,Poland,Canada,1,3,15,19,30/05/2023,0,0,1,1,16,6,24,46,1,2,4,7,3,1,41,45,9,2,1,12
8251,152216,2023,Poland,USA,0,0,1,1,16/07/2023,3,0,27,30,0,0,0,0,0,0,1,1,0,0,0,0,3,1,1,5
8252,152216,2023,Poland,China,0,0,1,1,15/07/2023,4,0,6,10,0,0,0,0,0,1,0,1,0,0,0,0,0,0,0,0
8253,152216,2023,Poland,Germany,0,0,1,1,12/07/2023,0,0,1,1,0,0,0,0,0,0,0,0,0,0,0,0,0,0,0,0
8254,152216,2023,Poland,Korea,1,1,12,14,02/07/2023,12,0,44,56,1,0,1,2,1,3,3,7,0,0,0,0,5,3,0,8
8255,152216,2023,Bulgaria,Poland,0,0,4,4,30/06/2023,3,1,7,11,1,0,0,1,0,1,1,2,0,0,0,0,2,0,0,2
8256,152216,2023,Poland,Germany,0,0,3,3,29/06/2023,2,0,17,19,0,0,0,0,0,0,0,0,0,0,0,0,1,1,0,2
8257,152216,2023,USA,Poland,0,0,1,1,28/06/2023,3,0,7,10,0,0,0,0,0,0,0,0,0,0,0,0,0,0,0,0
8258,152216,2023,Poland,China,0,0,3,3,17/06/2023,1,0,7,8,0,0,0,0,0,0,0,0,0,0,0,0,1,1,0,2
8259,152216,2023,Poland,Netherlands,0,0,7,7,16/06/2023,5,0,29,34,0,1,0,1,0,0,1,1,0,0,0,0,2,2,2,6
8260,152216,2023,Poland,Türkiye,1,0,2,3,15/06/2023,1,0,5,6,0,0,0,0,0,0,0,0,0,0,0,0,2,1,0,3
8261,152216,2023,Dominican Republic,Poland,0,0,2,2,13/06/2023,5,0,5,10,0,0,0,0,0,0,0,0,0,0,0,0,0,1,1,2
8262,152216,2023,Poland,Serbia,0,0,1,1,03/06/2023,0,1,2,3,0,0,0,0,0,0,0,0,0,0,0,0,0,1,0,1
8263,152216,2023,Thailand,Poland,0,0,3,3,02/06/2023,0,0,13,13,0,0,0,0,0,0,0,0,0,0,0,0,0,0,0,0
8264,152216,2023,Poland,Italy,0,0,1,1,01/06/2023,0,0,1,1,0,0,0,0,0,0,0,0,0,0,0,0,0,0,0,0
8265,152216,2023,Poland,Canada,0,0,0,0,30/05/2023,0,0,3,3,0,0,0,0,0,0,0,0,0,0,0,0,0,0,0,0
8266,185611,2023,Poland,USA,0,1,12,13,16/07/2023,0,0,8,8,8,3,3,14,2,2,3,7,0,0,0,0,3,0,0,3
8267,185611,2023,Poland,China,0,1,6,7,15/07/2023,0,0,0,0,7,0,3,10,1,5,2,8,0,0,0,0,1,0,0,1
8268,185611,2023,Poland,Germany,0,0,2,2,12/07/2023,0,0,1,1,2,0,4,6,0,2,2,4,0,0,0,0,3,0,0,3
8269,185611,2023,Poland,Korea,0,0,8,8,02/07/2023,0,0,0,0,3,0,1,4,2,1,5,8,0,0,0,0,4,1,0,5
8270,185611,2023,Bulgaria,Poland,2,0,14,16,30/06/2023,0,0,1,1,5,1,5,11,1,7,4,12,0,0,0,0,2,0,0,2
8271,185611,2023,Poland,Germany,0,0,14,14,29/06/2023,0,0,5,5,10,2,4,16,1,5,2,8,0,0,0,0,4,2,0,6
8272,185611,2023,USA,Poland,1,0,14,15,28/06/2023,0,0,2,2,6,1,2,9,1,6,9,16,0,0,0,0,3,1,0,4
8273,185611,2023,Poland,China,0,0,10,10,17/06/2023,0,0,3,3,5,0,2,7,1,3,0,4,0,0,0,0,2,3,0,5
8274,185611,2023,Poland,Netherlands,1,1,7,9,16/06/2023,0,0,0,0,5,0,0,5,0,5,1,6,0,0,0,0,0,2,1,3
8275,185611,2023,Poland,Türkiye,0,0,11,11,15/06/2023,0,0,2,2,7,0,1,8,0,1,4,5,0,0,0,0,1,1,0,2
8276,185611,2023,Dominican Republic,Poland,0,1,12,13,13/06/2023,0,0,2,2,4,1,5,10,2,3,6,11,0,0,1,1,2,0,0,2
8277,185611,2023,Poland,Serbia,0,0,9,9,03/06/2023,0,0,2,2,4,0,1,5,2,2,3,7,0,0,0,0,0,1,0,1
8278,185611,2023,Thailand,Poland,0,1,7,8,02/06/2023,0,0,0,0,7,1,4,12,2,3,4,9,0,0,0,0,2,0,2,4
8279,185611,2023,Poland,Italy,1,0,10,11,01/06/2023,0,0,0,0,4,0,2,6,3,5,5,13,0,0,2,2,6,0,0,6
8280,185611,2023,Poland,Canada,1,2,14,17,30/05/2023,0,0,2,2,5,0,6,11,1,4,7,12,0,0,0,0,6,2,0,8
8281,136024,2023,Serbia,Bulgaria,2,0,4,6,02/07/2023,0,0,0,0,3,0,4,7,0,4,1,5,1,0,12,13,3,0,1,4
8282,136024,2023,Serbia,Dominican Republic,0,1,8,9,01/07/2023,0,0,1,1,3,1,6,10,0,1,2,3,3,2,21,26,3,1,0,4
8283,136024,2023,Germany,Serbia,0,4,13,17,30/06/2023,0,0,4,4,7,3,6,16,0,1,0,1,7,3,17,27,10,2,2,14
8284,136024,2023,China,Serbia,2,2,14,18,28/06/2023,0,0,2,2,8,5,7,20,0,0,1,1,7,1,13,21,12,0,0,12
8285,136024,2023,Serbia,Croatia,0,1,16,17,18/06/2023,0,0,2,2,13,5,15,33,1,1,3,5,4,1,19,24,16,5,0,21
8286,136024,2023,Serbia,Thailand,1,3,12,16,17/06/2023,0,0,2,2,13,2,19,34,1,2,1,4,5,0,21,26,14,3,3,20
8287,136024,2023,Brazil,Serbia,2,2,6,10,16/06/2023,0,1,3,4,5,3,4,12,0,1,1,2,7,0,23,30,7,5,0,12
8288,136024,2023,Japan,Serbia,0,0,0,0,14/06/2023,0,0,0,0,0,0,0,0,0,0,0,0,0,0,0,0,0,0,0,0
8289,136024,2023,Canada,Serbia,0,2,11,13,04/06/2023,0,0,1,1,3,5,9,17,0,1,0,1,10,2,18,30,6,1,3,10
8290,136024,2023,Poland,Serbia,0,0,3,3,03/06/2023,0,0,3,3,0,5,1,6,0,1,1,2,2,0,3,5,0,0,1,1
8291,136024,2023,Türkiye,Serbia,0,1,13,14,01/06/2023,0,0,2,2,5,3,11,19,0,2,0,2,1,0,12,13,3,4,1,8
8292,136024,2023,Serbia,USA,1,1,15,17,31/05/2023,0,0,2,2,14,4,10,28,0,3,0,3,10,2,26,38,10,5,2,17
8293,152168,2023,Serbia,Bulgaria,0,1,6,7,02/07/2023,0,0,2,2,2,4,6,12,2,1,1,4,4,1,8,13,12,2,1,15
8294,152168,2023,Serbia,Dominican Republic,0,0,4,4,01/07/2023,0,0,0,0,2,1,5,8,0,1,0,1,1,0,5,6,1,1,0,2
8295,152168,2023,Germany,Serbia,0,0,1,1,30/06/2023,0,0,0,0,0,0,0,0,0,0,0,0,0,0,0,0,0,0,0,0
8296,152168,2023,China,Serbia,0,0,0,0,28/06/2023,0,0,0,0,0,0,0,0,0,0,0,0,0,0,0,0,0,0,0,0
8297,152168,2023,Serbia,Croatia,0,0,0,0,18/06/2023,0,0,0,0,0,0,0,0,0,0,0,0,0,0,3,3,5,0,1,6
8298,152168,2023,Serbia,Thailand,0,0,7,7,17/06/2023,0,0,2,2,1,0,3,4,0,0,0,0,2,1,10,13,0,2,0,2
8299,152168,2023,Brazil,Serbia,0,1,9,10,16/06/2023,0,0,2,2,3,1,7,11,0,1,2,3,5,0,14,19,7,4,1,12
8300,152168,2023,Japan,Serbia,0,2,19,21,14/06/2023,0,0,2,2,13,5,12,30,3,0,6,9,6,2,27,35,17,10,2,29
8301,152168,2023,Canada,Serbia,0,0,8,8,04/06/2023,0,0,1,1,3,1,6,10,0,2,2,4,8,0,16,24,7,3,1,11
8302,152168,2023,Poland,Serbia,0,1,3,4,03/06/2023,0,0,0,0,8,0,3,11,0,0,0,0,0,0,9,9,5,0,0,5
8303,152168,2023,Türkiye,Serbia,0,0,0,0,01/06/2023,0,0,0,0,0,0,0,0,0,0,0,0,0,0,0,0,0,0,0,0
8304,152168,2023,Serbia,USA,0,0,5,5,31/05/2023,0,0,0,0,0,0,0,0,0,0,0,0,0,0,0,0,0,0,0,0
8305,120326,2023,Serbia,Bulgaria,2,2,12,16,02/07/2023,22,1,73,96,2,0,1,3,0,3,2,5,0,0,0,0,7,2,2,11
8306,120326,2023,Serbia,Dominican Republic,0,1,7,8,01/07/2023,6,0,29,35,0,0,0,0,0,1,2,3,0,0,0,0,7,1,1,9
8307,120326,2023,Germany,Serbia,0,0,1,1,30/06/2023,1,0,8,9,0,0,0,0,0,0,0,0,0,0,0,0,1,1,0,2
8308,120326,2023,China,Serbia,0,0,0,0,28/06/2023,0,0,2,2,0,0,0,0,0,0,0,0,0,0,0,0,0,1,0,1
8309,120326,2023,Canada,Serbia,0,0,17,17,04/06/2023,11,1,106,118,1,2,2,5,1,5,3,9,0,0,0,0,11,6,0,17
8310,120326,2023,Poland,Serbia,0,3,7,10,03/06/2023,3,0,71,74,1,1,0,2,0,1,2,3,0,0,0,0,3,4,2,9
8311,120326,2023,Türkiye,Serbia,0,2,9,11,01/06/2023,8,1,78,87,4,0,1,5,2,1,2,5,0,0,0,0,6,4,1,11
8312,120326,2023,Serbia,USA,0,2,14,16,31/05/2023,21,0,97,118,3,1,2,6,0,1,2,3,0,0,0,0,11,7,2,20
8313,136030,2023,Serbia,Bulgaria,0,0,2,2,02/07/2023,0,0,0,0,1,0,0,1,0,3,1,4,0,0,0,0,1,0,1,2
8314,136030,2023,Serbia,Dominican Republic,0,2,8,10,01/07/2023,0,0,1,1,8,1,6,15,2,7,8,17,0,0,0,0,3,1,0,4
8315,136030,2023,Germany,Serbia,2,1,15,18,30/06/2023,0,0,0,0,7,1,5,13,0,6,9,15,0,0,1,1,1,0,1,2
8316,136030,2023,China,Serbia,2,1,6,9,28/06/2023,0,0,0,0,8,1,3,12,3,0,0,3,0,0,3,3,2,2,1,5
8317,136030,2023,Canada,Serbia,1,1,16,18,04/06/2023,0,1,1,2,6,0,4,10,3,10,8,21,0,1,0,1,2,3,0,5
8318,136030,2023,Poland,Serbia,1,0,8,9,03/06/2023,0,0,1,1,2,1,3,6,1,7,5,13,0,0,1,1,1,1,0,2
8319,136030,2023,Türkiye,Serbia,0,1,10,11,01/06/2023,0,0,1,1,3,1,2,6,1,3,5,9,0,0,1,1,1,1,1,3
8320,136030,2023,Serbia,USA,0,2,14,16,31/05/2023,0,0,2,2,5,1,5,11,3,5,3,11,1,0,1,2,0,0,1,1
8321,181204,2023,Serbia,Bulgaria,0,0,0,0,02/07/2023,0,0,0,0,0,3,3,6,1,2,0,3,0,0,1,1,0,1,0,1
8322,181204,2023,Serbia,Dominican Republic,0,1,10,11,01/07/2023,0,1,2,3,8,3,18,29,2,3,2,7,3,1,8,12,5,3,1,9
8323,181204,2023,Germany,Serbia,0,1,5,6,30/06/2023,0,0,1,1,8,1,14,23,1,3,0,4,1,0,7,8,6,1,3,10
8324,181204,2023,China,Serbia,0,0,0,0,28/06/2023,0,0,1,1,1,0,2,3,0,0,0,0,0,0,0,0,0,0,0,0
8325,181204,2023,Serbia,Croatia,0,0,0,0,18/06/2023,0,0,0,0,0,0,0,0,0,0,0,0,0,0,0,0,0,0,0,0
8326,181204,2023,Serbia,Thailand,0,1,2,3,17/06/2023,0,0,4,4,12,7,8,27,0,2,0,2,0,0,2,2,2,2,0,4
8327,181204,2023,Brazil,Serbia,0,4,2,6,16/06/2023,0,1,4,5,16,7,17,40,1,0,0,1,1,0,5,6,4,2,0,6
8328,181204,2023,Japan,Serbia,0,2,7,9,14/06/2023,0,0,1,1,21,4,21,46,2,0,3,5,4,2,6,12,9,4,0,13
8329,181204,2023,Canada,Serbia,1,1,4,6,04/06/2023,0,0,1,1,16,4,17,37,1,0,2,3,1,0,5,6,4,0,1,5
8330,181204,2023,Poland,Serbia,1,3,7,11,03/06/2023,0,0,1,1,9,8,13,30,1,1,0,2,3,0,10,13,5,2,1,8
8331,181204,2023,Türkiye,Serbia,0,2,1,3,01/06/2023,0,0,2,2,12,2,8,22,1,1,0,2,3,1,14,18,2,1,2,5
8332,181204,2023,Serbia,USA,0,1,2,3,31/05/2023,0,0,0,0,4,3,3,10,0,0,2,2,0,0,1,1,2,0,0,2
8333,116216,2023,Serbia,Bulgaria,1,0,2,3,02/07/2023,8,0,17,25,0,0,0,0,0,0,1,1,0,0,0,0,2,0,1,3
8334,116216,2023,Serbia,Dominican Republic,1,0,11,12,01/07/2023,29,1,68,98,0,0,1,1,2,7,4,13,0,0,0,0,8,0,0,8
8335,116216,2023,Germany,Serbia,0,1,23,24,30/06/2023,20,1,82,103,2,0,1,3,0,3,0,3,0,0,0,0,5,2,1,8
8336,116216,2023,China,Serbia,1,2,13,16,28/06/2023,25,2,76,103,2,0,2,4,0,7,4,11,0,0,0,0,6,3,1,10
8337,123709,2023,Serbia,Bulgaria,0,0,0,0,02/07/2023,0,0,3,3,0,0,0,0,0,0,0,0,1,1,4,6,4,0,0,4
8338,123709,2023,Serbia,Dominican Republic,0,0,0,0,01/07/2023,0,0,15,15,0,0,0,0,0,0,0,0,8,2,15,25,11,3,4,18
8339,123709,2023,Germany,Serbia,0,0,0,0,30/06/2023,0,0,13,13,0,0,0,0,0,0,0,0,6,1,10,17,11,5,1,17
8340,123709,2023,China,Serbia,0,0,0,0,28/06/2023,0,0,7,7,0,0,0,0,0,0,0,0,8,0,12,20,10,6,3,19
8341,123709,2023,Serbia,Croatia,0,0,0,0,18/06/2023,0,1,13,14,0,0,0,0,0,0,0,0,6,0,13,19,22,6,1,29
8342,123709,2023,Serbia,Thailand,0,0,0,0,17/06/2023,0,0,7,7,0,0,0,0,0,0,0,0,6,0,13,19,24,6,3,33
8343,123709,2023,Brazil,Serbia,0,0,0,0,16/06/2023,0,0,6,6,0,0,0,0,0,0,0,0,1,0,12,13,13,8,2,23
8344,123709,2023,Japan,Serbia,0,0,0,0,14/06/2023,0,0,0,0,0,0,0,0,0,0,0,0,0,0,0,0,0,0,0,0
8345,123709,2023,Canada,Serbia,0,0,0,0,04/06/2023,0,1,23,24,0,0,0,0,0,0,0,0,6,0,9,15,14,4,5,23
8346,123709,2023,Poland,Serbia,0,0,0,0,03/06/2023,0,0,9,9,0,0,0,0,0,0,0,0,5,0,15,20,11,2,3,16
8347,123709,2023,Türkiye,Serbia,0,0,0,0,01/06/2023,0,1,12,13,0,0,0,0,0,0,0,0,4,3,18,25,10,4,3,17
8348,123709,2023,Serbia,USA,0,0,0,0,31/05/2023,0,0,11,11,0,0,0,0,0,0,0,0,1,0,13,14,14,5,3,22
8349,123694,2023,Serbia,Bulgaria,1,2,9,12,02/07/2023,0,0,1,1,9,3,10,22,0,2,6,8,0,0,0,0,10,0,1,11
8350,123694,2023,Serbia,Dominican Republic,0,0,2,2,01/07/2023,0,0,0,0,2,1,5,8,0,1,1,2,0,0,0,0,3,0,0,3
8351,123694,2023,Germany,Serbia,0,1,0,1,30/06/2023,0,0,0,0,3,0,1,4,0,0,1,1,0,0,0,0,1,0,0,1
8352,123694,2023,China,Serbia,0,0,0,0,28/06/2023,0,0,0,0,0,0,1,1,0,1,0,1,0,0,0,0,0,0,0,0
8353,123694,2023,Serbia,Croatia,5,1,24,30,18/06/2023,0,0,3,3,15,5,16,36,1,2,7,10,0,0,0,0,5,2,0,7
8354,123694,2023,Serbia,Thailand,0,0,14,14,17/06/2023,0,0,6,6,16,6,19,41,2,4,4,10,0,0,0,0,16,0,2,18
8355,123694,2023,Brazil,Serbia,0,3,6,9,16/06/2023,0,0,1,1,5,10,14,29,2,3,2,7,0,0,0,0,7,3,0,10
8356,123694,2023,Japan,Serbia,0,2,16,18,14/06/2023,0,0,2,2,10,4,24,38,3,4,9,16,0,0,0,0,7,6,0,13
8357,123694,2023,Canada,Serbia,3,2,15,20,04/06/2023,0,0,4,4,13,5,14,32,2,3,9,14,0,0,0,0,10,8,1,19
8358,123694,2023,Poland,Serbia,0,2,4,6,03/06/2023,0,0,2,2,9,4,15,28,0,4,7,11,0,0,0,0,4,1,1,6
8359,123694,2023,Türkiye,Serbia,0,2,11,13,01/06/2023,0,0,2,2,9,4,15,28,1,3,2,6,0,0,0,0,8,1,1,10
8360,123694,2023,Serbia,USA,2,2,11,15,31/05/2023,0,0,1,1,17,5,21,43,0,5,1,6,0,0,0,0,5,2,1,8
8361,143548,2023,Serbia,Bulgaria,1,1,15,17,02/07/2023,0,0,4,4,9,4,7,20,5,3,13,21,0,0,0,0,1,0,1,2
8362,143548,2023,Serbia,Dominican Republic,0,0,1,1,01/07/2023,0,0,0,0,0,0,1,1,0,1,0,1,0,0,0,0,0,0,0,0
8363,143548,2023,Germany,Serbia,0,0,0,0,30/06/2023,0,0,0,0,0,0,0,0,0,0,0,0,0,0,0,0,0,0,0,0
8364,143548,2023,China,Serbia,0,0,3,3,28/06/2023,0,0,0,0,0,0,0,0,0,2,0,2,1,0,1,2,0,0,1,1
8365,143548,2023,Serbia,Croatia,0,2,9,11,18/06/2023,0,0,4,4,2,1,4,7,0,2,1,3,0,0,0,0,4,1,1,6
8366,143548,2023,Serbia,Thailand,0,1,13,14,17/06/2023,0,0,5,5,6,2,9,17,2,5,9,16,0,0,0,0,6,1,1,8
8367,143548,2023,Brazil,Serbia,0,2,20,22,16/06/2023,0,0,3,3,6,2,4,12,6,4,4,14,0,0,0,0,3,0,1,4
8368,143548,2023,Japan,Serbia,2,1,12,15,14/06/2023,0,0,4,4,2,3,4,9,4,8,10,22,0,0,0,0,5,2,1,8
8369,143548,2023,Canada,Serbia,0,0,18,18,04/06/2023,0,0,2,2,10,4,3,17,2,3,18,23,0,0,0,0,2,2,0,4
8370,143548,2023,Poland,Serbia,0,1,12,13,03/06/2023,0,0,2,2,3,0,6,9,0,5,5,10,0,0,0,0,2,0,2,4
8371,143548,2023,Türkiye,Serbia,1,2,12,15,01/06/2023,0,0,3,3,3,2,7,12,4,8,2,14,0,0,0,0,1,1,0,2
8372,143548,2023,Serbia,USA,2,2,11,15,31/05/2023,0,0,4,4,9,4,4,17,2,10,9,21,0,0,0,0,5,2,2,9
8373,123700,2023,Serbia,Bulgaria,1,1,9,11,02/07/2023,0,0,0,0,6,5,3,14,1,3,5,9,0,0,0,0,2,1,1,4
8374,123700,2023,Serbia,Dominican Republic,0,1,13,14,01/07/2023,0,0,0,0,3,2,3,8,2,4,6,12,0,0,0,0,2,4,0,6
8375,123700,2023,Germany,Serbia,0,2,11,13,30/06/2023,0,0,1,1,7,3,5,15,2,6,6,14,0,0,1,1,4,2,2,8
8376,123700,2023,China,Serbia,2,0,17,19,28/06/2023,0,0,3,3,10,0,6,16,1,2,0,3,0,0,0,0,3,1,0,4
8377,123700,2023,Serbia,Croatia,0,0,7,7,18/06/2023,0,0,1,1,5,0,4,9,5,5,3,13,0,0,0,0,5,1,0,6
8378,123700,2023,Serbia,Thailand,0,2,13,15,17/06/2023,0,0,2,2,4,1,8,13,5,4,6,15,0,0,0,0,11,2,2,15
8379,123700,2023,Brazil,Serbia,2,1,9,12,16/06/2023,0,0,1,1,7,1,5,13,4,7,4,15,0,0,0,0,5,1,2,8
8380,123700,2023,Japan,Serbia,1,1,14,16,14/06/2023,0,0,1,1,10,2,7,19,2,5,9,16,2,0,3,5,6,2,0,8
8381,170965,2023,Serbia,Bulgaria,0,0,0,0,02/07/2023,0,0,5,5,0,0,0,0,0,0,0,0,4,3,16,23,10,1,2,13
8382,170965,2023,Serbia,Dominican Republic,0,0,0,0,01/07/2023,0,0,0,0,0,0,0,0,0,0,0,0,0,0,0,0,0,0,0,0
8383,170965,2023,Germany,Serbia,0,0,0,0,30/06/2023,0,0,0,0,0,0,0,0,0,0,0,0,0,0,0,0,0,0,0,0
8384,170965,2023,China,Serbia,0,0,0,0,28/06/2023,0,0,0,0,0,0,0,0,0,0,0,0,0,0,0,0,0,0,0,0
8385,170965,2023,Serbia,Croatia,0,0,0,0,18/06/2023,0,0,0,0,0,0,0,0,0,0,0,0,0,0,0,0,0,0,0,0
8386,170965,2023,Serbia,Thailand,0,0,0,0,17/06/2023,0,0,0,0,0,0,0,0,0,0,0,0,0,0,0,0,0,0,0,0
8387,170965,2023,Brazil,Serbia,0,0,0,0,16/06/2023,0,0,3,3,0,0,0,0,0,0,0,0,2,1,4,7,8,3,0,11
8388,170965,2023,Japan,Serbia,0,0,0,0,14/06/2023,0,0,13,13,0,0,0,0,0,0,0,0,5,0,16,21,15,10,1,26
8389,170965,2023,Canada,Serbia,0,0,0,0,04/06/2023,0,0,0,0,0,0,0,0,0,0,0,0,0,0,0,0,0,0,0,0
8390,170965,2023,Poland,Serbia,0,0,0,0,03/06/2023,0,0,0,0,0,0,0,0,0,0,0,0,0,0,0,0,0,0,0,0
8391,170965,2023,Türkiye,Serbia,0,0,0,0,01/06/2023,0,0,0,0,0,0,0,0,0,0,0,0,0,0,0,0,0,0,0,0
8392,170965,2023,Serbia,USA,0,0,0,0,31/05/2023,0,0,0,0,0,0,0,0,0,0,0,0,0,0,0,0,0,0,0,0
8393,137941,2023,Serbia,Bulgaria,1,0,9,10,02/07/2023,0,1,0,1,12,1,9,22,1,0,2,3,0,0,0,0,1,0,1,2
8394,137941,2023,Serbia,Dominican Republic,1,1,12,14,01/07/2023,0,0,2,2,27,10,12,49,3,5,4,12,0,0,0,0,12,5,2,19
8395,137941,2023,Germany,Serbia,1,1,14,16,30/06/2023,0,0,3,3,34,4,12,50,4,2,3,9,0,0,0,0,14,1,1,16
8396,137941,2023,China,Serbia,1,1,7,9,28/06/2023,0,0,3,3,24,5,15,44,0,2,2,4,0,0,0,0,10,5,2,17
8397,142478,2023,Serbia,Bulgaria,0,0,0,0,02/07/2023,0,0,0,0,0,0,0,0,0,0,0,0,0,1,3,4,1,0,1,2
8398,142478,2023,Serbia,Dominican Republic,0,0,3,3,01/07/2023,0,1,0,1,2,1,4,7,1,0,1,2,3,0,11,14,5,2,1,8
8399,142478,2023,Germany,Serbia,0,0,0,0,30/06/2023,0,0,1,1,0,0,0,0,0,0,0,0,0,0,9,9,3,0,0,3
8400,142478,2023,China,Serbia,0,0,0,0,28/06/2023,0,0,0,0,0,0,0,0,0,0,0,0,1,1,4,6,0,0,0,0
8401,142478,2023,Serbia,Croatia,0,0,0,0,18/06/2023,0,0,0,0,0,0,0,0,0,0,0,0,0,0,0,0,0,0,0,0
8402,142478,2023,Serbia,Thailand,0,0,3,3,17/06/2023,0,0,0,0,0,0,0,0,0,1,0,1,0,0,2,2,1,1,0,2
8403,142478,2023,Brazil,Serbia,0,0,1,1,16/06/2023,0,0,0,0,0,1,2,3,0,0,0,0,0,0,10,10,0,1,0,1
8404,142478,2023,Japan,Serbia,0,0,0,0,14/06/2023,0,0,2,2,0,0,4,4,0,0,0,0,2,1,5,8,1,0,2,3
8405,142478,2023,Canada,Serbia,0,0,2,2,04/06/2023,0,0,0,0,0,0,0,0,0,0,0,0,0,0,0,0,0,0,0,0
8406,142478,2023,Poland,Serbia,0,0,1,1,03/06/2023,0,0,0,0,0,0,1,1,0,0,0,0,0,1,3,4,0,1,1,2
8407,142478,2023,Türkiye,Serbia,0,1,1,2,01/06/2023,0,0,1,1,4,0,0,4,0,1,0,1,0,1,7,8,1,0,0,1
8408,142478,2023,Serbia,USA,0,0,1,1,31/05/2023,0,0,0,0,0,0,0,0,0,0,0,0,0,0,4,4,1,0,0,1
8409,142479,2023,Serbia,Bulgaria,0,1,16,17,02/07/2023,0,0,2,2,17,4,13,34,0,2,4,6,4,2,14,20,10,1,1,12
8410,142479,2023,Serbia,Dominican Republic,0,0,6,6,01/07/2023,0,0,2,2,6,4,6,16,1,1,1,3,3,0,11,14,5,2,1,8
8411,142479,2023,Germany,Serbia,0,2,3,5,30/06/2023,0,0,0,0,4,3,4,11,0,0,2,2,1,1,12,14,3,0,0,3
8412,142479,2023,China,Serbia,1,1,15,17,28/06/2023,0,0,2,2,8,2,8,18,2,3,4,9,9,1,14,24,4,3,0,7
8413,142479,2023,Serbia,Croatia,3,1,14,18,18/06/2023,0,0,4,4,21,1,16,38,2,2,4,8,3,0,12,15,7,3,0,10
8414,142479,2023,Serbia,Thailand,1,2,15,18,17/06/2023,0,0,5,5,18,5,15,38,3,3,5,11,9,1,16,26,11,7,0,18
8415,142479,2023,Brazil,Serbia,0,1,8,9,16/06/2023,0,0,3,3,13,8,11,32,0,0,0,0,7,1,7,15,3,1,1,5
8416,142479,2023,Japan,Serbia,1,0,5,6,14/06/2023,0,0,0,0,1,0,6,7,0,0,0,0,0,1,6,7,0,0,0,0
8417,142479,2023,Canada,Serbia,0,0,10,10,04/06/2023,0,0,2,2,16,5,11,32,0,1,3,4,0,1,13,14,12,2,0,14
8418,142479,2023,Poland,Serbia,0,1,6,7,03/06/2023,0,0,0,0,5,4,5,14,1,3,1,5,0,1,17,18,0,0,0,0
8419,142479,2023,Türkiye,Serbia,0,2,9,11,01/06/2023,0,0,4,4,12,3,10,25,0,2,0,2,1,3,18,22,5,1,0,6
8420,142479,2023,Serbia,USA,1,0,14,15,31/05/2023,0,0,2,2,9,5,17,31,2,2,4,8,5,3,24,32,4,2,1,7
8421,151120,2023,Thailand,Brazil,0,0,2,2,02/07/2023,0,0,2,2,1,0,0,1,0,1,0,1,0,1,4,5,1,0,0,1
8422,151120,2023,Thailand,Japan,0,0,0,0,01/07/2023,0,0,0,0,0,0,0,0,0,0,0,0,0,0,0,0,0,0,0,0
8423,151120,2023,Thailand,Türkiye,0,0,1,1,29/06/2023,0,0,0,0,0,0,0,0,0,0,0,0,1,1,6,8,0,0,0,0
8424,151120,2023,Thailand,Netherlands,0,0,4,4,27/06/2023,0,1,2,3,7,5,7,19,0,1,2,3,1,2,8,11,3,2,2,7
8425,151120,2023,Thailand,Croatia,0,1,3,4,18/06/2023,0,0,1,1,1,1,5,7,0,4,1,5,1,4,13,18,2,1,0,3
8426,151120,2023,Serbia,Thailand,0,0,4,4,17/06/2023,0,0,1,1,0,0,0,0,0,0,0,0,0,0,0,0,1,0,0,1
8427,151120,2023,Thailand,USA,0,0,5,5,15/06/2023,0,0,2,2,4,3,4,11,0,3,0,3,1,0,9,10,3,2,2,7
8428,151120,2023,Germany,Thailand,1,3,10,14,14/06/2023,0,0,0,0,6,5,12,23,0,2,0,2,6,0,17,23,7,3,1,11
8429,151120,2023,Thailand,Korea,0,0,6,6,04/06/2023,0,0,1,1,4,0,4,8,1,0,2,3,0,1,8,9,6,2,0,8
8430,151120,2023,Thailand,Poland,0,1,3,4,02/06/2023,0,0,2,2,6,3,10,19,1,0,0,1,4,1,5,10,2,4,1,7
8431,151120,2023,Canada,Thailand,1,1,11,13,01/06/2023,0,0,3,3,16,7,15,38,1,1,0,2,3,1,7,11,12,3,1,16
8432,151120,2023,Italy,Thailand,0,0,4,4,30/05/2023,0,0,0,0,0,0,1,1,0,0,0,0,0,0,1,1,0,0,0,0
8433,123019,2023,Thailand,Brazil,0,0,1,1,02/07/2023,3,1,9,13,0,0,1,1,0,0,1,1,0,0,0,0,0,0,0,0
8434,123019,2023,Thailand,Japan,0,2,7,9,01/07/2023,17,0,53,70,0,0,2,2,0,2,3,5,0,0,1,1,6,1,0,7
8435,123019,2023,Thailand,Türkiye,0,1,6,7,29/06/2023,8,0,69,77,0,0,1,1,0,2,0,2,0,0,0,0,4,0,2,6
8436,123019,2023,Thailand,Netherlands,0,0,10,10,27/06/2023,22,2,62,86,1,0,0,1,0,1,1,2,0,0,0,0,9,5,3,17
8437,123019,2023,Thailand,Croatia,0,0,9,9,18/06/2023,17,0,43,60,1,0,3,4,0,3,1,4,0,0,0,0,6,1,1,8
8438,123019,2023,Serbia,Thailand,0,0,8,8,17/06/2023,14,2,65,81,0,0,1,1,0,4,6,10,0,0,0,0,5,3,0,8
8439,123019,2023,Thailand,USA,0,0,10,10,15/06/2023,14,0,53,67,1,0,0,1,1,2,2,5,0,0,0,0,7,3,2,12
8440,123019,2023,Germany,Thailand,0,0,13,13,14/06/2023,27,1,63,91,2,0,1,3,0,1,3,4,0,0,0,0,5,2,3,10
8441,123019,2023,Thailand,Korea,0,0,10,10,04/06/2023,17,3,69,89,2,0,2,4,0,1,2,3,0,0,0,0,5,1,0,6
8442,123019,2023,Thailand,Poland,0,1,7,8,02/06/2023,6,2,57,65,0,0,0,0,0,1,1,2,0,0,1,1,4,1,2,7
8443,123019,2023,Canada,Thailand,0,0,7,7,01/06/2023,22,0,61,83,1,0,0,1,0,0,4,4,0,0,1,1,3,5,0,8
8444,123019,2023,Italy,Thailand,0,0,14,14,30/05/2023,34,0,111,145,2,1,1,4,0,2,2,4,0,0,0,0,7,4,2,13
8445,142172,2023,Thailand,Brazil,0,0,0,0,02/07/2023,0,0,0,0,0,0,0,0,0,0,0,0,0,0,0,0,0,0,0,0
8446,142172,2023,Thailand,Japan,0,1,7,8,01/07/2023,0,0,3,3,5,0,6,11,2,2,7,11,0,0,0,0,4,0,0,4
8447,142172,2023,Thailand,Türkiye,0,1,6,7,29/06/2023,0,0,1,1,7,3,6,16,2,1,2,5,0,0,1,1,1,2,1,4
8448,142172,2023,Thailand,Netherlands,0,3,12,15,27/06/2023,0,0,1,1,7,1,3,11,0,1,5,6,0,0,0,0,2,0,2,4
8449,142172,2023,Thailand,Croatia,0,2,4,6,18/06/2023,0,0,3,3,3,1,1,5,0,3,1,4,0,1,0,1,0,2,0,2
8450,142172,2023,Serbia,Thailand,0,0,0,0,17/06/2023,0,0,0,0,0,0,0,0,0,0,0,0,0,0,0,0,0,0,0,0
8451,142172,2023,Thailand,USA,1,1,8,10,15/06/2023,0,0,0,0,2,2,4,8,3,4,3,10,0,0,1,1,1,1,0,2
8452,142172,2023,Germany,Thailand,0,0,12,12,14/06/2023,0,0,4,4,15,3,8,26,2,3,4,9,0,0,0,0,2,1,0,3
8453,142172,2023,Thailand,Korea,0,1,12,13,04/06/2023,0,0,2,2,4,1,4,9,7,3,11,21,0,0,1,1,2,1,0,3
8454,142172,2023,Thailand,Poland,0,1,7,8,02/06/2023,0,0,2,2,4,2,1,7,1,4,2,7,0,1,0,1,1,0,1,2
8455,142172,2023,Canada,Thailand,1,3,12,16,01/06/2023,0,0,5,5,6,2,5,13,0,1,7,8,2,0,4,6,3,3,0,6
8456,142172,2023,Italy,Thailand,1,0,24,25,30/05/2023,0,0,4,4,7,2,6,15,2,5,9,16,0,0,1,1,6,2,0,8
8457,145244,2023,Thailand,Brazil,0,1,4,5,02/07/2023,0,0,2,2,0,0,4,4,0,1,2,3,0,0,0,0,0,0,0,0
8458,145244,2023,Thailand,Japan,1,1,8,10,01/07/2023,0,0,1,1,2,2,6,10,2,4,8,14,0,0,0,0,2,1,1,4
8459,145244,2023,Thailand,Türkiye,1,2,10,13,29/06/2023,0,0,1,1,5,1,6,12,0,2,1,3,0,0,0,0,0,0,0,0
8460,145244,2023,Thailand,Netherlands,0,2,3,5,27/06/2023,0,0,1,1,3,2,2,7,0,3,0,3,0,0,0,0,0,0,0,0
8461,145244,2023,Thailand,Croatia,0,1,7,8,18/06/2023,0,0,0,0,4,1,1,6,0,2,4,6,0,0,0,0,3,1,2,6
8462,145244,2023,Serbia,Thailand,0,0,12,12,17/06/2023,0,0,1,1,3,3,13,19,5,8,6,19,1,0,1,2,4,3,0,7
8463,145244,2023,Thailand,USA,0,0,5,5,15/06/2023,0,0,0,0,1,0,2,3,0,1,6,7,0,0,0,0,0,2,0,2
8464,145244,2023,Germany,Thailand,0,0,5,5,14/06/2023,0,0,0,0,4,0,3,7,1,0,4,5,0,0,0,0,1,0,1,2
8465,145244,2023,Thailand,Korea,1,2,10,13,04/06/2023,0,0,3,3,4,0,3,7,2,5,9,16,0,0,0,0,3,2,0,5
8466,145244,2023,Thailand,Poland,0,0,5,5,02/06/2023,0,0,1,1,0,0,0,0,0,0,0,0,0,0,0,0,0,0,1,1
8467,145244,2023,Canada,Thailand,1,0,12,13,01/06/2023,0,1,2,3,2,0,1,3,3,4,6,13,0,0,1,1,2,0,2,4
8468,145244,2023,Italy,Thailand,0,2,10,12,30/05/2023,0,0,2,2,5,3,5,13,3,6,8,17,0,0,0,0,0,0,3,3
8469,122866,2023,Thailand,Brazil,0,0,0,0,02/07/2023,0,1,7,8,0,0,0,0,0,0,0,0,0,0,8,8,2,2,2,6
8470,122866,2023,Thailand,Japan,0,0,6,6,01/07/2023,0,0,4,4,3,3,13,19,0,0,4,4,3,0,9,12,4,1,2,7
8471,122866,2023,Thailand,Türkiye,0,0,1,1,29/06/2023,0,0,0,0,0,0,0,0,0,0,0,0,0,0,0,0,0,2,0,2
8472,122866,2023,Thailand,Netherlands,0,0,1,1,27/06/2023,0,0,1,1,0,0,0,0,0,0,0,0,0,0,0,0,0,0,0,0
8473,147188,2023,Thailand,Brazil,1,1,3,5,02/07/2023,13,1,51,65,0,0,1,1,0,2,0,2,0,0,0,0,2,1,0,3
8474,147188,2023,Thailand,Japan,0,0,1,1,01/07/2023,6,1,8,15,1,0,1,2,0,0,3,3,0,0,0,0,4,0,0,4
8475,147188,2023,Thailand,Türkiye,0,0,0,0,29/06/2023,3,0,10,13,0,0,1,1,0,1,0,1,0,0,0,0,0,0,0,0
8476,147188,2023,Thailand,Netherlands,0,0,0,0,27/06/2023,2,0,5,7,0,0,1,1,0,0,0,0,0,0,0,0,1,0,0,1
8477,151121,2023,Thailand,Brazil,0,1,8,9,02/07/2023,0,0,3,3,7,3,7,17,0,2,0,2,0,0,0,0,11,1,2,14
8478,151121,2023,Thailand,Japan,0,0,9,9,01/07/2023,0,0,3,3,5,4,10,19,0,1,1,2,0,0,2,2,8,0,2,10
8479,151121,2023,Thailand,Türkiye,0,0,4,4,29/06/2023,0,0,0,0,5,5,8,18,1,0,2,3,0,0,0,0,6,1,1,8
8480,151121,2023,Thailand,Netherlands,0,0,5,5,27/06/2023,0,0,0,0,3,2,12,17,0,0,3,3,0,0,0,0,3,0,0,3
8481,151121,2023,Thailand,Croatia,0,0,6,6,18/06/2023,0,0,1,1,2,5,6,13,0,0,3,3,0,0,1,1,1,1,0,2
8482,151121,2023,Serbia,Thailand,0,2,12,14,17/06/2023,0,0,1,1,20,9,30,59,0,2,3,5,0,0,0,0,12,7,1,20
8483,151121,2023,Thailand,USA,0,0,2,2,15/06/2023,0,0,2,2,3,3,9,15,1,0,1,2,0,0,2,2,2,0,0,2
8484,151121,2023,Germany,Thailand,0,2,9,11,14/06/2023,0,0,1,1,9,5,9,23,1,0,1,2,0,0,1,1,3,2,1,6
8485,151121,2023,Thailand,Korea,0,0,12,12,04/06/2023,0,0,1,1,12,4,12,28,1,2,4,7,0,0,0,0,10,3,0,13
8486,151121,2023,Thailand,Poland,0,1,6,7,02/06/2023,0,0,1,1,5,2,8,15,0,3,4,7,0,0,0,0,2,3,2,7
8487,151121,2023,Canada,Thailand,2,0,10,12,01/06/2023,1,0,3,4,6,4,14,24,0,2,2,4,0,0,0,0,6,7,0,13
8488,151121,2023,Italy,Thailand,1,3,16,20,30/05/2023,0,0,3,3,21,8,19,48,0,1,3,4,1,0,0,1,11,1,3,15
8489,133511,2023,Thailand,Brazil,1,0,8,9,02/07/2023,0,0,3,3,4,4,6,14,0,0,2,2,10,0,18,28,4,6,1,11
8490,133511,2023,Thailand,Japan,0,0,5,5,01/07/2023,0,0,0,0,6,1,7,14,0,2,0,2,3,4,7,14,4,2,3,9
8491,133511,2023,Thailand,Türkiye,0,1,3,4,29/06/2023,0,0,1,1,5,5,13,23,1,0,0,1,6,0,10,16,1,1,0,2
8492,133511,2023,Thailand,Netherlands,0,0,4,4,27/06/2023,0,0,0,0,8,1,5,14,0,2,1,3,1,2,8,11,1,1,1,3
8493,133511,2023,Thailand,Croatia,1,2,7,10,18/06/2023,0,0,1,1,13,1,17,31,0,3,2,5,6,1,14,21,11,1,2,14
8494,133511,2023,Serbia,Thailand,1,0,14,15,17/06/2023,0,0,3,3,13,3,19,35,3,2,3,8,9,3,24,36,14,7,1,22
8495,133511,2023,Thailand,USA,0,0,9,9,15/06/2023,0,0,3,3,8,4,13,25,2,3,1,6,0,0,3,3,6,3,1,10
8496,133511,2023,Germany,Thailand,0,0,3,3,14/06/2023,0,0,2,2,2,1,4,7,1,0,1,2,0,1,9,10,6,0,0,6
8497,133511,2023,Thailand,Korea,0,0,6,6,04/06/2023,0,0,0,0,6,1,8,15,0,1,1,2,4,0,19,23,6,3,0,9
8498,133511,2023,Thailand,Poland,0,1,5,6,02/06/2023,0,0,4,4,4,1,7,12,0,0,0,0,3,1,12,16,7,2,1,10
8499,133511,2023,Canada,Thailand,0,0,0,0,01/06/2023,0,0,0,0,0,0,0,0,0,0,0,0,0,0,0,0,0,0,0,0
8500,133511,2023,Italy,Thailand,0,1,14,15,30/05/2023,0,0,4,4,11,3,17,31,2,2,0,4,6,0,16,22,7,3,3,13
8501,147213,2023,Thailand,Brazil,1,2,8,11,02/07/2023,0,0,0,0,18,6,18,42,1,0,2,3,6,1,18,25,6,1,2,9
8502,147213,2023,Thailand,Japan,0,1,8,9,01/07/2023,0,0,2,2,8,5,20,33,0,3,1,4,5,1,17,23,5,0,0,5
8503,147213,2023,Thailand,Türkiye,1,3,6,10,29/06/2023,0,0,3,3,5,8,11,24,0,1,1,2,13,2,15,30,6,1,2,9
8504,147213,2023,Thailand,Netherlands,0,2,8,10,27/06/2023,0,0,3,3,13,5,10,28,0,5,2,7,3,2,25,30,7,2,1,10
8505,147213,2023,Thailand,Croatia,0,0,9,9,18/06/2023,0,0,0,0,16,4,11,31,3,3,6,12,4,0,13,17,5,3,3,11
8506,147213,2023,Serbia,Thailand,1,2,16,19,17/06/2023,0,1,8,9,18,8,24,50,2,1,6,9,10,0,18,28,18,10,2,30
8507,147213,2023,Thailand,USA,1,1,8,10,15/06/2023,0,0,3,3,10,3,12,25,2,3,3,8,8,2,29,39,6,3,1,10
8508,147213,2023,Germany,Thailand,0,1,12,13,14/06/2023,0,1,2,3,8,4,14,26,2,4,5,11,12,2,19,33,9,2,4,15
8509,147213,2023,Thailand,Korea,2,2,11,15,04/06/2023,0,0,3,3,16,5,19,40,2,2,4,8,1,2,10,13,11,5,1,17
8510,147213,2023,Thailand,Poland,0,1,6,7,02/06/2023,0,0,1,1,7,5,10,22,3,1,0,4,2,0,12,14,1,0,2,3
8511,147213,2023,Canada,Thailand,1,1,12,14,01/06/2023,0,0,6,6,14,6,20,40,2,1,3,6,11,0,18,29,16,3,0,19
8512,147213,2023,Italy,Thailand,0,3,11,14,30/05/2023,0,0,3,3,15,9,15,39,0,1,1,2,7,6,31,44,16,5,4,25
8513,162681,2023,Thailand,Brazil,0,0,0,0,02/07/2023,0,0,0,0,0,0,0,0,0,0,0,0,0,0,0,0,1,1,1,3
8514,162681,2023,Thailand,Japan,0,0,0,0,01/07/2023,0,0,4,4,0,0,0,0,0,0,0,0,0,0,0,0,4,1,0,5
8515,162681,2023,Thailand,Türkiye,0,0,0,0,29/06/2023,0,0,1,1,0,0,0,0,0,0,0,0,0,0,0,0,3,3,1,7
8516,162681,2023,Thailand,Netherlands,0,0,0,0,27/06/2023,0,0,2,2,0,0,0,0,0,0,0,0,0,0,0,0,8,2,0,10
8517,162681,2023,Thailand,Croatia,0,0,0,0,18/06/2023,0,0,2,2,0,0,0,0,0,0,0,0,0,0,0,0,4,3,2,9
8518,162681,2023,Serbia,Thailand,0,0,0,0,17/06/2023,0,0,5,5,0,0,0,0,0,0,0,0,0,0,0,0,11,6,3,20
8519,162681,2023,Thailand,USA,0,0,0,0,15/06/2023,0,0,2,2,0,0,0,0,0,0,0,0,0,0,0,0,0,4,0,4
8520,162681,2023,Germany,Thailand,0,0,0,0,14/06/2023,0,0,6,6,0,0,0,0,0,0,0,0,0,0,0,0,1,2,1,4
8521,162681,2023,Thailand,Korea,0,0,0,0,04/06/2023,0,0,5,5,0,0,0,0,0,0,0,0,0,0,0,0,7,1,1,9
8522,162681,2023,Thailand,Poland,0,0,0,0,02/06/2023,0,0,2,2,0,0,0,0,0,0,0,0,1,0,3,4,4,4,2,10
8523,162681,2023,Canada,Thailand,0,0,0,0,01/06/2023,0,0,2,2,0,0,0,0,0,0,0,0,0,0,1,1,13,4,2,19
8524,162681,2023,Italy,Thailand,0,0,0,0,30/05/2023,0,0,1,1,0,0,0,0,0,0,0,0,0,0,1,1,14,1,2,17
8525,152205,2023,Thailand,Brazil,0,0,7,7,02/07/2023,0,0,3,3,1,0,3,4,0,1,1,2,0,0,0,0,2,0,0,2
8526,152205,2023,Thailand,Japan,0,1,2,3,01/07/2023,0,0,0,0,0,0,6,6,0,2,0,2,0,0,0,0,3,0,0,3
8527,152205,2023,Thailand,Türkiye,0,0,4,4,29/06/2023,0,0,0,0,5,2,5,12,1,0,0,1,0,0,0,0,0,2,0,2
8528,152205,2023,Thailand,Netherlands,0,0,8,8,27/06/2023,0,0,0,0,5,1,9,15,0,2,2,4,0,0,0,0,5,0,1,6
8529,152205,2023,Thailand,Croatia,0,1,2,3,18/06/2023,0,0,1,1,3,1,2,6,0,1,0,1,0,0,0,0,1,0,0,1
8530,152205,2023,Serbia,Thailand,0,1,1,2,17/06/2023,0,0,0,0,1,1,1,3,0,0,0,0,0,0,0,0,1,1,1,3
8531,152205,2023,Thailand,USA,0,0,1,1,15/06/2023,0,0,0,0,0,1,1,2,0,0,0,0,1,0,0,1,1,0,0,1
8532,152205,2023,Germany,Thailand,0,0,5,5,14/06/2023,0,0,1,1,4,2,2,8,0,0,0,0,0,0,0,0,3,2,0,5
8533,152205,2023,Thailand,Korea,0,1,0,1,04/06/2023,0,0,0,0,0,0,2,2,0,0,2,2,0,0,0,0,2,0,0,2
8534,152205,2023,Thailand,Poland,0,0,3,3,02/06/2023,0,0,2,2,4,2,4,10,0,2,0,2,0,0,0,0,0,0,0,0
8535,152205,2023,Canada,Thailand,0,0,0,0,01/06/2023,0,0,0,0,0,1,0,1,0,0,0,0,0,0,0,0,0,0,0,0
8536,152205,2023,Italy,Thailand,0,0,2,2,30/05/2023,0,0,0,0,5,1,4,10,0,2,1,3,0,0,0,0,0,1,0,1
8537,163495,2023,Thailand,Brazil,0,1,2,3,02/07/2023,0,0,0,0,0,1,2,3,0,1,3,4,0,0,0,0,0,0,0,0
8538,163495,2023,Thailand,Japan,0,0,0,0,01/07/2023,0,0,0,0,0,0,0,0,0,0,0,0,0,0,0,0,0,0,0,0
8539,163495,2023,Thailand,Türkiye,0,0,0,0,29/06/2023,0,0,0,0,0,0,0,0,0,0,0,0,0,0,0,0,0,0,0,0
8540,163495,2023,Thailand,Netherlands,0,2,1,3,27/06/2023,0,0,1,1,0,0,3,3,0,3,1,4,0,0,0,0,1,0,1,2
8541,143002,2023,Thailand,Brazil,0,0,8,8,02/07/2023,0,0,0,0,2,0,6,8,3,0,3,6,0,0,0,0,0,4,0,4
8542,143002,2023,Thailand,Japan,0,0,2,2,01/07/2023,0,0,0,0,1,0,1,2,0,0,1,1,0,0,0,0,0,0,0,0
8543,143002,2023,Thailand,Türkiye,0,0,0,0,29/06/2023,0,0,0,0,0,0,0,0,0,0,0,0,0,0,0,0,0,0,0,0
8544,143002,2023,Thailand,Netherlands,0,0,0,0,27/06/2023,0,0,0,0,0,0,0,0,0,0,0,0,0,0,0,0,0,0,0,0
8545,143002,2023,Thailand,Croatia,0,0,1,1,18/06/2023,0,0,0,0,1,1,1,3,0,3,0,3,0,0,0,0,0,0,0,0
8546,143002,2023,Serbia,Thailand,0,0,15,15,17/06/2023,0,0,2,2,3,1,4,8,2,7,6,15,0,0,1,1,3,2,1,6
8547,143002,2023,Thailand,USA,0,0,5,5,15/06/2023,0,0,0,0,0,0,2,2,0,1,0,1,1,0,0,1,1,0,0,1
8548,143002,2023,Germany,Thailand,0,1,5,6,14/06/2023,0,0,0,0,4,0,4,8,0,0,2,2,0,0,0,0,2,0,0,2
8549,143002,2023,Thailand,Korea,0,0,0,0,04/06/2023,0,0,0,0,0,0,0,0,0,0,0,0,0,0,0,0,0,0,0,0
8550,143002,2023,Thailand,Poland,0,0,3,3,02/06/2023,0,1,1,2,1,1,0,2,0,2,1,3,0,0,0,0,1,0,0,1
8551,143002,2023,Canada,Thailand,0,0,0,0,01/06/2023,0,0,0,0,0,0,0,0,0,0,0,0,0,0,0,0,0,0,0,0
8552,143002,2023,Italy,Thailand,0,1,0,1,30/05/2023,0,0,0,0,0,0,0,0,0,0,0,0,0,0,1,1,0,0,0,0
8553,138773,2023,China,Türkiye,0,0,0,0,16/07/2023,0,1,4,5,0,0,0,0,0,0,0,0,5,1,10,16,20,5,2,27
8554,138773,2023,USA,Türkiye,0,0,0,0,16/07/2023,0,0,9,9,0,0,0,0,0,0,0,0,4,0,13,17,16,6,2,24
8555,138773,2023,Türkiye,Italy,0,0,0,0,13/07/2023,0,0,6,6,0,0,0,0,0,0,0,0,3,1,6,10,10,3,2,15
8556,138773,2023,Croatia,Türkiye,0,0,0,0,02/07/2023,0,0,0,0,0,0,0,0,0,0,0,0,0,0,0,0,0,0,0,0
8557,138773,2023,Brazil,Türkiye,0,0,0,0,30/06/2023,0,1,11,12,0,0,0,0,0,0,0,0,4,0,6,10,6,3,1,10
8558,138773,2023,Thailand,Türkiye,0,0,0,0,29/06/2023,0,0,0,0,0,0,0,0,0,0,0,0,0,0,0,0,0,0,0,0
8559,138773,2023,Japan,Türkiye,0,0,0,0,28/06/2023,0,0,14,14,0,0,0,0,0,0,0,0,7,2,13,22,22,7,2,31
8560,138773,2023,USA,Türkiye,0,0,1,1,04/06/2023,0,1,7,8,0,0,0,0,0,0,0,0,7,0,8,15,18,11,1,30
8561,138773,2023,Türkiye,Italy,0,0,0,0,03/06/2023,0,0,0,0,0,0,0,0,0,0,0,0,1,0,1,2,0,0,0,0
8562,138773,2023,Türkiye,Serbia,0,0,0,0,01/06/2023,0,0,7,7,0,0,0,0,0,0,0,0,7,0,5,12,12,6,1,19
8563,138773,2023,Korea,Türkiye,0,0,0,0,31/05/2023,0,0,0,0,0,0,0,0,0,0,0,0,0,0,0,0,0,0,0,0
8564,158840,2023,China,Türkiye,0,0,0,0,16/07/2023,0,0,0,0,0,0,0,0,0,0,0,0,0,0,0,0,0,0,1,1
8565,158840,2023,USA,Türkiye,0,0,0,0,16/07/2023,0,0,0,0,0,0,0,0,0,0,0,0,0,0,0,0,0,0,0,0
8566,158840,2023,Türkiye,Italy,0,0,0,0,13/07/2023,0,0,0,0,0,0,0,0,0,0,0,0,0,0,0,0,0,0,0,0
8567,158840,2023,Dominican Republic,Türkiye,0,0,0,0,18/06/2023,0,0,3,3,0,0,0,0,0,0,0,0,16,2,13,31,12,3,1,16
8568,158840,2023,Türkiye,Canada,0,0,0,0,16/06/2023,0,0,4,4,0,0,0,0,0,0,0,0,6,0,10,16,9,0,1,10
8569,158840,2023,Poland,Türkiye,0,0,0,0,15/06/2023,0,0,0,0,0,0,0,0,0,0,0,0,0,0,0,0,0,0,0,0
8570,158840,2023,Netherlands,Türkiye,0,0,0,0,14/06/2023,0,0,4,4,0,0,0,0,0,0,0,0,8,0,13,21,11,6,0,17
8571,158840,2023,USA,Türkiye,0,0,0,0,04/06/2023,0,0,0,0,0,0,0,0,0,0,0,0,2,0,3,5,1,0,0,1
8572,158840,2023,Türkiye,Italy,0,0,0,0,03/06/2023,0,0,6,6,0,0,0,0,0,0,0,0,6,1,16,23,7,1,2,10
8573,158840,2023,Türkiye,Serbia,0,0,0,0,01/06/2023,0,0,0,0,0,0,0,0,0,0,0,0,0,0,0,0,0,0,0,0
8574,158840,2023,Korea,Türkiye,0,0,0,0,31/05/2023,0,0,8,8,0,0,0,0,0,0,0,0,3,0,10,13,14,2,1,17
8575,143590,2023,China,Türkiye,0,0,0,0,16/07/2023,1,0,5,6,0,0,0,0,0,0,1,1,0,0,0,0,1,0,0,1
8576,143590,2023,USA,Türkiye,0,0,6,6,16/07/2023,4,0,22,26,0,0,0,0,1,1,2,4,0,0,0,0,1,0,1,2
8577,143590,2023,Türkiye,Italy,0,0,0,0,13/07/2023,1,0,1,2,0,0,0,0,0,0,0,0,0,0,0,0,0,0,0,0
8578,143590,2023,Croatia,Türkiye,0,1,5,6,02/07/2023,16,0,60,76,0,0,0,0,0,3,2,5,0,0,0,0,3,1,0,4
8579,143590,2023,Brazil,Türkiye,0,0,0,0,30/06/2023,1,0,4,5,0,0,0,0,0,0,0,0,0,0,0,0,0,0,0,0
8580,143590,2023,Thailand,Türkiye,0,0,1,1,29/06/2023,0,0,4,4,0,0,0,0,0,0,0,0,0,0,0,0,0,0,0,0
8581,143590,2023,Japan,Türkiye,0,1,12,13,28/06/2023,22,1,59,82,1,0,0,1,0,1,4,5,0,0,0,0,6,2,1,9
8582,143590,2023,Dominican Republic,Türkiye,0,0,1,1,18/06/2023,1,0,12,13,0,0,0,0,0,1,1,2,0,0,0,0,2,0,0,2
8583,143590,2023,Türkiye,Canada,0,0,0,0,16/06/2023,1,0,4,5,0,0,0,0,0,0,0,0,0,0,0,0,0,0,0,0
8584,143590,2023,Poland,Türkiye,0,1,8,9,15/06/2023,15,2,54,71,1,0,2,3,0,1,3,4,0,0,0,0,7,1,0,8
8585,143590,2023,Netherlands,Türkiye,0,1,8,9,14/06/2023,13,0,46,59,1,0,2,3,0,3,3,6,0,0,0,0,6,1,0,7
8586,143590,2023,USA,Türkiye,0,2,10,12,04/06/2023,6,0,96,102,0,0,0,0,0,6,6,12,0,0,0,0,2,2,0,4
8587,143590,2023,Türkiye,Italy,0,0,6,6,03/06/2023,7,0,53,60,0,1,2,3,1,2,0,3,0,0,0,0,3,5,1,9
8588,143590,2023,Türkiye,Serbia,0,1,10,11,01/06/2023,12,1,60,73,2,0,1,3,0,3,5,8,0,0,0,0,2,2,1,5
8589,143590,2023,Korea,Türkiye,0,1,6,7,31/05/2023,18,0,29,47,0,0,0,0,0,3,3,6,0,0,0,0,4,1,1,6
8590,143339,2023,China,Türkiye,3,1,15,19,16/07/2023,0,0,1,1,21,4,14,39,2,1,1,4,0,0,0,0,11,2,3,16
8591,143339,2023,USA,Türkiye,1,1,13,15,16/07/2023,0,0,5,5,20,5,18,43,2,2,5,9,0,0,0,0,5,0,2,7
8592,143339,2023,Türkiye,Italy,1,2,11,14,13/07/2023,0,0,1,1,14,3,10,27,1,3,1,5,0,0,0,0,5,3,1,9
8593,143339,2023,Dominican Republic,Türkiye,2,2,13,17,18/06/2023,0,0,4,4,26,4,8,38,1,1,1,3,0,0,0,0,9,3,4,16
8594,143339,2023,Türkiye,Canada,2,0,12,14,16/06/2023,0,0,1,1,14,3,10,27,1,6,3,10,0,0,0,0,8,0,0,8
8595,143339,2023,Poland,Türkiye,2,3,9,14,15/06/2023,0,0,0,0,21,3,19,43,1,3,1,5,1,0,2,3,11,5,0,16
8596,143339,2023,Netherlands,Türkiye,1,2,3,6,14/06/2023,0,0,1,1,7,2,4,13,1,2,1,4,0,0,0,0,6,1,0,7
8597,143339,2023,USA,Türkiye,3,1,6,10,04/06/2023,0,0,1,1,21,6,18,45,1,1,1,3,0,0,0,0,6,3,0,9
8598,143339,2023,Türkiye,Italy,0,1,10,11,03/06/2023,0,0,0,0,20,5,6,31,2,1,1,4,0,0,1,1,4,3,2,9
8599,143339,2023,Türkiye,Serbia,3,2,9,14,01/06/2023,0,0,1,1,17,5,8,30,1,1,1,3,0,0,0,0,12,1,0,13
8600,143339,2023,Korea,Türkiye,1,1,9,11,31/05/2023,0,0,0,0,13,2,6,21,1,1,0,2,0,0,0,0,5,2,2,9
8601,143592,2023,China,Türkiye,0,0,0,0,16/07/2023,0,0,2,2,0,0,0,0,0,0,0,0,3,0,4,7,2,0,0,2
8602,143592,2023,USA,Türkiye,0,0,0,0,16/07/2023,0,0,1,1,0,0,0,0,0,0,0,0,1,0,5,6,4,0,0,4
8603,143592,2023,Türkiye,Italy,0,0,0,0,13/07/2023,0,0,0,0,0,0,0,0,0,0,0,0,1,0,2,3,1,0,0,1
8604,143592,2023,Croatia,Türkiye,0,0,0,0,02/07/2023,0,0,8,8,0,0,0,0,0,0,0,0,2,0,3,5,11,3,0,14
8605,143592,2023,Brazil,Türkiye,0,0,0,0,30/06/2023,0,0,0,0,0,0,0,0,0,0,0,0,0,0,0,0,0,0,0,0
8606,143592,2023,Thailand,Türkiye,0,0,0,0,29/06/2023,0,0,6,6,0,0,0,0,0,0,0,0,4,1,6,11,8,5,5,18
8607,143592,2023,Japan,Türkiye,0,0,0,0,28/06/2023,0,0,0,0,0,0,0,0,0,0,0,0,0,0,0,0,0,0,0,0
8608,143592,2023,Dominican Republic,Türkiye,0,0,0,0,18/06/2023,0,0,0,0,0,0,0,0,0,0,0,0,2,0,1,3,0,2,1,3
8609,143592,2023,Türkiye,Canada,0,0,0,0,16/06/2023,0,0,0,0,0,0,0,0,0,0,0,0,1,0,0,1,0,0,0,0
8610,143592,2023,Poland,Türkiye,0,0,0,0,15/06/2023,0,0,12,12,0,0,0,0,0,0,0,0,4,0,8,12,12,6,0,18
8611,143592,2023,Netherlands,Türkiye,0,0,0,0,14/06/2023,0,0,0,0,0,0,0,0,0,0,0,0,0,0,0,0,0,0,0,0
8612,143585,2023,China,Türkiye,0,0,0,0,16/07/2023,0,0,0,0,0,0,0,0,0,0,0,0,0,0,0,0,0,0,0,0
8613,143585,2023,USA,Türkiye,0,0,0,0,16/07/2023,0,0,0,0,0,0,0,0,0,0,0,0,0,0,0,0,0,0,0,0
8614,143585,2023,Türkiye,Italy,0,0,0,0,13/07/2023,0,0,0,0,0,0,0,0,0,0,0,0,0,0,0,0,0,0,0,0
8615,143585,2023,Croatia,Türkiye,0,1,12,13,02/07/2023,0,0,0,0,10,0,6,16,2,0,3,5,13,0,14,27,8,1,0,9
8616,143585,2023,Brazil,Türkiye,0,0,0,0,30/06/2023,0,0,0,0,0,2,0,2,0,0,0,0,0,0,0,0,1,0,0,1
8617,143585,2023,Thailand,Türkiye,0,0,0,0,29/06/2023,0,0,0,0,1,2,2,5,0,0,0,0,0,0,0,0,1,1,0,2
8618,143585,2023,Japan,Türkiye,1,1,7,9,28/06/2023,0,0,2,2,6,4,11,21,0,2,2,4,4,0,17,21,6,1,0,7
8619,143585,2023,Dominican Republic,Türkiye,1,1,12,14,18/06/2023,0,0,1,1,9,2,11,22,3,3,3,9,10,1,11,22,3,0,0,3
8620,143585,2023,Türkiye,Canada,0,0,5,5,16/06/2023,0,0,1,1,0,2,3,5,0,0,2,2,2,0,3,5,3,0,1,4
8621,143585,2023,Poland,Türkiye,0,1,2,3,15/06/2023,0,0,0,0,4,5,4,13,1,1,0,2,2,0,3,5,3,0,0,3
8622,143585,2023,Netherlands,Türkiye,0,3,7,10,14/06/2023,0,0,1,1,10,1,9,20,2,2,4,8,3,1,21,25,6,3,0,9
8623,143585,2023,USA,Türkiye,0,1,8,9,04/06/2023,0,0,0,0,3,3,10,16,0,0,3,3,4,0,19,23,2,2,0,4
8624,143585,2023,Türkiye,Italy,0,0,0,0,03/06/2023,0,0,0,0,0,0,0,0,0,0,0,0,0,0,0,0,0,0,0,0
8625,143585,2023,Türkiye,Serbia,0,1,13,14,01/06/2023,0,1,2,3,11,5,9,25,2,1,3,6,8,1,22,31,4,4,0,8
8626,143585,2023,Korea,Türkiye,0,3,2,5,31/05/2023,0,0,0,0,7,2,7,16,0,0,1,1,1,1,7,9,4,1,0,5
8627,163094,2023,China,Türkiye,1,1,18,20,16/07/2023,0,0,2,2,8,6,4,18,1,2,2,5,1,2,11,14,3,2,1,6
8628,163094,2023,USA,Türkiye,0,0,13,13,16/07/2023,0,0,2,2,6,4,9,19,2,1,0,3,3,2,22,27,5,2,0,7
8629,163094,2023,Türkiye,Italy,0,0,0,0,13/07/2023,0,0,0,0,1,0,0,1,0,0,0,0,0,0,0,0,0,0,0,0
8630,163094,2023,Croatia,Türkiye,0,0,1,1,02/07/2023,0,1,0,1,3,1,3,7,0,0,1,1,0,0,0,0,1,0,0,1
8631,163094,2023,Brazil,Türkiye,0,0,8,8,30/06/2023,0,0,2,2,5,3,6,14,0,3,1,4,7,0,13,20,10,2,0,12
8632,163094,2023,Thailand,Türkiye,0,0,10,10,29/06/2023,0,0,3,3,12,1,8,21,0,2,3,5,3,1,10,14,9,5,0,14
8633,163094,2023,Japan,Türkiye,0,0,16,16,28/06/2023,0,0,1,1,8,2,10,20,1,3,7,11,3,0,13,16,11,2,0,13
8634,163094,2023,Dominican Republic,Türkiye,0,0,0,0,18/06/2023,0,0,0,0,0,0,0,0,0,0,0,0,0,0,0,0,0,0,0,0
8635,163094,2023,Poland,Türkiye,0,0,0,0,15/06/2023,0,0,0,0,0,0,0,0,0,0,0,0,0,0,0,0,0,0,0,0
8636,163094,2023,Netherlands,Türkiye,0,0,0,0,14/06/2023,0,0,0,0,0,0,0,0,0,0,0,0,0,0,0,0,0,0,0,0
8637,163094,2023,USA,Türkiye,0,0,1,1,04/06/2023,0,0,0,0,0,0,1,1,0,1,0,1,0,2,2,4,1,0,0,1
8638,163094,2023,Türkiye,Italy,0,2,14,16,03/06/2023,0,0,3,3,5,1,5,11,0,2,1,3,1,1,16,18,5,1,1,7
8639,163094,2023,Türkiye,Serbia,0,0,1,1,01/06/2023,0,0,0,0,0,0,0,0,0,0,0,0,0,0,0,0,0,0,0,0
8640,163094,2023,Korea,Türkiye,0,0,6,6,31/05/2023,0,0,0,0,2,2,3,7,0,1,0,1,0,0,5,5,3,2,0,5
8641,163975,2023,China,Türkiye,2,1,8,11,16/07/2023,19,0,71,90,1,0,2,3,2,3,3,8,0,0,0,0,4,2,1,7
8642,163975,2023,USA,Türkiye,0,1,13,14,16/07/2023,8,0,63,71,1,1,3,5,2,3,6,11,0,0,0,0,4,0,1,5
8643,163975,2023,Türkiye,Italy,0,1,7,8,13/07/2023,6,0,56,62,2,0,2,4,1,1,1,3,0,1,1,2,2,0,0,2
8644,163975,2023,Croatia,Türkiye,0,0,2,2,02/07/2023,1,0,6,7,0,1,0,1,0,0,0,0,0,0,0,0,1,1,0,2
8645,163975,2023,Brazil,Türkiye,0,0,8,8,30/06/2023,12,1,63,76,4,1,1,6,1,2,1,4,0,0,0,0,8,2,3,13
8646,163975,2023,Thailand,Türkiye,1,0,16,17,29/06/2023,8,1,53,62,1,0,3,4,2,0,4,6,0,0,0,0,5,2,1,8
8647,163975,2023,Japan,Türkiye,0,0,4,4,28/06/2023,16,0,36,52,3,0,2,5,0,3,2,5,0,0,0,0,3,2,0,5
8648,163975,2023,Dominican Republic,Türkiye,0,0,22,22,18/06/2023,32,3,56,91,1,0,2,3,3,0,1,4,0,0,0,0,3,5,0,8
8649,163975,2023,Türkiye,Canada,1,0,10,11,16/06/2023,13,0,60,73,2,0,1,3,1,2,1,4,0,1,0,1,4,1,0,5
8650,163975,2023,Poland,Türkiye,0,0,2,2,15/06/2023,1,1,18,20,2,0,0,2,1,1,0,2,0,0,0,0,4,0,1,5
8651,163975,2023,Netherlands,Türkiye,0,0,3,3,14/06/2023,5,0,25,30,0,1,0,1,0,0,0,0,0,0,0,0,1,0,0,1
8652,163975,2023,USA,Türkiye,0,0,0,0,04/06/2023,2,0,18,20,0,0,1,1,0,0,0,0,0,0,0,0,0,2,0,2
8653,163975,2023,Türkiye,Italy,0,0,0,0,03/06/2023,0,0,6,6,0,0,0,0,0,0,0,0,0,0,0,0,1,0,0,1
8654,163975,2023,Türkiye,Serbia,0,0,0,0,01/06/2023,7,0,14,21,0,0,0,0,0,0,0,0,0,0,0,0,1,1,0,2
8655,163975,2023,Korea,Türkiye,0,0,1,1,31/05/2023,6,0,27,33,2,0,0,2,1,0,0,1,0,0,0,0,1,2,1,4
8656,138782,2023,China,Türkiye,0,3,12,15,16/07/2023,0,0,1,1,8,2,5,15,4,8,7,19,1,0,0,1,5,0,0,5
8657,138782,2023,USA,Türkiye,0,2,16,18,16/07/2023,0,0,4,4,4,0,3,7,3,5,9,17,0,0,0,0,3,0,0,3
8658,138782,2023,Türkiye,Italy,0,0,10,10,13/07/2023,0,0,2,2,6,1,3,10,5,4,5,14,1,1,0,2,2,0,0,2
8659,138782,2023,Croatia,Türkiye,0,1,3,4,02/07/2023,0,0,0,0,2,0,2,4,1,0,3,4,0,0,0,0,2,0,0,2
8660,138782,2023,Brazil,Türkiye,0,1,13,14,30/06/2023,0,0,6,6,5,3,6,14,7,6,10,23,0,0,0,0,7,1,1,9
8661,138782,2023,Thailand,Türkiye,0,0,8,8,29/06/2023,0,0,3,3,8,0,1,9,4,1,4,9,0,0,0,0,1,0,0,1
8662,138782,2023,Japan,Türkiye,0,1,10,11,28/06/2023,0,0,3,3,8,2,10,20,6,9,12,27,0,0,0,0,6,1,0,7
8663,138782,2023,Dominican Republic,Türkiye,0,1,15,16,18/06/2023,0,1,4,5,5,3,2,10,1,6,4,11,0,0,0,0,3,3,0,6
8664,138782,2023,Türkiye,Canada,2,2,8,12,16/06/2023,0,0,1,1,6,0,3,9,3,2,5,10,0,0,0,0,4,1,1,6
8665,138782,2023,Poland,Türkiye,1,0,9,10,15/06/2023,0,0,3,3,4,1,5,10,1,4,4,9,0,0,0,0,1,1,1,3
8666,138782,2023,Netherlands,Türkiye,1,1,10,12,14/06/2023,0,0,3,3,8,1,0,9,3,5,11,19,0,0,0,0,1,1,1,3
8667,138782,2023,USA,Türkiye,0,0,5,5,04/06/2023,0,0,3,3,3,1,2,6,1,3,6,10,0,0,1,1,5,0,0,5
8668,138782,2023,Türkiye,Italy,0,0,0,0,03/06/2023,0,0,0,0,0,0,0,0,0,0,0,0,0,0,0,0,0,0,0,0
8669,138782,2023,Türkiye,Serbia,1,4,15,20,01/06/2023,0,0,6,6,8,0,4,12,3,9,9,21,0,0,0,0,6,0,1,7
8670,138782,2023,Korea,Türkiye,1,1,10,12,31/05/2023,0,0,4,4,4,1,6,11,0,3,7,10,0,0,0,0,6,1,1,8
8671,152312,2023,China,Türkiye,0,0,2,2,16/07/2023,0,0,0,0,0,0,0,0,0,0,0,0,0,0,0,0,0,1,0,1
8672,152312,2023,USA,Türkiye,0,0,0,0,16/07/2023,0,0,0,0,0,0,0,0,0,0,0,0,0,0,0,0,0,0,0,0
8673,152312,2023,Türkiye,Italy,0,0,0,0,13/07/2023,0,0,0,0,0,0,0,0,0,0,0,0,0,0,0,0,0,0,0,0
8674,152312,2023,Croatia,Türkiye,0,2,16,18,02/07/2023,0,0,0,0,9,5,7,21,0,2,5,7,4,1,10,15,8,2,2,12
8675,152312,2023,Brazil,Türkiye,0,0,1,1,30/06/2023,0,0,0,0,0,0,0,0,0,0,0,0,0,0,0,0,0,0,0,0
8676,152312,2023,Thailand,Türkiye,0,0,0,0,29/06/2023,0,0,0,0,0,0,0,0,0,0,0,0,0,0,0,0,0,0,0,0
8677,152312,2023,Japan,Türkiye,0,1,11,12,28/06/2023,0,0,0,0,1,2,5,8,0,0,1,1,2,2,8,12,4,2,1,7
8678,152312,2023,Dominican Republic,Türkiye,0,1,2,3,18/06/2023,0,0,0,0,1,1,0,2,0,0,0,0,1,0,3,4,2,3,0,5
8679,152312,2023,Türkiye,Canada,0,0,1,1,16/06/2023,0,0,0,0,1,1,1,3,0,1,0,1,1,0,1,2,1,0,0,1
8680,152312,2023,Poland,Türkiye,0,0,0,0,15/06/2023,0,0,0,0,0,0,0,0,0,0,0,0,2,1,0,3,0,0,0,0
8681,152312,2023,Netherlands,Türkiye,0,0,5,5,14/06/2023,0,0,0,0,1,1,2,4,0,1,0,1,0,0,4,4,1,0,0,1
8682,152312,2023,USA,Türkiye,0,0,0,0,04/06/2023,0,0,0,0,0,0,0,0,0,0,0,0,0,0,0,0,0,0,0,0
8683,152312,2023,Türkiye,Italy,0,0,0,0,03/06/2023,0,0,0,0,0,0,0,0,0,0,0,0,0,0,0,0,0,0,0,0
8684,152312,2023,Türkiye,Serbia,0,0,0,0,01/06/2023,0,0,0,0,0,0,0,0,0,0,0,0,0,0,0,0,0,0,0,0
8685,152312,2023,Korea,Türkiye,0,2,1,3,31/05/2023,0,0,1,1,0,0,2,2,1,0,0,1,0,0,3,3,0,0,0,0
8686,152263,2023,China,Türkiye,0,1,10,11,16/07/2023,0,0,2,2,7,0,6,13,2,3,5,10,0,0,0,0,1,2,0,3
8687,152263,2023,USA,Türkiye,0,3,10,13,16/07/2023,0,0,3,3,7,1,2,10,7,5,9,21,0,0,0,0,1,1,2,4
8688,152263,2023,Türkiye,Italy,2,2,12,16,13/07/2023,0,0,1,1,2,0,3,5,5,4,4,13,0,0,1,1,1,1,1,3
8689,152263,2023,Croatia,Türkiye,0,0,0,0,02/07/2023,0,0,0,0,0,0,0,0,0,0,0,0,0,0,0,0,0,0,0,0
8690,152263,2023,Brazil,Türkiye,0,2,10,12,30/06/2023,0,0,3,3,3,2,2,7,4,2,1,7,0,0,0,0,2,0,0,2
8691,152263,2023,Thailand,Türkiye,1,3,9,13,29/06/2023,0,0,1,1,5,3,3,11,4,0,4,8,0,0,0,0,1,2,0,3
8692,152263,2023,Japan,Türkiye,0,2,15,17,28/06/2023,0,0,3,3,8,0,5,13,7,7,8,22,0,0,0,0,4,3,2,9
8693,152263,2023,Dominican Republic,Türkiye,0,1,13,14,18/06/2023,0,0,1,1,5,0,3,8,8,2,7,17,0,0,1,1,5,0,1,6
8694,152263,2023,Türkiye,Canada,0,0,0,0,16/06/2023,0,0,0,0,0,0,0,0,0,0,0,0,0,0,0,0,0,0,0,0
8695,152263,2023,Poland,Türkiye,0,2,13,15,15/06/2023,0,0,2,2,3,0,1,4,2,8,4,14,0,0,0,0,2,2,2,6
8696,152263,2023,Netherlands,Türkiye,0,0,9,9,14/06/2023,0,0,5,5,4,0,2,6,1,3,0,4,0,0,0,0,1,0,0,1
8697,152263,2023,USA,Türkiye,0,0,8,8,04/06/2023,0,0,2,2,0,0,2,2,1,2,1,4,0,0,0,0,1,0,1,2
8698,152263,2023,Türkiye,Italy,0,2,11,13,03/06/2023,0,0,1,1,4,0,3,7,4,5,7,16,0,0,0,0,1,1,0,2
8699,152263,2023,Türkiye,Serbia,0,0,0,0,01/06/2023,0,0,0,0,0,0,0,0,0,0,0,0,0,0,0,0,0,0,0,0
8700,152263,2023,Korea,Türkiye,0,0,6,6,31/05/2023,0,0,0,0,3,0,4,7,0,2,4,6,0,0,0,0,2,0,2,4
8701,137087,2023,China,Türkiye,0,0,0,0,16/07/2023,0,0,0,0,0,0,0,0,0,0,0,0,0,0,0,0,0,0,0,0
8702,137087,2023,USA,Türkiye,0,0,0,0,16/07/2023,0,0,0,0,0,0,0,0,0,0,0,0,0,0,0,0,0,0,0,0
8703,137087,2023,Türkiye,Italy,0,0,0,0,13/07/2023,0,0,0,0,0,0,0,0,0,0,0,0,0,0,0,0,0,0,0,0
8704,137087,2023,Croatia,Türkiye,1,2,10,13,02/07/2023,0,0,0,0,6,2,2,10,2,1,3,6,0,0,2,2,4,0,1,5
8705,137087,2023,Brazil,Türkiye,0,0,2,2,30/06/2023,0,0,0,0,0,0,0,0,0,0,0,0,0,0,0,0,3,0,0,3
8706,137087,2023,Thailand,Türkiye,0,0,0,0,29/06/2023,0,0,0,0,0,0,0,0,0,0,0,0,0,0,0,0,0,0,0,0
8707,137087,2023,Japan,Türkiye,0,0,0,0,28/06/2023,0,0,0,0,0,0,0,0,0,0,0,0,0,0,0,0,0,0,0,0
8708,137087,2023,Dominican Republic,Türkiye,0,0,0,0,18/06/2023,0,0,0,0,0,0,0,0,0,0,0,0,0,0,0,0,0,0,0,0
8709,137087,2023,Türkiye,Canada,0,1,11,12,16/06/2023,0,0,1,1,1,0,6,7,1,4,3,8,0,0,0,0,2,2,0,4
8710,137087,2023,Poland,Türkiye,0,0,0,0,15/06/2023,0,0,0,0,0,0,0,0,0,1,0,1,0,0,0,0,0,0,0,0
8711,137087,2023,Netherlands,Türkiye,1,0,4,5,14/06/2023,0,0,0,0,1,1,1,3,0,3,2,5,0,0,0,0,1,1,0,2
8712,137087,2023,USA,Türkiye,0,1,5,6,04/06/2023,0,0,1,1,5,0,0,5,3,2,7,12,0,0,0,0,3,1,0,4
8713,137087,2023,Türkiye,Italy,0,0,0,0,03/06/2023,0,0,0,0,0,0,0,0,0,0,0,0,0,0,0,0,0,0,0,0
8714,137087,2023,Türkiye,Serbia,0,2,13,15,01/06/2023,0,0,1,1,3,0,6,9,3,5,8,16,0,0,1,1,4,0,0,4
8715,137087,2023,Korea,Türkiye,0,2,4,6,31/05/2023,0,0,0,0,0,1,0,1,1,0,1,2,0,0,0,0,1,0,0,1
8716,163089,2023,China,Türkiye,0,0,1,1,16/07/2023,0,0,0,0,0,0,1,1,0,0,0,0,1,0,2,3,0,0,0,0
8717,163089,2023,USA,Türkiye,0,1,1,2,16/07/2023,0,0,0,0,0,1,3,4,0,2,0,2,2,1,4,7,3,1,0,4
8718,163089,2023,Türkiye,Italy,0,0,14,14,13/07/2023,0,0,1,1,5,3,3,11,2,1,3,6,4,1,8,13,5,6,1,12
8719,163089,2023,Croatia,Türkiye,0,0,0,0,02/07/2023,0,0,0,0,0,0,0,0,0,0,0,0,0,0,0,0,0,0,0,0
8720,163089,2023,Brazil,Türkiye,0,2,14,16,30/06/2023,0,0,0,0,11,1,9,21,1,2,3,6,5,1,18,24,4,2,1,7
8721,163089,2023,Thailand,Türkiye,2,0,17,19,29/06/2023,0,0,1,1,6,3,3,12,1,2,2,5,9,0,9,18,13,5,0,18
8722,163089,2023,Japan,Türkiye,0,1,7,8,28/06/2023,0,0,4,4,9,5,6,20,1,1,0,2,3,0,12,15,4,1,0,5
8723,163089,2023,Dominican Republic,Türkiye,0,0,0,0,18/06/2023,0,0,0,0,0,0,0,0,0,0,0,0,0,0,0,0,0,0,0,0
8724,163089,2023,Türkiye,Canada,0,1,6,7,16/06/2023,0,0,0,0,3,2,8,13,0,0,2,2,6,0,2,8,1,1,0,2
8725,163089,2023,Poland,Türkiye,0,1,6,7,15/06/2023,0,0,1,1,4,1,5,10,1,1,0,2,4,0,12,16,2,2,0,4
8726,163089,2023,Netherlands,Türkiye,0,1,9,10,14/06/2023,0,0,1,1,9,4,7,20,0,1,2,3,2,1,8,11,10,0,0,10
8727,163089,2023,USA,Türkiye,1,0,15,16,04/06/2023,0,0,2,2,8,5,13,26,2,3,5,10,1,0,16,17,12,2,2,16
8728,163089,2023,Türkiye,Italy,1,4,5,10,03/06/2023,0,0,1,1,7,2,2,11,0,4,4,8,1,0,9,10,4,1,2,7
8729,163089,2023,Türkiye,Serbia,1,2,17,20,01/06/2023,0,0,0,0,11,2,8,21,0,1,3,4,5,0,17,22,6,3,1,10
8730,163089,2023,Korea,Türkiye,2,3,9,14,31/05/2023,0,0,2,2,11,0,4,15,1,2,3,6,3,0,16,19,6,0,2,8
8731,163982,2023,China,Türkiye,2,2,13,17,16/07/2023,0,0,4,4,7,2,16,25,3,2,1,6,7,1,20,28,4,2,2,8
8732,163982,2023,USA,Türkiye,1,1,17,19,16/07/2023,0,0,2,2,11,12,17,40,2,4,1,7,2,0,14,16,8,3,2,13
8733,163982,2023,Türkiye,Italy,0,0,11,11,13/07/2023,0,0,2,2,7,3,9,19,2,2,2,6,2,0,12,14,7,0,0,7
8734,163982,2023,Croatia,Türkiye,1,1,8,10,02/07/2023,0,0,0,0,14,4,8,26,0,1,0,1,0,0,0,0,4,1,2,7
8735,163982,2023,Brazil,Türkiye,1,0,13,14,30/06/2023,0,0,1,1,18,5,21,44,0,1,4,5,0,0,0,0,4,1,1,6
8736,163982,2023,Thailand,Türkiye,0,1,5,6,29/06/2023,0,0,0,0,5,2,12,19,3,0,0,3,0,0,0,0,1,0,1,2
8737,163982,2023,Japan,Türkiye,0,1,14,15,28/06/2023,0,1,0,1,17,6,27,50,2,5,7,14,0,0,0,0,8,2,1,11
8738,163982,2023,Dominican Republic,Türkiye,0,2,9,11,18/06/2023,0,0,0,0,8,6,12,26,0,3,3,6,3,2,11,16,2,1,0,3
8739,163982,2023,Türkiye,Canada,0,3,7,10,16/06/2023,0,0,0,0,12,5,2,19,2,0,0,2,3,1,10,14,5,0,1,6
8740,163982,2023,Poland,Türkiye,1,0,11,12,15/06/2023,0,0,0,0,8,3,10,21,0,1,3,4,4,3,24,31,3,5,1,9
8741,163982,2023,Netherlands,Türkiye,1,0,10,11,14/06/2023,0,0,1,1,12,2,11,25,0,2,1,3,0,0,0,0,1,0,1,2
8742,163982,2023,USA,Türkiye,4,4,23,31,04/06/2023,0,1,0,1,20,4,18,42,2,4,2,8,3,1,17,21,6,3,0,9
8743,163982,2023,Türkiye,Italy,0,1,4,5,03/06/2023,0,0,0,0,4,1,4,9,1,1,0,2,0,0,2,2,0,0,0,0
8744,163982,2023,Türkiye,Serbia,3,0,1,4,01/06/2023,0,0,0,0,9,0,7,16,1,2,0,3,0,0,0,0,0,0,0,0
8745,163982,2023,Korea,Türkiye,0,1,2,3,31/05/2023,0,0,0,0,9,4,5,18,0,0,0,0,0,0,0,0,0,0,0,0
8746,132835,2023,Poland,USA,2,0,3,5,16/07/2023,3,0,17,20,0,0,1,1,0,1,2,3,0,0,0,0,0,2,1,3
8747,132835,2023,USA,Türkiye,1,2,15,18,16/07/2023,8,3,109,120,4,1,2,7,2,0,7,9,0,0,0,0,8,2,0,10
8748,132835,2023,USA,Japan,0,2,16,18,13/07/2023,26,2,105,133,4,1,0,5,0,3,7,10,0,0,0,0,11,4,2,17
8749,132835,2023,China,USA,0,2,3,5,02/07/2023,0,0,1,1,0,0,0,0,0,0,0,0,0,0,0,0,0,1,0,1
8750,132835,2023,Germany,USA,1,0,13,14,01/07/2023,10,0,43,53,0,0,0,0,1,1,2,4,0,0,0,0,6,1,1,8
8751,132835,2023,USA,Bulgaria,0,0,0,0,29/06/2023,0,0,0,0,0,0,0,0,0,0,0,0,0,0,0,0,0,0,0,0
8752,132835,2023,USA,Poland,2,2,19,23,28/06/2023,25,0,115,140,4,1,1,6,1,3,13,17,0,0,3,3,5,4,2,11
8753,132835,2023,Brazil,USA,2,1,15,18,18/06/2023,9,0,59,68,1,1,0,2,0,5,3,8,0,0,0,0,3,0,0,3
8754,132835,2023,Japan,USA,0,0,6,6,17/06/2023,1,1,15,17,0,0,0,0,0,0,0,0,0,1,1,2,1,0,0,1
8755,132835,2023,Thailand,USA,3,2,15,20,15/06/2023,20,0,63,83,2,0,2,4,0,1,3,4,0,0,1,1,12,4,2,18
8756,132835,2023,Croatia,USA,0,0,9,9,13/06/2023,10,1,54,65,2,0,0,2,1,2,3,6,0,0,0,0,8,2,0,10
8757,132835,2023,USA,Türkiye,1,1,22,24,04/06/2023,8,1,98,107,3,1,1,5,0,7,4,11,0,1,0,1,13,7,3,23
8758,132835,2023,USA,Korea,0,0,0,0,03/06/2023,0,0,0,0,0,0,0,0,0,0,0,0,0,0,0,0,0,0,0,0
8759,132835,2023,USA,Italy,0,2,10,12,02/06/2023,15,0,99,114,1,0,3,4,1,1,6,8,0,0,0,0,10,6,3,19
8760,132835,2023,Serbia,USA,0,0,13,13,31/05/2023,12,0,110,122,3,2,1,6,0,3,9,12,0,0,0,0,6,4,2,12
8761,135564,2023,Poland,USA,0,0,0,0,16/07/2023,0,0,13,13,0,0,0,0,0,0,0,0,2,2,10,14,12,8,2,22
8762,135564,2023,USA,Türkiye,0,0,0,0,16/07/2023,0,0,15,15,0,0,0,0,0,0,0,0,2,1,14,17,10,8,1,19
8763,135564,2023,USA,Japan,0,0,0,0,13/07/2023,0,0,12,12,0,0,0,0,0,0,0,0,4,0,10,14,17,3,1,21
8764,135564,2023,China,USA,0,0,0,0,02/07/2023,0,0,8,8,0,0,0,0,0,0,0,0,3,0,11,14,17,4,0,21
8765,135564,2023,Germany,USA,0,0,0,0,01/07/2023,0,0,19,19,0,0,0,0,0,0,0,0,3,1,5,9,17,7,1,25
8766,135564,2023,USA,Bulgaria,0,0,0,0,29/06/2023,0,0,0,0,0,0,0,0,0,0,0,0,0,0,0,0,0,0,0,0
8767,135564,2023,USA,Poland,0,0,0,0,28/06/2023,0,0,15,15,0,0,0,0,0,0,0,0,6,2,8,16,23,5,4,32
8768,135564,2023,USA,Türkiye,0,0,0,0,04/06/2023,0,0,20,20,0,0,0,0,0,0,0,0,4,1,13,18,12,7,3,22
8769,135564,2023,USA,Korea,0,0,0,0,03/06/2023,0,0,0,0,0,0,0,0,0,0,0,0,0,0,0,0,0,0,0,0
8770,135564,2023,USA,Italy,0,0,0,0,02/06/2023,0,0,0,0,0,0,0,0,0,0,0,0,0,0,0,0,0,0,0,0
8771,135564,2023,Serbia,USA,0,0,0,0,31/05/2023,0,1,8,9,0,0,0,0,0,0,0,0,4,0,7,11,11,6,3,20
8772,139848,2023,Poland,USA,1,0,2,3,16/07/2023,0,0,1,1,2,3,2,7,0,0,1,1,0,1,6,7,4,1,0,5
8773,139848,2023,USA,Türkiye,0,2,7,9,16/07/2023,0,0,0,0,12,3,12,27,0,2,1,3,4,0,19,23,6,0,2,8
8774,139848,2023,USA,Japan,0,0,6,6,13/07/2023,0,0,1,1,3,1,2,6,0,1,0,1,0,0,5,5,2,0,1,3
8775,139848,2023,China,USA,0,0,0,0,02/07/2023,0,0,0,0,0,0,0,0,0,0,0,0,1,0,6,7,0,1,0,1
8776,139848,2023,Germany,USA,1,1,18,20,01/07/2023,0,0,3,3,15,8,21,44,1,2,4,7,10,0,12,22,8,1,2,11
8777,139848,2023,USA,Bulgaria,0,0,0,0,29/06/2023,0,0,0,0,0,0,0,0,0,0,0,0,0,0,0,0,0,0,0,0
8778,139848,2023,USA,Poland,0,1,18,19,28/06/2023,0,0,2,2,12,2,11,25,0,5,3,8,8,1,24,33,10,2,2,14
8779,139848,2023,Brazil,USA,0,0,0,0,18/06/2023,0,0,0,0,0,0,0,0,0,0,0,0,0,0,0,0,0,0,0,0
8780,139848,2023,Japan,USA,0,0,0,0,17/06/2023,0,0,0,0,0,0,0,0,0,0,0,0,0,0,0,0,0,0,0,0
8781,139848,2023,Thailand,USA,0,0,0,0,15/06/2023,0,0,0,0,0,0,0,0,0,0,0,0,0,0,0,0,0,0,0,0
8782,139848,2023,Croatia,USA,1,1,16,18,13/06/2023,0,0,3,3,15,2,14,31,1,4,2,7,3,1,26,30,8,2,1,11
8783,152187,2023,Poland,USA,0,0,0,0,16/07/2023,0,0,3,3,0,0,0,0,0,0,0,0,1,0,2,3,4,0,0,4
8784,152187,2023,USA,Türkiye,0,0,0,0,16/07/2023,0,0,0,0,0,0,0,0,0,0,0,0,0,0,0,0,0,0,0,0
8785,152187,2023,USA,Japan,0,0,0,0,13/07/2023,0,0,0,0,0,0,0,0,0,0,0,0,0,0,0,0,0,0,0,0
8786,152187,2023,China,USA,0,0,0,0,02/07/2023,0,0,0,0,0,0,0,0,0,0,0,0,0,0,0,0,0,0,0,0
8787,152187,2023,Germany,USA,0,0,0,0,01/07/2023,0,0,0,0,0,0,0,0,0,0,0,0,0,0,0,0,0,0,0,0
8788,152187,2023,USA,Bulgaria,0,0,0,0,29/06/2023,0,0,10,10,0,0,0,0,0,0,0,0,1,0,3,4,3,4,2,9
8789,152187,2023,USA,Poland,0,0,0,0,28/06/2023,0,0,0,0,0,0,0,0,0,0,0,0,0,0,0,0,0,0,0,0
8790,152187,2023,Brazil,USA,0,0,0,0,18/06/2023,0,0,7,7,0,0,0,0,0,0,0,0,2,0,4,6,9,3,3,15
8791,152187,2023,Japan,USA,0,0,0,0,17/06/2023,0,0,0,0,0,0,0,0,0,0,0,0,0,0,0,0,0,0,0,0
8792,152187,2023,Thailand,USA,0,0,0,0,15/06/2023,0,0,17,17,0,0,0,0,0,0,0,0,2,0,10,12,7,2,0,9
8793,152187,2023,Croatia,USA,0,0,0,0,13/06/2023,0,0,0,0,0,0,0,0,0,0,0,0,0,0,0,0,0,0,0,0
8794,152187,2023,USA,Türkiye,0,0,0,0,04/06/2023,0,0,0,0,0,0,0,0,0,0,0,0,0,0,0,0,0,0,0,0
8795,152187,2023,USA,Korea,0,0,0,0,03/06/2023,0,1,3,4,0,0,0,0,0,0,0,0,0,0,5,5,9,5,2,16
8796,152187,2023,USA,Italy,0,0,0,0,02/06/2023,0,0,8,8,0,0,0,0,0,0,0,0,3,1,8,12,16,3,0,19
8797,152187,2023,Serbia,USA,0,0,0,0,31/05/2023,0,0,0,0,0,0,0,0,0,0,0,0,0,0,0,0,0,0,0,0
8798,132500,2023,Poland,USA,0,0,8,8,16/07/2023,17,0,74,91,2,0,1,3,1,4,7,12,0,0,0,0,7,2,0,9
8799,132500,2023,USA,Türkiye,0,0,0,0,16/07/2023,0,0,0,0,0,0,0,0,0,0,0,0,0,0,0,0,0,0,0,0
8800,132500,2023,USA,Japan,0,0,0,0,13/07/2023,0,0,0,0,0,0,0,0,0,0,0,0,0,0,0,0,0,0,0,0
8801,132500,2023,China,USA,0,0,15,15,02/07/2023,37,1,90,128,4,0,3,7,0,4,5,9,0,0,0,0,4,6,2,12
8802,132500,2023,Germany,USA,0,0,3,3,01/07/2023,10,2,44,56,2,0,0,2,0,1,1,2,0,1,0,1,10,2,0,12
8803,132500,2023,USA,Bulgaria,0,2,2,4,29/06/2023,12,2,37,51,1,1,1,3,2,3,2,7,0,0,1,1,10,2,0,12
8804,132500,2023,USA,Poland,0,0,0,0,28/06/2023,0,0,0,0,0,0,0,0,0,0,0,0,0,0,0,0,0,0,0,0
8805,155307,2023,Poland,USA,0,1,13,14,16/07/2023,0,0,0,0,9,4,11,24,1,2,1,4,0,0,0,0,3,0,0,3
8806,155307,2023,USA,Türkiye,0,3,10,13,16/07/2023,0,0,3,3,12,11,14,37,2,3,4,9,0,0,0,0,5,7,2,14
8807,155307,2023,USA,Japan,2,2,9,13,13/07/2023,0,0,2,2,11,7,13,31,0,6,10,16,0,0,0,0,6,3,1,10
8808,155307,2023,China,USA,0,3,5,8,02/07/2023,0,0,4,4,15,4,19,38,1,10,3,14,0,0,0,0,7,2,1,10
8809,155307,2023,Germany,USA,0,0,0,0,01/07/2023,0,0,0,0,0,0,0,0,0,0,0,0,0,0,0,0,0,0,0,0
8810,155307,2023,USA,Bulgaria,0,0,0,0,29/06/2023,0,0,0,0,0,0,0,0,0,0,0,0,0,0,0,0,0,0,0,0
8811,155307,2023,USA,Poland,1,1,12,14,28/06/2023,0,0,1,1,18,9,21,48,1,3,4,8,0,0,0,0,7,1,1,9
8812,155307,2023,USA,Türkiye,2,2,13,17,04/06/2023,0,0,3,3,17,6,20,43,0,3,8,11,0,0,0,0,7,8,3,18
8813,155307,2023,USA,Korea,0,0,0,0,03/06/2023,0,0,0,0,0,0,0,0,0,0,0,0,0,0,0,0,0,0,0,0
8814,155307,2023,USA,Italy,0,3,15,18,02/06/2023,0,0,0,0,12,5,18,35,0,3,3,6,0,0,0,0,10,7,1,18
8815,155307,2023,Serbia,USA,2,4,12,18,31/05/2023,0,0,2,2,22,6,15,43,1,3,2,6,0,0,0,0,14,7,3,24
8816,172978,2023,Poland,USA,0,2,4,6,16/07/2023,0,0,2,2,5,3,12,20,0,2,3,5,0,0,0,0,6,5,3,14
8817,172978,2023,USA,Türkiye,0,0,1,1,16/07/2023,0,0,0,0,0,1,0,1,1,0,0,1,0,0,0,0,0,0,0,0
8818,172978,2023,USA,Japan,0,1,0,1,13/07/2023,0,0,1,1,2,1,5,8,0,1,3,4,0,0,0,0,0,0,0,0
8819,172978,2023,China,USA,0,0,0,0,02/07/2023,0,0,0,0,0,0,0,0,0,0,0,0,0,0,0,0,0,0,0,0
8820,172978,2023,Germany,USA,2,0,15,17,01/07/2023,0,0,6,6,14,6,24,44,1,1,7,9,0,0,0,0,10,2,0,12
8821,172978,2023,USA,Bulgaria,1,1,7,9,29/06/2023,0,0,4,4,11,2,9,22,4,2,5,11,0,0,0,0,8,0,0,8
8822,172978,2023,USA,Poland,0,0,2,2,28/06/2023,0,0,0,0,5,3,6,14,0,0,2,2,0,0,1,1,0,0,0,0
8823,172978,2023,Brazil,USA,2,1,11,14,18/06/2023,0,0,2,2,13,4,8,25,0,1,0,1,0,0,0,0,6,2,0,8
8824,172978,2023,Japan,USA,0,0,1,1,17/06/2023,0,0,0,0,3,2,5,10,2,1,1,4,0,0,0,0,0,0,0,0
8825,172978,2023,Thailand,USA,0,1,9,10,15/06/2023,0,0,2,2,14,6,16,36,1,1,2,4,0,0,0,0,9,2,0,11
8826,172978,2023,Croatia,USA,1,0,11,12,13/06/2023,0,0,2,2,14,1,9,24,2,2,3,7,0,0,0,0,4,2,2,8
8827,140052,2023,Poland,USA,0,0,3,3,16/07/2023,0,0,0,0,0,0,2,2,1,1,0,2,0,0,0,0,1,0,0,1
8828,140052,2023,USA,Türkiye,0,0,6,6,16/07/2023,0,0,0,0,0,3,1,4,0,0,0,0,0,0,1,1,0,1,0,1
8829,140052,2023,USA,Japan,0,0,11,11,13/07/2023,0,0,1,1,6,0,6,12,1,4,6,11,0,0,1,1,3,2,2,7
8830,140052,2023,China,USA,0,3,13,16,02/07/2023,0,0,1,1,7,0,7,14,0,1,4,5,0,0,0,0,3,0,2,5
8831,140052,2023,Germany,USA,0,0,0,0,01/07/2023,0,0,0,0,0,0,0,0,0,0,0,0,0,0,0,0,0,0,0,0
8832,140052,2023,USA,Bulgaria,0,0,0,0,29/06/2023,0,0,0,0,0,0,0,0,0,0,0,0,0,0,0,0,0,0,0,0
8833,140052,2023,USA,Poland,1,1,15,17,28/06/2023,0,0,2,2,5,2,3,10,5,11,5,21,0,0,1,1,4,2,1,7
8834,140052,2023,Brazil,USA,0,0,10,10,18/06/2023,0,0,1,1,5,0,1,6,3,4,2,9,0,0,0,0,0,0,0,0
8835,140052,2023,Japan,USA,0,0,0,0,17/06/2023,0,0,0,0,0,0,0,0,0,0,0,0,0,0,0,0,0,0,0,0
8836,140052,2023,Thailand,USA,0,0,10,10,15/06/2023,0,0,0,0,7,3,2,12,3,4,3,10,0,0,0,0,0,0,0,0
8837,140052,2023,Croatia,USA,0,0,0,0,13/06/2023,0,0,0,0,0,0,0,0,0,0,0,0,0,0,0,0,0,0,0,0
8838,172977,2023,Poland,USA,0,2,5,7,16/07/2023,0,0,0,0,0,0,1,1,0,1,1,2,0,1,1,2,1,0,0,1
8839,172977,2023,USA,Türkiye,0,2,11,13,16/07/2023,0,0,2,2,0,0,6,6,2,0,3,5,0,0,1,1,1,0,0,1
8840,172977,2023,USA,Japan,0,1,10,11,13/07/2023,0,0,0,0,3,0,1,4,2,0,7,9,0,0,1,1,0,1,0,1
8841,172977,2023,China,USA,1,3,9,13,02/07/2023,0,0,3,3,7,1,4,12,2,3,7,12,0,0,3,3,1,1,1,3
8842,172977,2023,Germany,USA,0,0,1,1,01/07/2023,0,0,0,0,0,0,0,0,0,0,0,0,0,0,0,0,0,1,0,1
8843,172977,2023,USA,Bulgaria,0,0,0,0,29/06/2023,0,0,0,0,0,0,0,0,0,0,0,0,0,0,0,0,0,0,0,0
8844,172977,2023,USA,Poland,0,1,16,17,28/06/2023,0,0,3,3,10,0,7,17,3,3,9,15,1,0,4,5,5,2,1,8
8845,172977,2023,USA,Türkiye,0,2,12,14,04/06/2023,0,0,2,2,8,1,5,14,1,1,3,5,0,0,0,0,1,1,0,2
8846,172977,2023,USA,Korea,0,0,0,0,03/06/2023,0,0,0,0,0,0,0,0,0,0,0,0,0,0,0,0,0,0,0,0
8847,172977,2023,USA,Italy,1,1,16,18,02/06/2023,0,0,1,1,11,1,8,20,2,3,10,15,1,0,1,2,4,1,1,6
8848,172977,2023,Serbia,USA,0,1,4,5,31/05/2023,0,0,2,2,3,2,3,8,1,1,3,5,0,1,0,1,1,0,0,1
8849,141933,2023,Poland,USA,0,1,18,19,16/07/2023,0,0,3,3,6,4,18,28,0,3,3,6,8,1,12,21,7,2,0,9
8850,141933,2023,USA,Türkiye,0,0,5,5,16/07/2023,0,0,1,1,1,3,8,12,0,0,1,1,0,0,4,4,0,0,0,0
8851,141933,2023,USA,Japan,0,3,8,11,13/07/2023,0,0,5,5,10,4,28,42,1,0,2,3,6,0,17,23,14,0,2,16
8852,141933,2023,China,USA,0,2,17,19,02/07/2023,0,0,5,5,17,6,24,47,0,7,3,10,5,1,19,25,10,1,1,12
8853,141933,2023,Germany,USA,0,0,0,0,01/07/2023,0,0,0,0,0,0,0,0,0,0,0,0,0,0,1,1,1,0,0,1
8854,141933,2023,USA,Bulgaria,0,0,0,0,29/06/2023,0,0,0,0,0,0,0,0,0,0,0,0,0,0,0,0,0,0,0,0
8855,141933,2023,USA,Poland,0,0,16,16,28/06/2023,0,0,8,8,17,8,21,46,3,6,6,15,8,0,19,27,10,2,0,12
8856,166638,2023,Poland,USA,1,1,7,9,16/07/2023,0,0,2,2,4,0,2,6,4,6,8,18,0,0,0,0,0,1,0,1
8857,166638,2023,USA,Türkiye,1,2,4,7,16/07/2023,0,0,1,1,2,2,0,4,3,2,4,9,0,0,0,0,3,1,0,4
8858,166638,2023,USA,Japan,0,1,7,8,13/07/2023,0,0,1,1,8,1,2,11,1,2,7,10,0,0,0,0,2,2,0,4
8859,200701,2023,Poland,USA,1,1,11,13,16/07/2023,0,0,1,1,4,2,5,11,4,4,8,16,0,1,0,1,2,2,1,5
8860,200701,2023,USA,Türkiye,0,1,1,2,16/07/2023,0,0,0,0,0,0,1,1,3,2,3,8,0,0,0,0,0,0,0,0
8861,200701,2023,USA,Japan,0,0,0,0,13/07/2023,0,0,0,0,0,0,0,0,0,0,0,0,0,0,0,0,0,0,0,0
8862,200701,2023,Brazil,USA,0,1,9,10,18/06/2023,0,0,0,0,3,2,2,7,1,5,3,9,0,0,1,1,2,1,0,3
8863,200701,2023,Japan,USA,0,0,0,0,17/06/2023,0,0,0,0,0,0,0,0,0,0,0,0,0,0,0,0,0,0,0,0
8864,200701,2023,Thailand,USA,0,1,10,11,15/06/2023,0,0,0,0,8,0,4,12,5,2,7,14,0,0,2,2,3,0,0,3
8865,200701,2023,Croatia,USA,0,0,7,7,13/06/2023,0,0,1,1,3,0,1,4,2,3,6,11,0,0,0,0,1,1,0,2
8866,200701,2023,USA,Türkiye,0,1,9,10,04/06/2023,0,0,0,0,4,0,6,10,1,0,6,7,0,0,0,0,0,1,2,3
8867,200701,2023,USA,Korea,0,1,6,7,03/06/2023,0,0,2,2,4,1,4,9,1,3,1,5,0,0,0,0,1,0,0,1
8868,200701,2023,USA,Italy,1,3,19,23,02/06/2023,0,1,3,4,7,1,3,11,3,3,5,11,0,0,1,1,1,1,2,4
8869,200701,2023,Serbia,USA,0,1,10,11,31/05/2023,0,0,1,1,4,0,4,8,1,1,7,9,0,0,0,0,1,1,0,2
8870,192906,2023,Poland,USA,0,2,9,11,16/07/2023,0,0,2,2,15,2,12,29,3,1,3,7,1,0,26,27,5,1,0,6
8871,192906,2023,USA,Türkiye,0,0,2,2,16/07/2023,0,0,1,1,3,3,5,11,0,1,2,3,1,1,4,6,0,2,0,2
8872,192906,2023,USA,Japan,0,1,3,4,13/07/2023,0,0,0,0,9,0,6,15,2,2,2,6,2,1,10,13,4,1,0,5
8873,192906,2023,Brazil,USA,0,0,0,0,18/06/2023,0,0,0,0,0,0,0,0,0,0,0,0,0,0,0,0,0,0,0,0
8874,192906,2023,Japan,USA,1,2,14,17,17/06/2023,0,0,2,2,12,8,18,38,1,2,2,5,4,1,29,34,11,7,1,19
8875,192906,2023,Thailand,USA,0,0,8,8,15/06/2023,0,1,1,2,13,3,10,26,2,1,3,6,3,0,12,15,8,0,1,9
8876,192906,2023,Croatia,USA,0,0,0,0,13/06/2023,0,0,0,0,0,0,0,0,0,0,0,0,0,0,0,0,0,0,0,0
8877,192906,2023,USA,Türkiye,0,0,13,13,04/06/2023,0,0,3,3,16,4,14,34,0,3,3,6,7,4,25,36,9,4,2,15
8878,192906,2023,USA,Korea,1,3,16,20,03/06/2023,0,0,1,1,12,1,8,21,1,1,5,7,4,0,16,20,4,1,2,7
8879,192906,2023,USA,Italy,0,0,2,2,02/06/2023,0,0,0,0,0,1,3,4,0,0,0,0,0,0,3,3,1,0,0,1
8880,192906,2023,Serbia,USA,1,3,15,19,31/05/2023,0,0,1,1,17,4,11,32,1,4,2,7,5,1,29,35,10,6,0,16
8881,147590,2023,Poland,USA,0,1,1,2,16/07/2023,0,0,1,1,3,1,6,10,0,2,0,2,1,1,9,11,1,0,0,1
8882,147590,2023,USA,Türkiye,1,2,8,11,16/07/2023,0,0,3,3,16,5,16,37,1,0,1,2,6,0,33,39,13,3,0,16
8883,147590,2023,USA,Japan,0,2,7,9,13/07/2023,0,0,1,1,6,4,17,27,3,1,2,6,4,1,19,24,13,3,3,19
8884,147590,2023,Brazil,USA,0,0,8,8,18/06/2023,0,0,3,3,12,1,9,22,0,4,2,6,2,0,5,7,3,3,1,7
8885,147590,2023,Japan,USA,2,0,13,15,17/06/2023,0,0,3,3,15,3,15,33,3,8,2,13,6,0,23,29,16,2,1,19
8886,147590,2023,Thailand,USA,0,0,0,0,15/06/2023,0,0,0,0,0,0,0,0,0,0,0,0,0,0,0,0,0,0,0,0
8887,147590,2023,Croatia,USA,0,4,12,16,13/06/2023,0,0,5,5,12,4,16,32,1,2,4,7,2,2,18,22,9,1,0,10
8888,147590,2023,USA,Türkiye,0,2,13,15,04/06/2023,0,0,8,8,11,8,18,37,1,3,6,10,7,0,26,33,6,2,0,8
8889,147590,2023,USA,Korea,0,0,0,0,03/06/2023,0,0,0,0,0,0,0,0,0,0,0,0,0,0,0,0,0,0,0,0
8890,147590,2023,USA,Italy,1,2,12,15,02/06/2023,0,0,1,1,13,2,15,30,2,4,3,9,4,2,16,22,3,1,1,5
8891,147590,2023,Serbia,USA,2,2,15,19,31/05/2023,0,0,3,3,13,5,16,34,1,1,4,6,7,0,29,36,10,3,0,13
