,Player_ID,Year,TeamA,TeamB,Serve_Points,Serve_Errors,Serve_Attempts,Total_Serves,Match_Date,Set_Successes,Set_Errors,Set_Attempts,Total_Sets,Attack_Success,Attack Errors,Attack_Attempts,Total_Attacks,Block_Successful,Block_Errors,Block_Rebounds,Total_Blocks,Reception_Successful,Reception_Errors,Reception_Attemps,Total_Receptions,Dig_Success,Dig_Errors,Dig_Attempts,Total_Digs
0,142412,2021,Iran,Argentina,0,0,0,0,23/06/2021,2,0,2,4,0,0,0,0,0,0,0,0,0,0,0,0,1,0,0,1
1,142412,2021,France,Argentina,0,0,1,1,22/06/2021,2,0,5,7,0,0,0,0,0,0,0,0,0,0,0,0,0,0,0,0
2,142412,2021,Argentina,Serbia,1,1,11,13,17/06/2021,25,0,22,47,0,0,0,0,0,0,0,0,0,0,0,0,5,0,1,6
3,142412,2021,Argentina,Bulgaria,0,0,0,0,15/06/2021,2,0,6,8,0,0,0,0,0,0,0,0,0,0,0,0,1,0,0,1
4,142412,2021,Japan,Argentina,0,0,1,1,11/06/2021,7,0,6,13,0,0,0,0,0,0,0,0,0,0,0,0,0,0,0,0
5,142412,2021,Argentina,Australia,1,1,12,14,10/06/2021,34,0,39,73,2,0,0,2,0,1,0,1,0,0,0,0,3,4,0,7
6,142412,2021,Netherlands,Argentina,0,0,0,0,05/06/2021,0,0,0,0,0,0,0,0,0,0,0,0,0,0,0,0,0,0,0,0
7,117445,2021,Iran,Argentina,0,0,0,0,23/06/2021,0,0,0,0,2,0,0,2,1,0,0,1,0,0,0,0,0,0,0,0
8,117445,2021,France,Argentina,0,0,2,2,22/06/2021,0,0,0,0,2,0,1,3,0,0,0,0,0,0,0,0,0,1,0,1
9,117445,2021,Poland,Argentina,0,2,6,8,21/06/2021,0,0,1,1,10,3,3,16,0,1,0,1,0,0,0,0,2,1,2,5
10,117445,2021,Argentina,Serbia,0,1,1,2,17/06/2021,0,0,0,0,6,1,2,9,0,0,1,1,0,0,0,0,0,0,0,0
11,117445,2021,Argentina,Russia,1,2,3,6,16/06/2021,0,0,1,1,15,6,5,26,0,3,1,4,0,0,1,1,0,2,0,2
12,117445,2021,Argentina,Bulgaria,0,0,1,1,15/06/2021,0,0,0,0,2,0,0,2,0,0,0,0,0,0,0,0,2,1,0,3
13,117445,2021,Japan,Argentina,2,4,10,16,11/06/2021,0,0,2,2,18,6,12,36,2,3,6,11,0,0,0,0,5,0,0,5
14,117445,2021,Argentina,Australia,3,4,7,14,10/06/2021,0,0,1,1,12,4,5,21,0,3,0,3,0,0,0,0,2,1,0,3
15,117445,2021,Argentina,Italy,0,0,0,0,09/06/2021,0,0,0,0,1,0,2,3,0,1,0,1,0,0,0,0,0,0,0,0
16,117445,2021,Netherlands,Argentina,1,3,7,11,05/06/2021,0,0,2,2,8,6,9,23,6,2,2,10,0,0,0,0,2,5,0,7
17,117445,2021,Argentina,Slovenia,0,3,3,6,04/06/2021,0,0,2,2,4,7,9,20,0,1,1,2,0,0,0,0,1,0,2,3
18,117445,2021,Germany,Argentina,1,5,12,18,03/06/2021,0,0,0,0,20,4,9,33,1,2,1,4,0,0,0,0,6,1,0,7
19,117445,2021,USA,Argentina,0,3,8,11,30/05/2021,0,0,4,4,7,8,7,22,1,0,0,1,0,0,0,0,1,0,0,1
20,117445,2021,Argentina,Canada,1,1,5,7,29/05/2021,0,0,0,0,4,7,2,13,0,3,0,3,0,0,0,0,1,1,0,2
21,117445,2021,Brazil,Argentina,1,4,5,10,28/05/2021,0,1,0,1,14,4,7,25,1,2,1,4,0,0,0,0,3,1,0,4
22,142410,2021,Iran,Argentina,0,0,0,0,23/06/2021,0,0,0,0,0,0,0,0,0,0,0,0,0,0,0,0,0,0,0,0
23,142410,2021,France,Argentina,0,0,0,0,22/06/2021,0,0,0,0,0,0,0,0,0,0,0,0,0,0,0,0,0,0,0,0
24,142410,2021,Poland,Argentina,0,0,0,0,21/06/2021,0,0,0,0,0,0,0,0,0,0,0,0,0,0,0,0,0,0,0,0
25,142410,2021,Japan,Argentina,0,0,0,0,11/06/2021,0,0,0,0,0,0,0,0,0,0,0,0,0,0,0,0,0,0,0,0
26,142410,2021,Argentina,Australia,0,2,13,15,10/06/2021,0,0,1,1,8,2,7,17,1,3,2,6,9,0,9,18,5,0,0,5
27,142410,2021,Argentina,Italy,0,0,5,5,09/06/2021,0,0,0,0,5,3,8,16,0,0,0,0,5,2,6,13,2,0,0,2
28,142410,2021,Netherlands,Argentina,0,0,0,0,05/06/2021,0,0,0,0,0,0,0,0,0,0,0,0,0,0,0,0,0,0,0,0
29,142410,2021,Argentina,Slovenia,0,3,7,10,04/06/2021,0,0,4,4,7,1,9,17,0,1,0,1,5,0,14,19,9,1,0,10
30,142410,2021,Germany,Argentina,0,3,14,17,03/06/2021,0,0,0,0,18,2,12,32,1,4,0,5,6,1,16,23,10,0,0,10
31,142410,2021,USA,Argentina,0,1,12,13,30/05/2021,0,0,5,5,9,4,13,26,0,3,0,3,4,0,14,18,4,1,0,5
32,142410,2021,Argentina,Canada,0,0,0,0,29/05/2021,0,0,1,1,0,0,0,0,0,0,0,0,6,1,8,15,4,3,0,7
33,142410,2021,Brazil,Argentina,0,2,8,10,28/05/2021,0,0,0,0,4,1,8,13,0,0,0,0,4,0,8,12,4,1,0,5
34,119846,2021,Poland,Argentina,0,1,4,5,21/06/2021,16,0,26,42,0,0,0,0,1,0,1,2,0,0,0,0,1,1,0,2
35,119846,2021,Argentina,Russia,0,0,7,7,16/06/2021,14,0,35,49,2,0,1,3,0,0,1,1,0,0,0,0,6,1,1,8
36,119846,2021,Japan,Argentina,0,1,0,1,11/06/2021,0,0,0,0,0,0,0,0,0,0,0,0,0,0,0,0,0,0,0,0
37,119846,2021,Argentina,Australia,0,0,0,0,10/06/2021,0,0,0,0,0,0,0,0,0,0,0,0,0,0,0,0,0,0,0,0
38,119846,2021,Argentina,Italy,0,2,3,5,09/06/2021,16,0,38,54,0,0,3,3,0,0,1,1,0,0,1,1,0,1,0,1
39,119846,2021,Argentina,Slovenia,0,0,4,4,04/06/2021,15,0,24,39,0,0,1,1,2,0,3,5,0,0,0,0,2,0,1,3
40,119846,2021,Germany,Argentina,0,0,3,3,03/06/2021,2,1,4,7,0,0,0,0,0,0,0,0,0,0,0,0,1,1,0,2
41,119846,2021,USA,Argentina,0,0,2,2,30/05/2021,6,0,8,14,0,0,0,0,1,0,1,2,0,0,0,0,1,1,0,2
42,119846,2021,Argentina,Canada,0,1,4,5,29/05/2021,9,0,22,31,1,0,1,2,1,3,1,5,0,0,0,0,0,0,0,0
43,119846,2021,Brazil,Argentina,0,0,1,1,28/05/2021,0,0,0,0,0,0,0,0,0,0,0,0,0,0,0,0,0,0,0,0
44,119853,2021,Iran,Argentina,0,4,17,21,23/06/2021,0,0,1,1,10,5,14,29,2,3,3,8,3,1,16,20,8,0,1,9
45,119853,2021,France,Argentina,0,2,3,5,22/06/2021,0,0,2,2,1,1,4,6,0,0,0,0,2,2,12,16,4,1,0,5
46,119853,2021,Poland,Argentina,0,3,7,10,21/06/2021,0,0,1,1,7,0,8,15,0,0,3,3,3,3,7,13,3,3,1,7
47,119853,2021,Argentina,Serbia,0,0,0,0,17/06/2021,0,0,0,0,0,0,0,0,0,0,0,0,0,0,0,0,0,0,0,0
48,119853,2021,Argentina,Russia,0,3,8,11,16/06/2021,0,0,3,3,5,4,6,15,0,3,2,5,3,3,16,22,6,0,0,6
49,119853,2021,Argentina,Bulgaria,0,0,0,0,15/06/2021,0,0,0,0,0,0,0,0,0,0,0,0,0,0,0,0,0,0,0,0
50,119853,2021,Japan,Argentina,1,0,12,13,11/06/2021,0,0,8,8,12,2,11,25,1,2,5,8,11,1,11,23,10,1,1,12
51,119853,2021,Argentina,Australia,0,0,0,0,10/06/2021,0,0,0,0,0,0,0,0,0,0,0,0,0,0,0,0,0,0,0,0
52,119853,2021,Netherlands,Argentina,0,2,12,14,05/06/2021,0,0,1,1,6,1,2,9,0,3,0,3,5,2,7,14,3,1,0,4
53,119853,2021,Argentina,Slovenia,0,0,5,5,04/06/2021,0,0,0,0,4,2,6,12,0,2,3,5,1,1,9,11,5,2,0,7
54,119853,2021,Germany,Argentina,0,0,0,0,03/06/2021,0,0,0,0,0,0,0,0,0,0,0,0,0,0,0,0,0,0,0,0
55,118886,2021,Iran,Argentina,0,4,10,14,23/06/2021,0,0,2,2,9,5,4,18,2,2,2,6,8,2,24,34,8,2,0,10
56,118886,2021,France,Argentina,0,2,6,8,22/06/2021,0,0,1,1,4,2,4,10,3,2,0,5,4,0,12,16,2,1,2,5
57,118886,2021,Poland,Argentina,0,3,8,11,21/06/2021,0,0,0,0,4,2,10,16,0,3,1,4,7,2,16,25,8,2,0,10
58,118886,2021,Argentina,Serbia,0,2,8,10,17/06/2021,0,0,3,3,12,2,6,20,2,3,2,7,5,1,13,19,3,2,1,6
59,118886,2021,Argentina,Russia,0,4,10,14,16/06/2021,0,0,10,10,7,6,10,23,0,2,1,3,4,0,22,26,7,1,2,10
60,118886,2021,Argentina,Bulgaria,0,5,10,15,15/06/2021,0,0,3,3,12,1,8,21,0,3,3,6,3,2,10,15,9,3,0,12
61,118886,2021,Japan,Argentina,0,2,15,17,11/06/2021,0,0,4,4,9,6,17,32,3,4,0,7,7,0,17,24,8,7,1,16
62,118886,2021,Argentina,Australia,0,0,0,0,10/06/2021,0,0,0,0,0,0,0,0,0,0,0,0,0,0,0,0,0,0,0,0
63,118886,2021,Argentina,Italy,0,0,4,4,09/06/2021,0,0,1,1,0,4,6,10,1,0,0,1,3,2,7,12,2,1,0,3
64,118886,2021,Netherlands,Argentina,0,2,8,10,05/06/2021,0,0,1,1,12,1,12,25,2,2,1,5,9,1,13,23,5,1,0,6
65,118886,2021,Argentina,Slovenia,0,0,0,0,04/06/2021,0,0,0,0,0,0,0,0,0,0,0,0,0,0,0,0,0,0,0,0
66,118886,2021,Germany,Argentina,0,0,0,0,03/06/2021,0,0,0,0,0,0,0,0,0,0,0,0,0,0,0,0,0,0,0,0
67,118886,2021,USA,Argentina,1,4,9,14,30/05/2021,0,0,6,6,7,4,11,22,1,2,1,4,7,2,13,22,6,3,0,9
68,118886,2021,Argentina,Canada,0,4,7,11,29/05/2021,0,1,0,1,7,3,8,18,1,2,0,3,3,2,12,17,6,1,0,7
69,118886,2021,Brazil,Argentina,1,3,9,13,28/05/2021,0,0,0,0,9,7,4,20,3,2,0,5,7,6,15,28,4,1,0,5
70,152692,2021,Iran,Argentina,0,4,15,19,23/06/2021,0,0,0,0,10,1,2,13,2,3,3,8,0,1,2,3,1,2,1,4
71,152692,2021,France,Argentina,0,2,6,8,22/06/2021,0,0,1,1,8,1,3,12,0,6,3,9,0,0,0,0,3,0,0,3
72,152692,2021,Poland,Argentina,1,5,5,11,21/06/2021,0,0,2,2,4,0,4,8,0,7,7,14,0,0,0,0,0,0,1,1
73,152692,2021,Argentina,Serbia,1,2,14,17,17/06/2021,0,0,0,0,8,1,5,14,3,3,2,8,0,0,1,1,3,2,0,5
74,152692,2021,Argentina,Russia,1,2,12,15,16/06/2021,0,0,0,0,7,1,5,13,2,3,3,8,0,0,0,0,4,1,1,6
75,152692,2021,Argentina,Bulgaria,2,5,10,17,15/06/2021,0,0,0,0,7,0,0,7,1,5,5,11,0,0,2,2,2,1,0,3
76,152692,2021,Japan,Argentina,2,2,14,18,11/06/2021,0,0,2,2,9,0,3,12,1,5,2,8,0,0,3,3,2,0,1,3
77,152692,2021,Argentina,Australia,0,3,8,11,10/06/2021,0,0,2,2,13,1,5,19,1,3,1,5,0,0,0,0,5,0,0,5
78,152692,2021,Argentina,Italy,1,3,5,9,09/06/2021,0,0,0,0,3,0,1,4,4,0,2,6,0,1,2,3,0,1,0,1
79,152692,2021,Netherlands,Argentina,1,2,9,12,05/06/2021,0,0,0,0,8,1,1,10,1,3,2,6,1,0,0,1,0,1,0,1
80,152692,2021,Argentina,Slovenia,0,0,0,0,04/06/2021,0,0,0,0,0,0,0,0,0,0,0,0,0,0,0,0,0,0,0,0
81,152692,2021,Germany,Argentina,0,5,11,16,03/06/2021,0,0,1,1,9,2,3,14,1,8,3,12,1,0,0,1,4,0,0,4
82,153053,2021,Iran,Argentina,0,0,0,0,23/06/2021,0,0,6,6,0,0,0,0,0,0,0,0,10,1,15,26,6,5,2,13
83,153053,2021,France,Argentina,0,0,0,0,22/06/2021,0,0,6,6,0,0,0,0,0,0,0,0,1,1,6,8,7,4,2,13
84,153053,2021,Poland,Argentina,0,0,0,0,21/06/2021,0,0,1,1,0,0,0,0,0,0,0,0,2,2,13,17,4,4,1,9
85,153053,2021,Argentina,Serbia,0,0,0,0,17/06/2021,0,0,4,4,0,0,0,0,0,0,0,0,6,1,8,15,7,1,1,9
86,153053,2021,Argentina,Russia,0,0,0,0,16/06/2021,0,0,3,3,0,0,0,0,0,0,0,0,5,0,12,17,13,2,1,16
87,153053,2021,Argentina,Bulgaria,0,0,0,0,15/06/2021,0,0,5,5,0,0,0,0,0,0,0,0,8,0,14,22,9,1,1,11
88,153053,2021,Argentina,Italy,0,0,0,0,09/06/2021,0,0,4,4,0,0,0,0,0,0,0,0,4,0,7,11,7,6,1,14
89,136737,2021,Poland,Argentina,0,0,0,0,21/06/2021,0,0,0,0,0,0,0,0,0,0,0,0,0,0,0,0,0,0,0,0
90,136737,2021,Argentina,Serbia,0,0,0,0,17/06/2021,0,0,0,0,0,0,0,0,0,0,0,0,0,0,0,0,0,0,0,0
91,136737,2021,Argentina,Russia,0,0,0,0,16/06/2021,0,0,0,0,0,0,0,0,0,0,0,0,0,0,0,0,0,0,0,0
92,136737,2021,Argentina,Bulgaria,0,1,4,5,15/06/2021,0,0,0,0,5,4,2,11,1,2,0,3,1,1,6,8,3,1,0,4
93,136737,2021,Argentina,Italy,0,0,6,6,09/06/2021,0,0,0,0,4,4,9,17,2,0,0,2,2,0,5,7,1,1,0,2
94,133730,2021,Argentina,Russia,1,1,17,19,16/06/2021,0,0,2,2,5,0,7,12,3,2,8,13,0,0,0,0,5,0,0,5
95,133730,2021,Argentina,Bulgaria,0,2,12,14,15/06/2021,0,0,1,1,6,1,5,12,1,5,7,13,1,0,0,1,1,0,0,1
96,133730,2021,Japan,Argentina,0,2,17,19,11/06/2021,0,0,0,0,11,1,5,17,1,4,13,18,2,0,1,3,6,2,0,8
97,133730,2021,Argentina,Australia,0,0,0,0,10/06/2021,0,0,0,0,0,0,0,0,0,0,0,0,0,0,0,0,0,0,0,0
98,133730,2021,Argentina,Italy,0,2,15,17,09/06/2021,0,0,1,1,6,1,7,14,2,3,3,8,0,0,1,1,2,0,0,2
99,133730,2021,Netherlands,Argentina,0,0,10,10,05/06/2021,1,0,0,1,8,0,2,10,1,2,1,4,0,0,0,0,1,1,0,2
100,133730,2021,Argentina,Slovenia,0,0,0,0,04/06/2021,0,0,0,0,0,0,0,0,0,0,0,0,0,0,0,0,0,0,0,0
101,133730,2021,Germany,Argentina,0,5,12,17,03/06/2021,0,0,0,0,11,1,2,14,2,7,4,13,2,0,0,2,5,1,0,6
102,133730,2021,USA,Argentina,0,1,9,10,30/05/2021,0,0,0,0,3,0,2,5,2,2,2,6,1,0,1,2,0,0,0,0
103,133730,2021,Argentina,Canada,0,1,8,9,29/05/2021,0,0,0,0,4,2,4,10,1,1,2,4,1,0,1,2,2,0,0,2
104,133730,2021,Brazil,Argentina,0,2,8,10,28/05/2021,0,0,0,0,5,0,5,10,2,9,2,13,0,0,2,2,2,0,0,2
105,142415,2021,Iran,Argentina,1,6,9,16,23/06/2021,0,0,1,1,23,3,9,35,0,8,2,10,0,0,1,1,6,1,1,8
106,142415,2021,France,Argentina,0,3,8,11,22/06/2021,0,0,1,1,10,4,5,19,1,2,1,4,0,0,0,0,3,0,0,3
107,142415,2021,Poland,Argentina,0,1,4,5,21/06/2021,0,0,0,0,4,1,3,8,0,1,0,1,0,0,0,0,1,1,0,2
108,142415,2021,Argentina,Serbia,0,1,3,4,17/06/2021,0,0,0,0,9,4,4,17,1,3,4,8,0,0,0,0,0,1,0,1
109,142415,2021,Argentina,Russia,0,3,3,6,16/06/2021,0,0,1,1,6,5,4,15,0,0,1,1,0,0,0,0,2,1,1,4
110,142415,2021,Argentina,Bulgaria,2,3,10,15,15/06/2021,0,0,1,1,14,6,4,24,0,5,3,8,0,0,0,0,2,2,1,5
111,142415,2021,Argentina,Italy,0,5,6,11,09/06/2021,0,0,0,0,10,8,4,22,0,0,3,3,1,0,0,1,4,2,0,6
112,125048,2021,Iran,Argentina,0,0,0,0,23/06/2021,0,0,0,0,0,0,0,0,0,0,0,0,0,0,0,0,0,0,0,0
113,125048,2021,France,Argentina,0,3,2,5,22/06/2021,0,0,1,1,4,1,4,9,2,0,1,3,3,1,4,8,0,1,0,1
114,125048,2021,Poland,Argentina,0,0,0,0,21/06/2021,0,0,0,0,0,0,0,0,0,0,0,0,0,0,0,0,0,0,0,0
115,125048,2021,Argentina,Serbia,1,5,6,12,17/06/2021,0,1,2,3,4,2,3,9,0,2,0,2,9,0,12,21,5,0,1,6
116,125048,2021,Argentina,Russia,0,1,1,2,16/06/2021,0,0,0,0,1,2,3,6,0,0,0,0,2,0,5,7,2,0,0,2
117,125048,2021,Argentina,Bulgaria,2,1,8,11,15/06/2021,0,0,0,0,7,1,5,13,0,0,3,3,7,1,9,17,3,2,0,5
118,125048,2021,Japan,Argentina,0,0,0,0,11/06/2021,0,0,0,0,0,0,0,0,0,0,0,0,0,0,0,0,0,0,0,0
119,125048,2021,Argentina,Australia,0,0,0,0,10/06/2021,0,0,0,0,0,0,0,0,0,0,0,0,0,0,0,0,0,0,0,0
120,125048,2021,Netherlands,Argentina,0,0,0,0,05/06/2021,0,0,0,0,0,0,0,0,0,0,0,0,0,0,1,1,0,1,0,1
121,125048,2021,Argentina,Slovenia,0,0,0,0,04/06/2021,0,0,0,0,0,0,0,0,0,0,0,0,0,0,0,0,0,0,0,0
122,125048,2021,Germany,Argentina,0,0,0,0,03/06/2021,0,0,0,0,0,2,1,3,0,0,0,0,0,0,0,0,1,0,0,1
123,119851,2021,Netherlands,Argentina,0,0,0,0,05/06/2021,0,0,0,0,0,0,0,0,0,0,0,0,0,0,0,0,0,0,0,0
124,119851,2021,Argentina,Slovenia,0,1,11,12,04/06/2021,0,0,1,1,6,1,2,9,2,2,2,6,0,0,1,1,3,1,1,5
125,119851,2021,Germany,Argentina,0,0,0,0,03/06/2021,0,0,0,0,0,0,0,0,0,0,0,0,0,0,0,0,0,0,0,0
126,117457,2021,Iran,Argentina,1,2,14,17,23/06/2021,40,1,57,98,1,0,0,1,2,2,0,4,0,0,1,1,2,1,0,3
127,117457,2021,France,Argentina,0,0,10,10,22/06/2021,23,1,32,56,0,0,0,0,0,2,1,3,0,0,1,1,4,0,0,4
128,117457,2021,Poland,Argentina,0,0,2,2,21/06/2021,10,0,16,26,0,0,0,0,0,0,0,0,0,0,0,0,0,0,0,0
129,117457,2021,Argentina,Serbia,0,1,5,6,17/06/2021,11,0,13,24,0,0,0,0,0,0,0,0,0,0,0,0,1,0,1,2
130,117457,2021,Argentina,Russia,1,0,6,7,16/06/2021,11,1,30,42,0,0,1,1,0,2,1,3,0,1,0,1,5,0,0,5
131,117457,2021,Argentina,Bulgaria,0,2,10,12,15/06/2021,20,0,56,76,1,0,1,2,0,1,3,4,0,0,0,0,4,3,1,8
132,117457,2021,Japan,Argentina,1,3,13,17,11/06/2021,41,0,52,93,1,0,1,2,1,2,1,4,0,0,0,0,10,4,2,16
133,117457,2021,Argentina,Australia,0,0,0,0,10/06/2021,0,0,0,0,0,0,0,0,0,0,0,0,0,0,0,0,0,0,0,0
134,117457,2021,Argentina,Italy,0,0,5,5,09/06/2021,7,0,32,39,0,0,0,0,0,1,0,1,0,0,0,0,1,0,0,1
135,117457,2021,Netherlands,Argentina,0,0,17,17,05/06/2021,24,0,49,73,1,0,3,4,0,0,1,1,0,1,0,1,1,2,0,3
136,117457,2021,Argentina,Slovenia,0,1,6,7,04/06/2021,11,0,23,34,0,0,0,0,0,0,2,2,0,0,1,1,1,1,2,4
137,117457,2021,Germany,Argentina,1,4,11,16,03/06/2021,35,1,82,118,3,1,2,6,0,2,4,6,0,0,0,0,6,3,0,9
138,117457,2021,USA,Argentina,0,3,8,11,30/05/2021,22,0,43,65,1,0,3,4,0,1,1,2,0,0,2,2,2,0,1,3
139,117457,2021,Argentina,Canada,0,2,2,4,29/05/2021,9,0,28,37,0,0,2,2,0,0,0,0,0,0,0,0,0,1,0,1
140,117457,2021,Brazil,Argentina,0,2,13,15,28/05/2021,22,1,51,74,0,0,1,1,3,1,0,4,0,0,0,0,0,2,0,2
141,162546,2021,Iran,Argentina,0,0,0,0,23/06/2021,0,0,0,0,0,0,0,0,0,0,0,0,0,0,0,0,0,0,0,0
142,162546,2021,France,Argentina,0,0,0,0,22/06/2021,0,0,0,0,0,0,0,0,0,0,0,0,0,0,0,0,0,0,0,0
143,162546,2021,Argentina,Serbia,0,0,0,0,17/06/2021,0,0,0,0,0,0,0,0,0,0,0,0,0,0,0,0,0,0,0,0
144,162546,2021,Japan,Argentina,0,0,2,2,11/06/2021,0,0,0,0,1,1,1,3,0,1,0,1,0,0,0,0,0,0,0,0
145,162546,2021,Argentina,Australia,0,0,0,0,10/06/2021,0,0,0,0,0,0,0,0,0,0,0,0,0,0,0,0,0,0,0,0
146,162546,2021,Argentina,Italy,0,0,0,0,09/06/2021,0,0,0,0,0,0,0,0,0,0,0,0,0,0,0,0,0,0,0,0
147,162546,2021,Netherlands,Argentina,0,0,0,0,05/06/2021,0,0,0,0,0,0,0,0,0,0,0,0,0,0,0,0,0,0,0,0
148,162546,2021,Argentina,Slovenia,0,1,4,5,04/06/2021,0,0,1,1,4,2,4,10,0,1,0,1,0,0,0,0,4,2,0,6
149,162546,2021,Germany,Argentina,0,1,1,2,03/06/2021,0,0,0,0,1,0,2,3,0,0,0,0,0,0,0,0,0,0,0,0
150,162546,2021,USA,Argentina,0,1,6,7,30/05/2021,0,0,0,0,5,4,4,13,1,0,0,1,0,0,0,0,1,1,0,2
151,162546,2021,Argentina,Canada,0,2,1,3,29/05/2021,0,0,0,0,2,1,4,7,0,0,0,0,0,0,0,0,1,2,0,3
152,162546,2021,Brazil,Argentina,0,0,1,1,28/05/2021,0,0,0,0,1,0,1,2,0,0,0,0,0,1,2,3,1,2,0,3
153,125049,2021,Iran,Argentina,0,0,0,0,23/06/2021,0,0,0,0,0,0,0,0,0,0,0,0,0,0,0,0,0,0,0,0
154,125049,2021,France,Argentina,0,2,6,8,22/06/2021,0,0,2,2,5,1,3,9,1,2,0,3,2,2,7,11,2,0,1,3
155,125049,2021,Poland,Argentina,0,0,0,0,21/06/2021,0,0,0,0,0,0,0,0,0,0,0,0,0,0,0,0,0,0,0,0
156,125049,2021,Argentina,Serbia,0,0,0,0,17/06/2021,0,0,0,0,0,0,0,0,0,0,0,0,0,0,0,0,0,0,0,0
157,125049,2021,Argentina,Russia,0,0,0,0,16/06/2021,0,0,0,0,0,1,2,3,0,0,0,0,0,1,0,1,0,0,0,0
158,125049,2021,Argentina,Bulgaria,0,0,0,0,15/06/2021,0,0,0,0,0,0,0,0,0,0,0,0,0,0,1,1,0,0,0,0
159,125049,2021,Japan,Argentina,0,0,0,0,11/06/2021,0,0,0,0,0,0,0,0,0,0,0,0,0,0,0,0,0,0,0,0
160,125049,2021,Argentina,Australia,0,0,10,10,10/06/2021,0,0,2,2,9,2,2,13,0,2,0,2,9,1,10,20,3,1,0,4
161,125049,2021,Argentina,Italy,0,2,5,7,09/06/2021,0,0,2,2,8,1,4,13,0,1,1,2,3,1,10,14,1,3,0,4
162,125049,2021,Netherlands,Argentina,0,0,0,0,05/06/2021,0,0,0,0,0,0,0,0,0,0,0,0,0,0,0,0,0,0,0,0
163,125049,2021,Argentina,Slovenia,0,1,2,3,04/06/2021,0,0,1,1,2,1,6,9,2,2,1,5,3,1,11,15,2,0,0,2
164,125049,2021,Germany,Argentina,0,3,13,16,03/06/2021,0,0,4,4,8,5,17,30,3,1,2,6,11,2,20,33,6,4,3,13
165,125049,2021,USA,Argentina,0,0,0,0,30/05/2021,0,0,3,3,0,0,0,0,0,0,0,0,4,3,20,27,12,5,1,18
166,125049,2021,Argentina,Canada,0,3,5,8,29/05/2021,0,0,0,0,6,6,3,15,1,0,0,1,4,1,18,23,3,3,1,7
167,125049,2021,Brazil,Argentina,0,0,0,0,28/05/2021,0,0,1,1,0,0,0,0,0,0,0,0,8,0,19,27,6,2,0,8
168,125047,2021,Iran,Argentina,1,3,21,25,23/06/2021,0,0,1,1,10,1,3,14,3,6,1,10,0,0,1,1,3,0,1,4
169,125047,2021,France,Argentina,0,2,9,11,22/06/2021,0,0,0,0,3,2,2,7,0,2,3,5,0,0,1,1,1,0,0,1
170,125047,2021,Poland,Argentina,0,2,9,11,21/06/2021,0,0,0,0,8,0,2,10,0,5,5,10,1,0,2,3,3,3,2,8
171,125047,2021,Argentina,Serbia,0,1,12,13,17/06/2021,0,0,1,1,6,3,2,11,2,7,2,11,1,0,0,1,0,0,1,1
172,125047,2021,Argentina,Russia,0,0,0,0,16/06/2021,0,0,0,0,0,0,0,0,0,0,0,0,0,0,0,0,0,0,0,0
173,125047,2021,Argentina,Bulgaria,0,0,0,0,15/06/2021,0,0,0,0,0,0,0,0,0,0,0,0,0,0,0,0,0,0,0,0
174,125047,2021,Japan,Argentina,0,0,0,0,11/06/2021,0,0,0,0,0,0,0,0,0,0,0,0,0,0,0,0,0,0,0,0
175,125047,2021,Argentina,Australia,1,2,6,9,10/06/2021,0,0,0,0,5,0,6,11,4,4,0,8,1,0,0,1,2,0,0,2
176,125047,2021,Argentina,Italy,0,0,1,1,09/06/2021,0,0,0,0,1,1,1,3,0,2,0,2,0,0,1,1,1,0,0,1
177,125047,2021,Netherlands,Argentina,0,0,0,0,05/06/2021,0,0,0,0,0,0,0,0,0,0,0,0,0,0,0,0,0,0,0,0
178,125047,2021,Argentina,Slovenia,0,1,7,8,04/06/2021,0,1,1,2,5,1,3,9,1,4,5,10,1,0,0,1,3,1,3,7
179,125047,2021,Germany,Argentina,0,0,0,0,03/06/2021,0,0,0,0,0,0,0,0,0,0,0,0,0,0,0,0,0,0,0,0
180,125047,2021,USA,Argentina,0,2,11,13,30/05/2021,0,0,0,0,4,1,2,7,3,5,1,9,0,1,0,1,1,1,0,2
181,125047,2021,Argentina,Canada,1,2,6,9,29/05/2021,0,0,0,0,3,0,1,4,1,5,0,6,3,0,0,3,2,1,0,3
182,125047,2021,Brazil,Argentina,1,2,7,10,28/05/2021,0,0,0,0,5,1,1,7,4,2,0,6,0,0,0,0,2,0,0,2
183,135349,2021,Iran,Argentina,0,0,0,0,23/06/2021,0,0,0,0,0,0,0,0,0,0,0,0,0,0,0,0,0,0,0,0
184,135349,2021,France,Argentina,0,0,0,0,22/06/2021,0,0,0,0,0,0,0,0,0,0,0,0,0,0,0,0,0,0,0,0
185,135349,2021,Poland,Argentina,0,0,0,0,21/06/2021,0,0,0,0,0,0,0,0,0,0,0,0,0,0,0,0,0,0,0,0
186,135349,2021,Argentina,Serbia,0,0,0,0,17/06/2021,0,0,0,0,0,0,0,0,0,0,0,0,0,0,0,0,0,0,0,0
187,135349,2021,Argentina,Russia,0,0,0,0,16/06/2021,0,0,0,0,0,0,0,0,0,0,0,0,0,0,0,0,0,0,0,0
188,135349,2021,Argentina,Bulgaria,0,0,0,0,15/06/2021,0,0,0,0,0,0,0,0,0,0,0,0,0,0,0,0,0,0,0,0
189,135349,2021,Japan,Argentina,0,0,0,0,11/06/2021,0,0,1,1,0,0,0,0,0,0,0,0,9,0,11,20,13,5,2,20
190,135349,2021,Argentina,Australia,0,0,0,0,10/06/2021,0,0,3,3,0,0,0,0,0,0,0,0,5,0,5,10,5,3,1,9
191,135349,2021,Argentina,Italy,0,0,0,0,09/06/2021,0,0,0,0,0,0,0,0,0,0,0,0,0,0,0,0,0,0,0,0
192,135349,2021,Netherlands,Argentina,0,0,0,0,05/06/2021,0,0,3,3,0,0,0,0,0,0,0,0,2,2,8,12,9,3,1,13
193,135349,2021,Argentina,Slovenia,0,0,0,0,04/06/2021,0,0,3,3,0,0,0,0,0,0,0,0,2,2,6,10,4,4,2,10
194,135349,2021,Germany,Argentina,0,0,0,0,03/06/2021,0,0,2,2,0,0,0,0,0,0,0,0,13,1,14,28,12,2,2,16
195,144457,2021,Australia,Netherlands,0,1,3,4,23/06/2021,0,0,0,0,0,3,1,4,0,1,0,1,0,0,0,0,1,0,0,1
196,144457,2021,Canada,Australia,0,1,2,3,22/06/2021,0,1,2,3,3,2,7,12,0,2,1,3,0,0,0,0,2,1,2,5
197,144457,2021,Australia,Serbia,0,2,11,13,21/06/2021,0,0,2,2,7,9,7,23,0,4,2,6,0,0,0,0,1,2,0,3
198,144457,2021,Australia,Brazil,0,1,7,8,17/06/2021,0,0,0,0,10,4,11,25,0,4,1,5,0,0,0,0,2,1,0,3
199,144457,2021,Slovenia,Australia,0,2,9,11,16/06/2021,0,0,1,1,7,2,10,19,1,3,1,5,0,0,0,0,1,2,0,3
200,144457,2021,Iran,Australia,3,2,22,27,15/06/2021,0,0,2,2,12,4,9,25,0,2,1,3,1,0,1,2,2,5,0,7
201,144457,2021,Australia,Italy,0,0,6,6,11/06/2021,0,0,0,0,5,5,3,13,0,1,2,3,0,0,0,0,2,2,0,4
202,144457,2021,Argentina,Australia,0,0,6,6,10/06/2021,0,0,0,0,6,0,4,10,0,1,0,1,0,0,1,1,1,1,0,2
203,144457,2021,Japan,Australia,0,0,9,9,09/06/2021,0,0,2,2,5,2,3,10,0,2,3,5,0,0,0,0,1,5,0,6
204,144457,2021,USA,Australia,0,4,3,7,05/06/2021,0,0,2,2,7,6,9,22,0,2,1,3,0,0,0,0,4,0,0,4
205,144457,2021,Russia,Australia,0,2,9,11,04/06/2021,0,0,0,0,6,8,11,25,0,1,0,1,0,0,0,0,1,1,0,2
206,144457,2021,Australia,Poland,0,1,3,4,03/06/2021,0,0,1,1,2,3,3,8,0,0,0,0,0,1,0,1,1,4,0,5
207,144457,2021,Australia,France,0,5,12,17,30/05/2021,0,1,0,1,13,5,8,26,1,2,2,5,0,0,0,0,4,2,1,7
208,144457,2021,Australia,Bulgaria,0,2,4,6,29/05/2021,0,0,0,0,6,6,4,16,0,1,0,1,0,2,1,3,1,2,1,4
209,144457,2021,Germany,Australia,0,2,8,10,28/05/2021,0,0,0,0,7,1,4,12,0,2,2,4,0,0,0,0,0,1,0,1
210,144456,2021,Australia,Netherlands,0,0,9,9,23/06/2021,13,0,41,54,2,1,1,4,2,0,1,3,0,0,0,0,3,3,0,6
211,144456,2021,Canada,Australia,0,1,5,6,22/06/2021,9,1,39,49,1,1,1,3,0,2,0,2,0,0,0,0,3,1,2,6
212,144456,2021,Australia,Serbia,1,0,12,13,21/06/2021,18,0,59,77,2,0,1,3,1,4,1,6,0,0,0,0,10,3,0,13
213,144456,2021,Australia,Brazil,0,1,7,8,17/06/2021,7,0,50,57,2,0,3,5,0,2,1,3,0,0,0,0,5,3,1,9
214,144456,2021,Slovenia,Australia,3,4,12,19,16/06/2021,23,0,48,71,1,0,2,3,1,3,1,5,0,0,0,0,6,3,1,10
215,144456,2021,Iran,Australia,1,3,14,18,15/06/2021,17,1,82,100,1,1,3,5,1,3,1,5,0,0,0,0,4,5,0,9
216,144456,2021,Australia,Italy,0,4,6,10,11/06/2021,13,1,47,61,3,0,1,4,1,1,5,7,0,0,0,0,2,1,1,4
217,144456,2021,Argentina,Australia,1,1,7,9,10/06/2021,11,1,46,58,0,0,3,3,2,0,0,2,0,0,1,1,4,8,1,13
218,144456,2021,Japan,Australia,0,2,11,13,09/06/2021,26,1,75,102,2,1,4,7,2,4,2,8,0,0,1,1,9,5,1,15
219,144456,2021,USA,Australia,0,2,6,8,05/06/2021,14,1,51,66,2,0,3,5,0,2,0,2,0,0,0,0,4,4,3,11
220,144456,2021,Russia,Australia,1,3,8,12,04/06/2021,13,0,52,65,2,1,2,5,1,3,1,5,0,0,1,1,2,2,1,5
221,144456,2021,Australia,Poland,0,2,3,5,03/06/2021,8,1,40,49,0,0,2,2,0,0,1,1,0,0,1,1,0,0,0,0
222,144456,2021,Australia,France,1,2,9,12,30/05/2021,31,1,67,99,2,0,5,7,1,2,0,3,0,0,1,1,5,2,2,9
223,144456,2021,Australia,Bulgaria,0,0,9,9,29/05/2021,10,1,53,64,3,2,1,6,0,1,0,1,0,0,0,0,3,2,2,7
224,144456,2021,Germany,Australia,0,5,2,7,28/05/2021,12,3,36,51,2,0,1,3,1,2,0,3,0,0,0,0,3,1,0,4
225,162262,2021,Australia,Netherlands,0,0,0,0,23/06/2021,0,0,0,0,0,0,0,0,0,0,0,0,0,0,0,0,0,0,0,0
226,162262,2021,Canada,Australia,0,0,0,0,22/06/2021,0,0,0,0,0,0,0,0,0,0,0,0,0,0,0,0,0,0,0,0
227,162262,2021,Australia,Serbia,0,0,0,0,21/06/2021,0,0,0,0,0,0,0,0,0,0,0,0,0,0,0,0,0,0,0,0
228,162262,2021,Australia,Italy,0,0,0,0,11/06/2021,0,0,0,0,0,0,0,0,0,0,0,0,0,0,0,0,0,0,0,0
229,162262,2021,Argentina,Australia,0,0,3,3,10/06/2021,0,0,0,0,0,0,0,0,0,1,0,1,0,0,0,0,0,0,0,0
230,162262,2021,Australia,France,0,0,0,0,30/05/2021,0,0,0,0,0,0,0,0,0,0,0,0,0,0,0,0,0,0,0,0
231,162262,2021,Australia,Bulgaria,0,0,0,0,29/05/2021,0,0,0,0,0,0,0,0,0,0,0,0,0,0,0,0,0,0,0,0
232,162077,2021,Australia,Netherlands,0,0,0,0,23/06/2021,0,0,0,0,0,0,0,0,0,0,0,0,0,0,0,0,0,0,0,0
233,162077,2021,Canada,Australia,0,2,6,8,22/06/2021,0,0,2,2,1,1,5,7,0,2,1,3,0,0,0,0,1,0,1,2
234,162077,2021,Australia,Serbia,1,1,9,11,21/06/2021,0,0,1,1,6,4,3,13,3,1,0,4,0,0,0,0,1,1,0,2
235,162077,2021,Australia,Brazil,0,2,1,3,17/06/2021,0,0,0,0,1,0,0,1,0,0,0,0,0,0,0,0,0,0,0,0
236,162077,2021,Slovenia,Australia,0,0,1,1,16/06/2021,0,0,0,0,0,0,0,0,0,0,0,0,0,0,0,0,0,0,0,0
237,162077,2021,Iran,Australia,0,0,1,1,15/06/2021,0,0,0,0,0,0,0,0,0,0,0,0,0,0,0,0,0,0,0,0
238,162077,2021,Australia,Italy,0,0,0,0,11/06/2021,0,0,0,0,0,0,0,0,0,0,0,0,0,0,0,0,0,0,0,0
239,162077,2021,Argentina,Australia,0,2,4,6,10/06/2021,0,0,2,2,3,3,2,8,0,1,1,2,0,0,0,0,1,3,0,4
240,162077,2021,Japan,Australia,0,0,1,1,09/06/2021,0,0,0,0,0,0,0,0,0,0,0,0,0,0,0,0,0,0,0,0
241,162077,2021,USA,Australia,0,0,2,2,05/06/2021,0,0,0,0,0,0,0,0,0,0,0,0,0,0,0,0,0,0,0,0
242,162077,2021,Russia,Australia,0,0,0,0,04/06/2021,0,0,0,0,0,0,0,0,0,0,0,0,0,0,0,0,0,0,0,0
243,162077,2021,Australia,Poland,1,1,3,5,03/06/2021,0,0,0,0,1,2,2,5,0,3,0,3,0,0,0,0,0,1,0,1
244,162077,2021,Australia,France,2,1,3,6,30/05/2021,0,0,0,0,2,1,2,5,0,4,1,5,1,0,0,1,1,0,0,1
245,162077,2021,Australia,Bulgaria,0,3,5,8,29/05/2021,0,0,0,0,2,0,0,2,0,0,1,1,0,1,1,2,0,0,0,0
246,162077,2021,Germany,Australia,0,1,10,11,28/05/2021,0,0,0,0,2,0,1,3,1,3,1,5,0,0,0,0,1,2,0,3
247,144464,2021,Australia,Netherlands,0,0,8,8,23/06/2021,0,0,3,3,4,0,6,10,0,4,3,7,0,0,1,1,0,2,0,2
248,144464,2021,Canada,Australia,0,2,2,4,22/06/2021,0,0,0,0,2,0,2,4,0,2,2,4,0,0,2,2,1,0,0,1
249,144464,2021,Australia,Serbia,1,1,8,10,21/06/2021,0,0,1,1,3,1,3,7,0,2,0,2,0,0,1,1,1,1,0,2
250,144464,2021,Australia,Brazil,1,1,4,6,17/06/2021,0,0,0,0,0,3,5,8,0,0,2,2,0,0,0,0,2,1,0,3
251,144464,2021,Slovenia,Australia,0,3,10,13,16/06/2021,0,0,2,2,2,4,1,7,3,4,3,10,1,0,2,3,2,0,0,2
252,144464,2021,Iran,Australia,0,2,11,13,15/06/2021,0,0,0,0,13,2,4,19,4,2,0,6,1,0,0,1,1,0,0,1
253,144464,2021,Australia,Italy,0,0,7,7,11/06/2021,0,0,5,5,4,2,2,8,2,2,1,5,0,0,0,0,0,2,1,3
254,144464,2021,Argentina,Australia,0,0,9,9,10/06/2021,0,0,1,1,4,1,7,12,3,4,0,7,1,0,0,1,0,1,0,1
255,144464,2021,Japan,Australia,0,3,10,13,09/06/2021,0,0,0,0,8,1,5,14,0,5,6,11,1,0,0,1,1,1,0,2
256,144464,2021,USA,Australia,0,0,12,12,05/06/2021,0,0,1,1,7,1,0,8,0,2,2,4,0,0,0,0,2,0,2,4
257,144464,2021,Russia,Australia,0,0,12,12,04/06/2021,0,0,1,1,3,2,4,9,2,3,1,6,0,0,1,1,3,1,0,4
258,144464,2021,Australia,Poland,0,0,3,3,03/06/2021,0,0,0,0,1,0,2,3,0,1,0,1,0,2,0,2,0,0,0,0
259,144464,2021,Australia,France,0,2,16,18,30/05/2021,0,0,0,0,7,1,3,11,0,6,10,16,0,0,1,1,2,0,2,4
260,144464,2021,Australia,Bulgaria,0,0,2,2,29/05/2021,0,0,0,0,1,0,3,4,0,1,2,3,0,0,0,0,0,0,0,0
261,144464,2021,Germany,Australia,0,0,0,0,28/05/2021,0,0,0,0,0,0,0,0,0,0,0,0,0,0,0,0,0,0,0,0
262,144578,2021,Australia,Netherlands,0,0,0,0,23/06/2021,0,0,5,5,0,0,0,0,0,0,0,0,3,0,2,5,8,3,0,11
263,144578,2021,Canada,Australia,0,0,0,0,22/06/2021,0,0,9,9,0,0,0,0,0,0,0,0,3,0,7,10,7,2,4,13
264,144578,2021,Australia,Serbia,0,0,0,0,21/06/2021,0,0,10,10,0,0,0,0,0,0,0,0,8,0,8,16,4,3,0,7
265,144578,2021,Australia,Brazil,0,0,0,0,17/06/2021,0,0,11,11,0,0,0,0,0,0,0,0,5,0,5,10,8,2,0,10
266,144578,2021,Slovenia,Australia,0,0,0,0,16/06/2021,0,0,13,13,0,0,0,0,0,0,0,0,9,2,6,17,11,4,3,18
267,144578,2021,Iran,Australia,0,0,0,0,15/06/2021,0,0,14,14,0,0,0,0,0,0,0,0,13,0,5,18,14,8,2,24
268,144578,2021,Australia,Italy,0,0,0,0,11/06/2021,0,0,9,9,0,0,0,0,0,0,0,0,2,0,11,13,10,1,2,13
269,144578,2021,Argentina,Australia,0,0,0,0,10/06/2021,0,0,10,10,0,0,0,0,0,0,0,0,7,1,7,15,4,1,0,5
270,144578,2021,Japan,Australia,0,0,0,0,09/06/2021,0,0,15,15,0,0,0,0,0,0,0,0,7,1,11,19,14,5,0,19
271,144578,2021,USA,Australia,0,0,0,0,05/06/2021,0,0,8,8,0,0,0,0,0,0,0,0,7,1,6,14,7,2,1,10
272,144578,2021,Russia,Australia,0,0,0,0,04/06/2021,0,0,10,10,0,0,0,0,0,0,0,0,8,0,6,14,5,0,0,5
273,144578,2021,Australia,Poland,0,0,0,0,03/06/2021,0,0,7,7,0,0,0,0,0,0,0,0,10,2,8,20,2,1,0,3
274,144578,2021,Australia,France,0,0,0,0,30/05/2021,0,0,7,7,0,0,0,0,0,0,0,0,6,1,11,18,17,0,0,17
275,144578,2021,Australia,Bulgaria,0,0,0,0,29/05/2021,0,0,3,3,0,0,0,0,0,0,0,0,6,3,9,18,12,3,1,16
276,144578,2021,Germany,Australia,0,0,0,0,28/05/2021,0,0,3,3,0,0,0,0,0,0,0,0,5,0,12,17,6,4,1,11
277,144461,2021,Australia,Netherlands,0,1,10,11,23/06/2021,0,0,0,0,8,2,0,10,2,4,0,6,0,0,2,2,2,1,0,3
278,144461,2021,Canada,Australia,1,1,5,7,22/06/2021,0,0,0,0,2,0,6,8,0,3,2,5,0,0,1,1,3,0,0,3
279,144461,2021,Australia,Serbia,0,0,0,0,21/06/2021,0,0,0,0,0,0,0,0,0,0,0,0,0,0,0,0,0,0,0,0
280,144461,2021,Australia,Brazil,0,0,8,8,17/06/2021,0,0,4,4,3,1,5,9,1,4,2,7,0,0,0,0,5,1,0,6
281,144461,2021,Slovenia,Australia,0,0,11,11,16/06/2021,0,0,1,1,9,3,7,19,2,3,4,9,1,0,0,1,4,0,0,4
282,144461,2021,Iran,Australia,0,1,11,12,15/06/2021,0,0,1,1,8,3,7,18,4,1,0,5,3,0,1,4,1,2,0,3
283,144461,2021,Australia,Italy,0,2,10,12,11/06/2021,1,1,0,2,7,1,5,13,1,5,4,10,0,0,2,2,3,2,0,5
284,144461,2021,Japan,Australia,0,3,14,17,09/06/2021,0,0,1,1,11,2,2,15,3,2,6,11,2,0,1,3,6,4,2,12
285,144461,2021,USA,Australia,0,0,10,10,05/06/2021,0,0,3,3,3,1,4,8,0,3,4,7,0,0,0,0,3,3,1,7
286,144461,2021,Russia,Australia,0,0,13,13,04/06/2021,0,1,2,3,5,0,1,6,0,4,2,6,2,0,0,2,4,1,0,5
287,144461,2021,Australia,Poland,0,0,9,9,03/06/2021,0,0,1,1,5,0,3,8,0,3,0,3,1,0,0,1,2,0,0,2
288,144461,2021,Australia,France,0,0,10,10,30/05/2021,0,0,0,0,7,0,4,11,2,3,7,12,1,0,2,3,2,0,1,3
289,144461,2021,Australia,Bulgaria,1,1,10,12,29/05/2021,0,0,0,0,1,1,5,7,2,4,5,11,0,0,0,0,2,0,0,2
290,144461,2021,Germany,Australia,0,1,8,9,28/05/2021,0,0,0,0,5,1,4,10,1,3,2,6,1,0,1,2,2,0,0,2
291,120515,2021,Australia,Brazil,1,0,10,11,17/06/2021,0,0,0,0,8,1,10,19,2,3,2,7,6,1,17,24,5,2,0,7
292,120515,2021,Slovenia,Australia,0,1,11,12,16/06/2021,0,0,1,1,12,2,8,22,2,1,0,3,10,1,25,36,4,4,0,8
293,120515,2021,Iran,Australia,0,1,16,17,15/06/2021,0,0,0,0,11,8,13,32,2,5,0,7,15,1,20,36,3,3,0,6
294,120515,2021,Australia,Italy,1,2,7,10,11/06/2021,1,0,5,6,8,2,8,18,0,2,1,3,9,0,15,24,5,3,0,8
295,120515,2021,Argentina,Australia,0,2,9,11,10/06/2021,0,0,1,1,9,1,8,18,2,0,0,2,10,4,17,31,2,4,0,6
296,120515,2021,Japan,Australia,1,2,14,17,09/06/2021,0,0,3,3,18,3,16,37,0,2,3,5,6,3,28,37,8,2,0,10
297,120515,2021,USA,Australia,0,0,12,12,05/06/2021,0,0,1,1,6,2,9,17,0,3,2,5,3,1,15,19,1,1,1,3
298,120515,2021,Russia,Australia,1,1,7,9,04/06/2021,0,0,1,1,11,2,12,25,1,2,2,5,9,2,10,21,4,3,0,7
299,120515,2021,Australia,Poland,0,1,4,5,03/06/2021,0,0,1,1,5,6,4,15,0,0,0,0,7,3,13,23,0,0,0,0
300,120515,2021,Australia,France,0,5,8,13,30/05/2021,0,0,0,0,8,3,11,22,4,3,0,7,7,3,17,27,6,0,0,6
301,120515,2021,Australia,Bulgaria,0,2,10,12,29/05/2021,0,0,0,0,9,4,6,19,0,1,0,1,2,2,13,17,4,2,2,8
302,120515,2021,Germany,Australia,0,4,5,9,28/05/2021,0,0,0,0,10,3,8,21,0,6,1,7,2,3,8,13,0,0,0,0
303,132961,2021,Iran,Australia,0,1,0,1,15/06/2021,0,0,0,0,1,0,0,1,0,0,0,0,3,1,2,6,0,1,0,1
304,158841,2021,Australia,Netherlands,0,0,0,0,23/06/2021,0,0,0,0,0,0,0,0,0,0,0,0,0,0,0,0,0,0,0,0
305,158841,2021,Canada,Australia,0,0,1,1,22/06/2021,2,0,9,11,1,0,0,1,1,1,0,2,0,0,0,0,0,0,0,0
306,158841,2021,Australia,Serbia,0,0,0,0,21/06/2021,1,0,3,4,0,0,0,0,0,0,0,0,0,0,0,0,0,1,0,1
307,158841,2021,Australia,Brazil,0,1,0,1,17/06/2021,2,0,15,17,0,0,0,0,0,0,0,0,0,0,0,0,2,0,0,2
308,158841,2021,Slovenia,Australia,0,0,0,0,16/06/2021,2,0,2,4,0,0,0,0,0,0,0,0,0,0,0,0,1,0,0,1
309,158841,2021,Iran,Australia,0,0,0,0,15/06/2021,2,0,4,6,0,0,0,0,0,0,0,0,0,0,0,0,2,0,0,2
310,158841,2021,Australia,Italy,0,0,0,0,11/06/2021,0,0,0,0,0,0,0,0,0,0,0,0,0,0,0,0,0,0,0,0
311,158841,2021,Argentina,Australia,0,0,1,1,10/06/2021,0,0,0,0,0,0,0,0,0,0,0,0,0,0,0,0,0,0,0,0
312,158841,2021,Japan,Australia,0,0,0,0,09/06/2021,0,0,0,0,0,0,0,0,0,0,0,0,0,0,0,0,0,0,0,0
313,158841,2021,USA,Australia,0,0,0,0,05/06/2021,0,0,0,0,0,0,0,0,0,0,0,0,0,0,0,0,0,0,0,0
314,158841,2021,Russia,Australia,0,0,0,0,04/06/2021,0,0,0,0,0,0,0,0,0,0,0,0,0,0,0,0,0,0,0,0
315,158841,2021,Australia,Poland,0,0,0,0,03/06/2021,0,0,8,8,0,0,0,0,0,0,0,0,0,0,0,0,0,0,0,0
316,158841,2021,Australia,France,0,0,0,0,30/05/2021,0,0,0,0,0,0,0,0,0,0,0,0,0,0,0,0,2,0,0,2
317,158841,2021,Australia,Bulgaria,0,0,0,0,29/05/2021,0,0,0,0,0,0,0,0,0,0,0,0,0,0,0,0,0,0,0,0
318,158841,2021,Germany,Australia,0,0,0,0,28/05/2021,3,0,3,6,0,0,0,0,0,0,0,0,0,0,0,0,0,1,0,1
319,162870,2021,Australia,Netherlands,1,2,12,15,23/06/2021,0,0,1,1,4,2,5,11,1,4,0,5,12,2,12,26,3,3,0,6
320,162870,2021,Canada,Australia,1,2,5,8,22/06/2021,0,0,1,1,2,2,6,10,0,0,1,1,9,1,13,23,8,1,2,11
321,162870,2021,Australia,Serbia,1,2,4,7,21/06/2021,0,0,3,3,4,3,9,16,0,0,0,0,5,1,4,10,1,0,0,1
322,162870,2021,Australia,Brazil,0,0,2,2,17/06/2021,0,0,0,0,0,0,0,0,0,0,0,0,0,1,2,3,1,0,1,2
323,162870,2021,Slovenia,Australia,0,2,4,6,16/06/2021,0,0,0,0,3,0,2,5,1,1,2,4,6,0,4,10,0,0,1,1
324,162870,2021,Iran,Australia,0,0,1,1,15/06/2021,0,0,0,0,0,0,0,0,0,0,0,0,2,0,1,3,0,0,0,0
325,162870,2021,Australia,Italy,0,0,3,3,11/06/2021,1,0,0,1,1,3,2,6,0,0,0,0,3,0,5,8,0,2,0,2
326,162870,2021,Argentina,Australia,0,3,8,11,10/06/2021,0,0,0,0,6,1,9,16,0,0,0,0,6,0,6,12,0,1,0,1
327,162870,2021,Japan,Australia,0,1,12,13,09/06/2021,0,0,1,1,7,3,9,19,3,1,3,7,2,0,15,17,4,0,1,5
328,162870,2021,USA,Australia,1,1,1,3,05/06/2021,0,0,0,0,3,2,0,5,0,1,0,1,1,0,6,7,0,0,0,0
329,162870,2021,Russia,Australia,0,0,0,0,04/06/2021,0,0,0,0,0,0,0,0,0,0,0,0,0,0,0,0,0,0,0,0
330,162870,2021,Australia,Poland,0,0,0,0,03/06/2021,0,0,0,0,0,0,0,0,0,0,0,0,0,0,0,0,0,0,0,0
331,162870,2021,Australia,France,0,0,0,0,30/05/2021,0,0,0,0,0,0,0,0,0,0,0,0,0,0,0,0,0,0,0,0
332,162870,2021,Australia,Bulgaria,0,0,0,0,29/05/2021,0,0,0,0,0,0,0,0,0,0,0,0,0,0,0,0,0,0,0,0
333,162870,2021,Germany,Australia,0,0,0,0,28/05/2021,0,0,0,0,0,0,0,0,0,0,0,0,0,0,0,0,0,0,0,0
334,162267,2021,Australia,Netherlands,0,0,0,0,23/06/2021,0,0,0,0,0,0,0,0,0,0,0,0,0,0,0,0,0,0,0,0
335,162267,2021,Canada,Australia,0,0,0,0,22/06/2021,0,0,0,0,0,0,0,0,0,0,0,0,0,0,0,0,0,0,0,0
336,162267,2021,Australia,Serbia,0,1,0,1,21/06/2021,0,0,0,0,2,1,1,4,0,0,0,0,1,2,6,9,0,0,0,0
337,162267,2021,Australia,Brazil,0,0,0,0,17/06/2021,0,0,0,0,0,0,0,0,0,0,0,0,0,0,0,0,0,0,0,0
338,162267,2021,Slovenia,Australia,0,1,0,1,16/06/2021,0,0,0,0,3,0,0,3,0,0,0,0,0,0,0,0,0,0,0,0
339,162267,2021,Iran,Australia,0,0,0,0,15/06/2021,0,0,0,0,0,0,0,0,0,0,0,0,0,0,0,0,0,0,0,0
340,162267,2021,Australia,Italy,0,1,5,6,11/06/2021,0,0,1,1,4,1,5,10,0,2,0,2,1,3,8,12,4,0,0,4
341,162267,2021,Argentina,Australia,0,0,0,0,10/06/2021,0,0,0,0,0,0,0,0,0,0,0,0,0,0,0,0,0,0,0,0
342,162267,2021,Japan,Australia,0,2,2,4,09/06/2021,0,0,0,0,2,2,2,6,0,0,1,1,4,1,3,8,1,2,1,4
343,162267,2021,USA,Australia,0,2,4,6,05/06/2021,0,0,1,1,7,4,3,14,2,0,1,3,2,3,13,18,5,1,0,6
344,162267,2021,Russia,Australia,0,1,1,2,04/06/2021,0,0,0,0,0,1,4,5,0,0,0,0,2,1,3,6,1,0,0,1
345,162267,2021,Australia,Poland,0,1,0,1,03/06/2021,0,0,1,1,1,2,1,4,0,0,0,0,2,1,3,6,0,0,0,0
346,162267,2021,Australia,France,0,0,0,0,30/05/2021,0,0,0,0,1,3,3,7,0,0,0,0,0,2,0,2,1,0,0,1
347,162267,2021,Australia,Bulgaria,0,1,4,5,29/05/2021,0,0,0,0,2,1,4,7,1,1,1,3,1,3,3,7,1,2,0,3
348,162267,2021,Germany,Australia,0,0,0,0,28/05/2021,0,0,0,0,0,0,0,0,0,0,0,0,0,0,0,0,0,0,0,0
349,169335,2021,Australia,Netherlands,0,0,0,0,23/06/2021,0,0,0,0,0,0,0,0,0,0,0,0,1,1,1,3,1,1,0,2
350,169335,2021,Canada,Australia,0,1,3,4,22/06/2021,0,0,2,2,0,3,3,6,0,3,1,4,1,0,5,6,0,0,1,1
351,169335,2021,Australia,Serbia,0,2,1,3,21/06/2021,0,0,0,0,2,2,7,11,0,1,0,1,3,1,12,16,0,1,0,1
352,169335,2021,Australia,Brazil,0,2,3,5,17/06/2021,0,0,3,3,7,3,9,19,0,1,0,1,7,1,21,29,2,5,1,8
353,169335,2021,Slovenia,Australia,0,0,4,4,16/06/2021,0,1,2,3,2,4,5,11,0,4,1,5,3,1,5,9,0,1,0,1
354,169335,2021,Iran,Australia,1,6,8,15,15/06/2021,0,0,1,1,8,11,9,28,1,3,2,6,11,3,6,20,0,1,0,1
355,169335,2021,Japan,Australia,0,0,0,0,09/06/2021,0,0,0,0,0,0,0,0,0,0,0,0,0,0,0,0,0,0,0,0
356,169335,2021,Russia,Australia,0,1,5,6,04/06/2021,0,0,1,1,2,1,6,9,0,1,0,1,5,1,6,12,0,1,0,1
357,169335,2021,Australia,Poland,0,1,2,3,03/06/2021,0,0,0,0,2,5,4,11,1,3,1,5,1,1,5,7,2,2,0,4
358,169335,2021,Australia,France,0,6,7,13,30/05/2021,0,0,0,0,7,4,9,20,0,5,2,7,9,0,16,25,4,2,1,7
359,169335,2021,Australia,Bulgaria,0,1,5,6,29/05/2021,0,0,0,0,1,1,4,6,0,1,0,1,1,2,5,8,0,1,0,1
360,169335,2021,Germany,Australia,0,2,7,9,28/05/2021,0,0,0,0,2,3,5,10,0,3,0,3,5,2,14,21,2,2,0,4
361,162265,2021,Australia,Netherlands,0,2,2,4,23/06/2021,0,0,0,0,5,1,3,9,0,0,0,0,0,0,0,0,1,0,0,1
362,162265,2021,Canada,Australia,0,0,0,0,22/06/2021,0,0,0,0,0,0,0,0,0,0,0,0,0,0,0,0,0,0,0,0
363,162265,2021,Australia,Serbia,0,1,0,1,21/06/2021,0,0,0,0,0,1,0,1,0,0,0,0,0,0,0,0,0,0,0,0
364,162265,2021,Australia,Brazil,0,0,0,0,17/06/2021,0,0,0,0,0,0,0,0,0,0,0,0,0,0,0,0,0,0,0,0
365,162265,2021,Slovenia,Australia,0,0,0,0,16/06/2021,0,0,0,0,0,0,0,0,0,0,0,0,0,0,0,0,0,0,0,0
366,162265,2021,Iran,Australia,0,0,0,0,15/06/2021,0,0,0,0,0,0,0,0,0,0,0,0,0,0,0,0,0,0,0,0
367,162265,2021,Australia,Italy,0,1,0,1,11/06/2021,0,0,0,0,0,0,0,0,0,0,0,0,0,0,0,0,0,0,0,0
368,162265,2021,Argentina,Australia,0,0,0,0,10/06/2021,0,0,0,0,0,0,0,0,0,0,0,0,0,0,0,0,0,0,0,0
369,162265,2021,Japan,Australia,0,0,0,0,09/06/2021,0,0,0,0,0,0,0,0,0,0,0,0,0,0,0,0,0,0,0,0
370,162265,2021,USA,Australia,0,0,0,0,05/06/2021,0,0,0,0,0,0,0,0,0,0,0,0,0,0,0,0,0,0,0,0
371,162265,2021,Russia,Australia,0,0,0,0,04/06/2021,0,0,0,0,0,0,0,0,0,0,0,0,0,0,0,0,0,0,0,0
372,162265,2021,Australia,Poland,0,0,0,0,03/06/2021,0,0,0,0,0,0,0,0,0,0,0,0,0,0,0,0,0,0,0,0
373,162265,2021,Australia,France,0,0,0,0,30/05/2021,0,0,0,0,0,1,1,2,0,0,0,0,0,1,0,1,0,0,0,0
374,162265,2021,Australia,Bulgaria,0,1,1,2,29/05/2021,0,0,0,0,1,0,1,2,0,2,0,2,0,0,0,0,2,0,3,5
375,162265,2021,Germany,Australia,0,0,0,0,28/05/2021,0,0,0,0,0,1,1,2,0,1,0,1,0,0,0,0,0,0,0,0
376,181257,2021,Australia,Netherlands,0,4,8,12,23/06/2021,0,0,0,0,10,5,4,19,1,1,0,2,8,5,7,20,0,0,0,0
377,181257,2021,Canada,Australia,0,3,3,6,22/06/2021,0,0,0,0,10,5,12,27,0,1,4,5,2,4,10,16,1,2,1,4
378,181257,2021,Australia,Serbia,2,1,8,11,21/06/2021,0,0,0,0,8,3,10,21,2,3,0,5,10,2,14,26,10,5,0,15
379,181257,2021,Australia,Brazil,0,1,0,1,17/06/2021,0,0,0,0,4,1,4,9,0,0,0,0,0,0,0,0,0,0,0,0
380,181257,2021,Slovenia,Australia,0,0,1,1,16/06/2021,0,0,0,0,3,1,1,5,0,0,0,0,0,0,0,0,1,1,0,2
381,181257,2021,Iran,Australia,0,0,0,0,15/06/2021,0,0,0,0,1,0,0,1,0,0,0,0,0,0,0,0,0,0,0,0
382,181257,2021,Australia,Italy,0,0,2,2,11/06/2021,0,0,0,0,1,1,5,7,0,0,1,1,0,0,0,0,1,0,1,2
383,181257,2021,Argentina,Australia,0,2,1,3,10/06/2021,0,0,0,0,4,5,2,11,0,0,0,0,0,0,0,0,0,0,0,0
384,181257,2021,Japan,Australia,0,2,5,7,09/06/2021,0,0,0,0,6,1,11,18,0,2,0,2,0,0,0,0,1,0,1,2
385,181257,2021,USA,Australia,0,0,2,2,05/06/2021,0,0,2,2,1,2,3,6,0,1,0,1,0,1,0,1,2,0,0,2
386,181257,2021,Russia,Australia,0,0,0,0,04/06/2021,0,0,0,0,0,0,0,0,0,0,0,0,0,0,0,0,0,0,0,0
387,181257,2021,Australia,Poland,0,2,1,3,03/06/2021,0,0,0,0,3,0,7,10,0,1,0,1,0,0,0,0,1,1,0,2
388,178207,2021,Australia,Brazil,0,0,0,0,17/06/2021,0,0,0,0,0,0,0,0,0,0,0,0,0,0,0,0,0,0,0,0
389,178207,2021,Argentina,Australia,0,0,0,0,10/06/2021,0,0,0,0,0,0,0,0,0,0,0,0,0,0,0,0,0,0,0,0
390,178207,2021,USA,Australia,0,0,0,0,05/06/2021,0,0,0,0,0,0,0,0,0,0,0,0,0,0,0,0,0,0,0,0
391,178207,2021,Australia,Poland,0,1,0,1,03/06/2021,0,0,0,0,0,2,0,2,0,0,0,0,0,1,0,1,0,0,0,0
392,178207,2021,Australia,France,0,0,0,0,30/05/2021,0,0,0,0,0,0,0,0,0,0,0,0,0,0,0,0,0,0,0,0
393,178207,2021,Australia,Bulgaria,0,0,0,0,29/05/2021,0,0,0,0,0,0,0,0,0,0,0,0,0,0,0,0,0,0,0,0
394,178207,2021,Germany,Australia,0,0,0,0,28/05/2021,0,0,0,0,0,0,0,0,0,0,0,0,0,0,0,0,0,0,0,0
395,181247,2021,Australia,Netherlands,0,0,0,0,23/06/2021,0,0,0,0,0,0,0,0,0,0,0,0,0,0,0,0,0,0,0,0
396,181247,2021,Canada,Australia,0,0,0,0,22/06/2021,0,0,0,0,0,0,0,0,0,0,0,0,0,0,0,0,0,0,0,0
397,181247,2021,Australia,Serbia,0,0,0,0,21/06/2021,0,0,0,0,0,0,0,0,0,0,0,0,0,0,0,0,0,0,0,0
398,181247,2021,Slovenia,Australia,0,0,0,0,16/06/2021,0,0,0,0,0,0,0,0,0,0,0,0,0,0,0,0,0,0,0,0
399,181247,2021,Australia,Italy,0,0,0,0,11/06/2021,0,0,0,0,0,0,0,0,0,0,0,0,0,0,0,0,0,0,0,0
400,181247,2021,Argentina,Australia,0,0,0,0,10/06/2021,0,0,0,0,0,0,0,0,0,0,0,0,0,0,0,0,0,0,0,0
401,181247,2021,Japan,Australia,0,0,0,0,09/06/2021,0,0,0,0,0,0,0,0,0,0,0,0,0,0,0,0,0,0,0,0
402,181247,2021,USA,Australia,0,0,0,0,05/06/2021,0,0,0,0,0,0,0,0,0,0,0,0,0,0,0,0,0,0,0,0
403,181247,2021,Russia,Australia,0,0,0,0,04/06/2021,0,0,0,0,0,0,0,0,0,0,0,0,0,0,0,0,0,0,0,0
404,181247,2021,Germany,Australia,0,0,0,0,28/05/2021,0,0,0,0,0,0,0,0,0,0,0,0,0,0,0,0,0,0,0,0
405,116099,2021,Brazil,Poland,1,0,14,15,27/06/2021,22,0,63,85,0,0,0,0,0,4,1,5,0,0,0,0,11,4,0,15
406,116099,2021,Brazil,France,0,0,9,9,26/06/2021,18,1,48,67,0,0,0,0,1,2,3,6,0,0,0,0,4,1,0,5
407,116099,2021,Brazil,Russia,0,1,6,7,23/06/2021,15,0,27,42,0,0,0,0,0,1,1,2,0,0,0,0,2,5,3,10
408,116099,2021,Brazil,Germany,0,0,0,0,22/06/2021,1,0,1,2,0,0,0,0,0,0,0,0,0,0,0,0,0,0,0,0
409,116099,2021,Brazil,Italy,0,0,18,18,21/06/2021,36,0,68,104,0,0,0,0,0,5,5,10,0,0,0,0,14,2,5,21
410,116099,2021,Australia,Brazil,0,1,11,12,17/06/2021,25,0,36,61,2,0,1,3,1,2,0,3,0,0,0,0,9,1,4,14
411,116099,2021,Iran,Brazil,0,0,0,0,16/06/2021,0,0,5,5,0,0,0,0,0,0,0,0,0,0,0,0,0,0,0,0
412,116099,2021,Brazil,Slovenia,0,0,9,9,15/06/2021,31,0,59,90,0,0,0,0,1,2,4,7,0,0,0,0,9,2,2,13
413,116099,2021,Poland,Brazil,0,0,11,11,11/06/2021,11,0,60,71,2,0,0,2,0,3,3,6,0,0,0,0,5,0,0,5
414,116099,2021,Bulgaria,Brazil,0,0,0,0,10/06/2021,1,0,3,4,0,0,0,0,0,0,0,0,0,0,0,0,0,0,0,0
415,116099,2021,Netherlands,Brazil,0,0,11,11,09/06/2021,18,1,49,68,2,0,1,3,1,0,3,4,0,0,0,0,8,0,0,8
416,116099,2021,Brazil,Serbia,0,0,16,16,05/06/2021,39,1,41,81,1,0,0,1,2,2,2,6,0,0,0,0,6,1,2,9
417,116099,2021,Brazil,Japan,0,0,0,0,04/06/2021,0,0,2,2,0,0,0,0,0,0,0,0,0,0,0,0,0,0,0,0
418,116099,2021,Brazil,France,0,1,9,10,03/06/2021,37,0,48,85,0,0,0,0,1,3,5,9,0,0,0,0,5,3,1,9
419,116099,2021,Canada,Brazil,0,0,0,0,30/05/2021,2,0,3,5,0,0,0,0,0,0,0,0,0,0,0,0,2,0,0,2
420,116099,2021,USA,Brazil,2,2,10,14,29/05/2021,7,0,59,66,0,0,2,2,0,0,0,0,0,0,0,0,1,0,0,1
421,116099,2021,Brazil,Argentina,2,3,11,16,28/05/2021,19,0,52,71,2,0,1,3,0,2,0,2,0,0,1,1,6,3,0,9
422,136955,2021,Brazil,Germany,0,0,1,1,22/06/2021,0,0,0,0,0,0,0,0,0,0,0,0,0,0,0,0,0,0,0,0
423,136955,2021,Brazil,Italy,0,1,2,3,21/06/2021,0,0,0,0,0,0,0,0,0,0,0,0,0,0,0,0,0,0,0,0
424,136955,2021,Australia,Brazil,1,1,2,4,17/06/2021,0,0,2,2,3,0,1,4,0,0,0,0,0,0,1,1,1,0,0,1
425,136955,2021,Iran,Brazil,0,0,1,1,16/06/2021,0,0,0,0,0,0,2,2,0,0,0,0,0,0,0,0,0,0,0,0
426,132030,2021,Brazil,Poland,0,0,0,0,27/06/2021,0,0,0,0,0,0,0,0,0,0,0,0,0,0,0,0,0,0,0,0
427,132030,2021,Brazil,France,0,0,0,0,26/06/2021,0,0,0,0,0,0,0,0,0,0,0,0,0,0,0,0,0,0,0,0
428,132030,2021,Brazil,Russia,0,1,2,3,23/06/2021,0,0,0,0,3,3,0,6,0,0,0,0,0,1,2,3,2,0,0,2
429,132030,2021,Brazil,Germany,1,3,9,13,22/06/2021,0,0,2,2,8,5,6,19,2,0,0,2,8,2,8,18,7,0,0,7
430,132030,2021,Brazil,Italy,0,0,0,0,21/06/2021,1,0,0,1,1,0,0,1,0,0,0,0,1,0,4,5,1,0,0,1
431,132030,2021,Australia,Brazil,0,1,7,8,17/06/2021,0,0,7,7,10,1,7,18,1,1,4,6,4,0,9,13,4,0,0,4
432,132030,2021,Iran,Brazil,0,0,0,0,16/06/2021,0,0,0,0,0,0,0,0,0,0,0,0,1,1,5,7,0,1,0,1
433,132030,2021,Brazil,Slovenia,0,0,0,0,15/06/2021,0,0,0,0,0,0,0,0,0,0,0,0,0,0,1,1,1,1,0,2
434,132030,2021,Poland,Brazil,0,0,0,0,11/06/2021,0,0,0,0,0,0,0,0,0,0,0,0,0,1,1,2,0,0,0,0
435,132030,2021,Bulgaria,Brazil,0,0,0,0,10/06/2021,0,0,0,0,0,0,0,0,0,0,0,0,0,0,0,0,0,0,0,0
436,132030,2021,Netherlands,Brazil,0,1,13,14,09/06/2021,0,0,5,5,3,6,7,16,0,2,3,5,11,4,7,22,2,0,0,2
437,132030,2021,Brazil,Serbia,0,0,0,0,05/06/2021,0,0,0,0,0,0,0,0,0,0,0,0,0,0,0,0,0,0,0,0
438,132030,2021,Brazil,Japan,0,0,2,2,04/06/2021,0,0,0,0,1,0,1,2,0,0,0,0,0,0,4,4,1,3,0,4
439,132030,2021,Brazil,France,0,0,0,0,03/06/2021,0,0,0,0,0,0,0,0,0,0,0,0,0,0,1,1,0,0,0,0
440,132030,2021,Canada,Brazil,2,3,10,15,30/05/2021,0,0,0,0,7,3,8,18,0,1,3,4,8,2,15,25,5,2,1,8
441,132030,2021,USA,Brazil,0,0,0,0,29/05/2021,0,0,0,0,0,0,0,0,0,0,0,0,0,0,0,0,0,0,0,0
442,132030,2021,Brazil,Argentina,0,0,0,0,28/05/2021,0,0,0,0,0,0,0,0,0,0,0,0,0,0,0,0,0,0,0,0
443,142744,2021,Brazil,Poland,0,0,0,0,27/06/2021,0,0,0,0,0,0,0,0,0,0,0,0,0,0,0,0,0,0,0,0
444,142744,2021,Brazil,France,0,0,0,0,26/06/2021,0,0,0,0,0,0,0,0,0,0,0,0,0,0,0,0,0,0,0,0
445,142744,2021,Brazil,Russia,0,1,3,4,23/06/2021,3,0,15,18,0,0,0,0,0,0,1,1,0,0,0,0,1,0,0,1
446,142744,2021,Brazil,Germany,0,1,7,8,22/06/2021,23,0,50,73,1,0,0,1,0,4,1,5,0,0,0,0,4,2,0,6
447,142744,2021,Brazil,Italy,0,0,0,0,21/06/2021,1,0,0,1,0,0,0,0,0,0,0,0,0,0,0,0,0,0,0,0
448,142744,2021,Australia,Brazil,0,0,0,0,17/06/2021,0,0,0,0,0,0,0,0,0,0,0,0,0,0,0,0,0,0,0,0
449,142744,2021,Iran,Brazil,0,2,15,17,16/06/2021,7,0,77,84,2,0,0,2,1,2,0,3,0,0,1,1,9,2,0,11
450,142744,2021,Brazil,Slovenia,0,0,0,0,15/06/2021,1,0,6,7,0,0,0,0,0,1,0,1,0,0,0,0,0,0,0,0
451,142744,2021,Poland,Brazil,0,0,0,0,11/06/2021,0,0,0,0,0,0,0,0,0,0,0,0,0,0,0,0,0,0,0,0
452,142744,2021,Bulgaria,Brazil,2,0,8,10,10/06/2021,19,0,26,45,0,1,0,1,0,1,0,1,0,0,0,0,1,2,0,3
453,142744,2021,Netherlands,Brazil,0,0,0,0,09/06/2021,1,0,1,2,0,0,0,0,0,0,0,0,0,0,0,0,0,0,0,0
454,142744,2021,Brazil,Serbia,0,0,0,0,05/06/2021,0,0,1,1,0,0,0,0,0,0,0,0,0,0,0,0,0,0,0,0
455,142744,2021,Brazil,Japan,0,1,6,7,04/06/2021,31,0,34,65,0,0,1,1,0,1,2,3,0,0,0,0,10,1,1,12
456,142744,2021,Brazil,France,0,0,1,1,03/06/2021,2,0,5,7,0,0,0,0,0,0,0,0,0,0,0,0,1,0,0,1
457,142744,2021,Canada,Brazil,1,0,12,13,30/05/2021,24,2,76,102,0,0,1,1,1,2,0,3,0,0,1,1,8,2,0,10
458,142744,2021,USA,Brazil,0,0,0,0,29/05/2021,0,0,0,0,0,0,0,0,0,0,0,0,0,0,0,0,0,0,0,0
459,142744,2021,Brazil,Argentina,0,0,0,0,28/05/2021,0,0,1,1,0,0,0,0,0,0,0,0,0,0,0,0,0,1,0,1
460,112869,2021,Brazil,Poland,1,4,14,19,27/06/2021,0,0,1,1,18,7,6,31,3,3,6,12,1,0,0,1,4,2,0,6
461,112869,2021,Brazil,France,1,0,11,12,26/06/2021,0,0,1,1,11,2,6,19,1,0,4,5,0,0,0,0,2,0,0,2
462,112869,2021,Brazil,Russia,2,3,4,9,23/06/2021,0,0,0,0,6,3,2,11,2,2,2,6,0,0,0,0,4,0,1,5
463,112869,2021,Brazil,Germany,0,0,0,0,22/06/2021,0,0,0,0,0,0,0,0,0,0,0,0,0,0,0,0,0,0,0,0
464,112869,2021,Brazil,Italy,0,4,11,15,21/06/2021,0,0,1,1,19,3,7,29,1,5,4,10,0,0,3,3,4,1,0,5
465,112869,2021,Australia,Brazil,0,0,0,0,17/06/2021,0,0,0,0,0,0,0,0,0,0,0,0,0,0,0,0,0,0,0,0
466,112869,2021,Iran,Brazil,0,0,0,0,16/06/2021,0,0,0,0,0,0,0,0,0,0,0,0,0,0,0,0,0,0,0,0
467,112869,2021,Brazil,Slovenia,1,4,15,20,15/06/2021,0,0,3,3,17,2,7,26,0,4,3,7,0,0,0,0,5,3,2,10
468,112869,2021,Poland,Brazil,0,2,12,14,11/06/2021,0,0,2,2,17,4,6,27,1,2,0,3,0,0,1,1,3,2,0,5
469,112869,2021,Bulgaria,Brazil,0,0,0,0,10/06/2021,0,0,0,0,0,0,0,0,0,0,0,0,0,0,0,0,0,0,0,0
470,112869,2021,Netherlands,Brazil,1,2,12,15,09/06/2021,0,0,1,1,12,0,7,19,2,2,4,8,0,0,0,0,7,0,0,7
471,112869,2021,Brazil,Serbia,0,0,0,0,05/06/2021,0,0,0,0,0,0,0,0,0,0,0,0,0,0,0,0,0,0,0,0
472,112869,2021,Brazil,Japan,1,2,10,13,04/06/2021,0,0,0,0,15,1,10,26,0,0,2,2,0,0,1,1,6,1,1,8
473,112869,2021,Brazil,France,1,1,8,10,03/06/2021,0,0,2,2,5,5,3,13,0,1,0,1,0,0,1,1,1,2,0,3
474,112869,2021,Canada,Brazil,0,2,12,14,30/05/2021,3,0,0,3,19,2,12,33,0,1,0,1,0,0,0,0,7,1,1,9
475,112869,2021,USA,Brazil,0,1,4,5,29/05/2021,0,0,0,0,4,1,0,5,0,0,0,0,0,0,0,0,0,0,0,0
476,112869,2021,Brazil,Argentina,1,2,14,17,28/05/2021,0,0,0,0,7,9,3,19,0,4,0,4,0,0,1,1,6,0,0,6
477,118928,2021,Brazil,Poland,0,3,10,13,27/06/2021,0,0,3,3,16,4,15,35,1,1,0,2,5,2,23,30,6,3,0,9
478,118928,2021,Brazil,France,2,4,9,15,26/06/2021,0,0,1,1,18,1,8,27,0,2,4,6,5,1,11,17,8,1,0,9
479,118928,2021,Brazil,Russia,0,0,7,7,23/06/2021,0,0,1,1,6,6,5,17,0,3,0,3,1,3,7,11,3,0,0,3
480,118928,2021,Brazil,Italy,1,3,13,17,21/06/2021,0,0,3,3,19,2,14,35,0,3,4,7,6,2,22,30,5,2,0,7
481,118928,2021,Australia,Brazil,0,0,0,0,17/06/2021,0,0,0,0,0,0,0,0,0,0,0,0,0,0,0,0,0,0,0,0
482,118928,2021,Iran,Brazil,1,2,3,6,16/06/2021,0,0,0,0,2,1,4,7,1,1,0,2,2,0,3,5,2,2,0,4
483,118928,2021,Brazil,Slovenia,0,2,14,16,15/06/2021,0,0,2,2,16,5,10,31,1,2,1,4,6,1,27,34,3,1,0,4
484,118928,2021,Poland,Brazil,1,2,15,18,11/06/2021,0,0,1,1,10,5,14,29,0,2,2,4,3,1,16,20,3,3,0,6
485,118928,2021,Bulgaria,Brazil,0,0,0,0,10/06/2021,0,0,0,0,0,0,0,0,0,0,0,0,0,0,0,0,0,0,0,0
486,118928,2021,Netherlands,Brazil,2,1,10,13,09/06/2021,0,0,2,2,18,5,4,27,0,4,1,5,3,0,11,14,4,1,1,6
487,118928,2021,Brazil,Serbia,0,0,0,0,05/06/2021,0,0,0,0,0,0,0,0,0,0,0,0,0,0,0,0,0,0,0,0
488,118928,2021,Brazil,Japan,3,1,10,14,04/06/2021,0,0,1,1,7,5,4,16,2,1,4,7,3,0,12,15,6,0,0,6
489,118928,2021,Brazil,France,0,1,8,9,03/06/2021,0,0,0,0,11,2,8,21,1,1,1,3,4,1,16,21,1,0,0,1
490,118928,2021,USA,Brazil,2,2,9,13,29/05/2021,0,0,0,0,9,1,3,13,2,0,0,2,2,2,16,20,0,0,0,0
491,118928,2021,Brazil,Argentina,0,0,7,7,28/05/2021,0,0,0,0,7,2,5,14,3,2,0,5,5,2,10,17,3,0,0,3
492,151789,2021,Brazil,Germany,0,0,0,0,22/06/2021,0,0,0,0,0,0,0,0,0,1,0,1,0,0,0,0,0,0,0,0
493,151789,2021,Australia,Brazil,0,1,2,3,17/06/2021,0,0,1,1,3,1,2,6,1,1,1,3,2,0,1,3,1,0,0,1
494,151789,2021,Brazil,Slovenia,0,1,0,1,15/06/2021,0,0,0,0,0,0,0,0,0,0,0,0,0,0,0,0,0,0,0,0
495,151789,2021,Poland,Brazil,0,0,1,1,11/06/2021,0,0,0,0,0,0,0,0,0,0,0,0,0,0,0,0,0,0,0,0
496,151789,2021,Bulgaria,Brazil,0,0,1,1,10/06/2021,0,0,0,0,2,1,0,3,0,0,0,0,0,0,1,1,0,0,0,0
497,151789,2021,Netherlands,Brazil,0,0,1,1,09/06/2021,0,0,0,0,0,0,0,0,0,0,0,0,0,0,0,0,0,0,0,0
498,151789,2021,Brazil,Serbia,0,0,0,0,05/06/2021,0,0,0,0,0,0,0,0,0,0,0,0,0,0,0,0,0,0,0,0
499,151789,2021,Brazil,France,0,0,0,0,03/06/2021,0,0,0,0,0,0,0,0,0,0,0,0,0,0,0,0,0,0,0,0
500,151789,2021,Canada,Brazil,0,0,0,0,30/05/2021,0,0,0,0,1,0,0,1,0,0,0,0,0,0,0,0,0,0,0,0
501,151789,2021,Brazil,Argentina,0,0,0,0,28/05/2021,0,0,0,0,0,0,0,0,0,0,0,0,0,0,0,0,0,0,0,0
502,119872,2021,Brazil,Poland,0,1,0,1,27/06/2021,0,0,0,0,0,0,0,0,0,0,0,0,0,0,0,0,0,0,0,0
503,119872,2021,Brazil,France,0,2,2,4,26/06/2021,0,0,0,0,1,0,0,1,0,1,1,2,0,0,0,0,0,0,0,0
504,119872,2021,Brazil,Russia,0,1,1,2,23/06/2021,0,0,1,1,1,1,2,4,0,2,1,3,0,0,0,0,0,0,0,0
505,119872,2021,Brazil,Germany,0,4,6,10,22/06/2021,0,0,0,0,7,0,4,11,1,3,0,4,0,0,0,0,1,1,0,2
506,119872,2021,Australia,Brazil,2,1,10,13,17/06/2021,0,0,0,0,7,1,5,13,2,2,6,10,0,0,0,0,1,0,0,1
507,119872,2021,Iran,Brazil,0,2,13,15,16/06/2021,0,0,2,2,5,0,9,14,1,3,1,5,1,0,0,1,2,1,0,3
508,119872,2021,Brazil,Slovenia,1,2,5,8,15/06/2021,0,0,0,0,4,0,0,4,3,1,0,4,0,0,1,1,1,0,0,1
509,119872,2021,Poland,Brazil,0,4,6,10,11/06/2021,0,0,0,0,5,0,2,7,1,1,3,5,1,0,0,1,0,0,0,0
510,119872,2021,Bulgaria,Brazil,0,3,7,10,10/06/2021,0,0,0,0,5,0,2,7,0,3,3,6,1,0,0,1,1,1,0,2
511,119872,2021,Netherlands,Brazil,0,0,0,0,09/06/2021,0,0,0,0,0,0,0,0,0,0,0,0,0,0,0,0,0,0,0,0
512,119872,2021,Brazil,Serbia,1,4,7,12,05/06/2021,0,0,0,0,3,2,1,6,2,3,2,7,0,0,0,0,0,0,0,0
513,119872,2021,Brazil,Japan,1,1,5,7,04/06/2021,0,0,1,1,7,0,2,9,0,4,5,9,0,0,0,0,3,2,0,5
514,119872,2021,Brazil,France,2,4,9,15,03/06/2021,0,0,0,0,5,1,4,10,3,7,4,14,0,0,0,0,3,1,2,6
515,119872,2021,Canada,Brazil,1,4,12,17,30/05/2021,0,0,0,0,4,1,6,11,3,3,2,8,0,0,0,0,5,0,1,6
516,119872,2021,USA,Brazil,1,2,9,12,29/05/2021,0,0,1,1,5,0,1,6,3,0,0,3,1,0,1,2,1,0,0,1
517,119872,2021,Brazil,Argentina,1,1,12,14,28/05/2021,0,0,0,0,7,3,2,12,2,1,0,3,1,0,0,1,1,0,0,1
518,136734,2021,Brazil,Poland,1,2,8,11,27/06/2021,0,0,1,1,3,0,2,5,4,2,6,12,0,0,0,0,2,1,0,3
519,136734,2021,Brazil,France,0,1,9,10,26/06/2021,0,0,0,0,3,0,1,4,5,7,4,16,0,0,0,0,1,0,0,1
520,136734,2021,Brazil,Russia,0,0,7,7,23/06/2021,0,0,2,2,3,0,3,6,1,2,2,5,0,0,0,0,0,0,0,0
521,136734,2021,Brazil,Germany,0,0,0,0,22/06/2021,0,0,0,0,0,0,0,0,0,0,0,0,0,0,0,0,0,0,0,0
522,136734,2021,Brazil,Italy,0,0,16,16,21/06/2021,0,0,1,1,8,2,7,17,0,4,10,14,0,0,0,0,0,0,1,1
523,136734,2021,Australia,Brazil,0,0,0,0,17/06/2021,0,0,0,0,0,0,0,0,0,0,0,0,0,0,0,0,0,0,0,0
524,136734,2021,Iran,Brazil,1,3,12,16,16/06/2021,0,0,4,4,5,1,2,8,3,6,1,10,0,0,1,1,1,0,1,2
525,136734,2021,Brazil,Slovenia,0,1,9,10,15/06/2021,0,0,0,0,3,1,2,6,0,5,0,5,0,0,0,0,1,1,0,2
526,136734,2021,Poland,Brazil,0,1,12,13,11/06/2021,0,0,1,1,4,1,1,6,2,1,3,6,0,0,1,1,0,1,0,1
527,136734,2021,Bulgaria,Brazil,0,0,0,0,10/06/2021,0,0,0,0,0,0,0,0,0,0,0,0,0,0,0,0,0,0,0,0
528,136734,2021,Netherlands,Brazil,0,0,9,9,09/06/2021,2,0,0,2,3,1,2,6,4,4,3,11,0,0,0,0,1,1,1,3
529,136734,2021,Brazil,Serbia,1,2,10,13,05/06/2021,0,0,1,1,3,0,2,5,0,6,2,8,2,0,4,6,0,0,0,0
530,136734,2021,Brazil,Japan,0,1,5,6,04/06/2021,0,0,0,0,1,0,0,1,0,2,1,3,0,0,0,0,0,0,0,0
531,142741,2021,Brazil,Poland,0,0,1,1,27/06/2021,0,0,0,0,1,0,0,1,0,0,0,0,0,0,0,0,0,0,0,0
532,142741,2021,Brazil,France,0,0,0,0,26/06/2021,0,0,0,0,0,0,0,0,0,0,0,0,0,0,0,0,0,0,0,0
533,142741,2021,Brazil,Russia,1,2,2,5,23/06/2021,0,0,1,1,2,1,1,4,0,0,1,1,1,0,10,11,2,0,1,3
534,142741,2021,Brazil,Germany,2,3,13,18,22/06/2021,0,0,4,4,8,3,12,23,1,1,2,4,8,0,8,16,6,0,0,6
535,142741,2021,Brazil,Italy,0,0,1,1,21/06/2021,0,0,0,0,0,0,0,0,0,0,0,0,0,0,0,0,0,0,0,0
536,142741,2021,Australia,Brazil,0,0,10,10,17/06/2021,0,0,5,5,10,1,2,13,0,4,2,6,11,2,6,19,2,2,0,4
537,142741,2021,Iran,Brazil,0,2,6,8,16/06/2021,0,0,5,5,5,2,12,19,1,4,0,5,5,4,10,19,3,1,0,4
538,142741,2021,Brazil,Slovenia,3,3,7,13,15/06/2021,0,0,4,4,8,4,11,23,0,2,1,3,5,2,6,13,4,2,1,7
539,142741,2021,Poland,Brazil,0,0,0,0,11/06/2021,0,0,0,0,0,0,0,0,0,0,0,0,0,0,0,0,0,0,0,0
540,142741,2021,Bulgaria,Brazil,0,1,8,9,10/06/2021,0,0,3,3,7,3,3,13,1,3,1,5,5,0,5,10,1,2,0,3
541,142741,2021,Netherlands,Brazil,0,0,0,0,09/06/2021,0,0,0,0,0,0,0,0,0,0,0,0,0,0,0,0,0,0,0,0
542,142741,2021,Brazil,Serbia,1,3,12,16,05/06/2021,0,0,4,4,17,3,10,30,4,2,1,7,8,0,11,19,3,1,1,5
543,142741,2021,Brazil,Japan,2,3,9,14,04/06/2021,0,0,4,4,11,4,5,20,0,1,1,2,2,2,7,11,6,0,1,7
544,142741,2021,Brazil,France,0,1,2,3,03/06/2021,0,0,2,2,6,2,0,8,0,0,1,1,1,0,3,4,1,0,1,2
545,142741,2021,Canada,Brazil,1,1,13,15,30/05/2021,0,0,0,0,20,9,3,32,1,2,3,6,4,0,15,19,3,2,1,6
546,142741,2021,USA,Brazil,0,0,0,0,29/05/2021,0,0,0,0,0,0,0,0,0,0,0,0,0,0,0,0,0,0,0,0
547,142741,2021,Brazil,Argentina,0,1,1,2,28/05/2021,0,0,0,0,6,2,0,8,0,0,0,0,1,0,1,2,1,1,0,2
548,161939,2021,Brazil,Poland,0,0,0,0,27/06/2021,0,0,0,0,0,0,0,0,0,0,0,0,0,0,0,0,0,0,0,0
549,161939,2021,Brazil,France,0,0,0,0,26/06/2021,0,0,0,0,0,0,0,0,0,0,0,0,0,0,0,0,0,0,0,0
550,161939,2021,Brazil,Russia,0,0,0,0,23/06/2021,0,0,0,0,0,0,0,0,0,0,0,0,0,0,0,0,0,0,0,0
551,161939,2021,Brazil,Germany,0,0,0,0,22/06/2021,0,0,0,0,0,0,0,0,0,0,0,0,0,0,0,0,0,0,0,0
552,161939,2021,Brazil,Italy,0,0,0,0,21/06/2021,0,0,0,0,0,0,0,0,0,0,0,0,0,0,0,0,0,0,0,0
553,161939,2021,Australia,Brazil,0,0,0,0,17/06/2021,0,0,0,0,0,0,0,0,0,0,0,0,4,0,1,5,13,2,1,16
554,161939,2021,Iran,Brazil,0,0,0,0,16/06/2021,0,0,0,0,0,0,0,0,0,0,0,0,0,0,0,0,0,0,0,0
555,161939,2021,Brazil,Slovenia,0,0,0,0,15/06/2021,0,0,0,0,0,0,0,0,0,0,0,0,0,0,0,0,0,0,0,0
556,161939,2021,Poland,Brazil,0,0,0,0,11/06/2021,0,0,0,0,0,0,0,0,0,0,0,0,0,0,0,0,0,0,0,0
557,161939,2021,Bulgaria,Brazil,0,0,0,0,10/06/2021,0,0,1,1,0,0,0,0,0,0,0,0,4,0,9,13,7,1,1,9
558,161939,2021,Netherlands,Brazil,0,0,0,0,09/06/2021,0,0,0,0,0,0,0,0,0,0,0,0,0,0,0,0,0,0,1,1
559,161939,2021,Brazil,Serbia,0,0,0,0,05/06/2021,0,0,0,0,0,0,0,0,0,0,0,0,0,0,0,0,3,4,0,7
560,161939,2021,Brazil,Japan,0,0,0,0,04/06/2021,0,0,1,1,0,0,0,0,0,0,0,0,0,0,0,0,4,1,0,5
561,161939,2021,Brazil,France,0,0,0,0,03/06/2021,0,0,0,0,0,0,0,0,0,0,0,0,0,0,0,0,0,0,0,0
562,161939,2021,Canada,Brazil,0,0,0,0,30/05/2021,0,0,0,0,0,0,0,0,0,0,0,0,0,0,0,0,0,0,0,0
563,161939,2021,USA,Brazil,0,0,0,0,29/05/2021,0,0,0,0,0,0,0,0,0,0,0,0,0,0,0,0,0,0,0,0
564,161939,2021,Brazil,Argentina,0,0,0,0,28/05/2021,5,0,0,5,0,0,0,0,0,0,0,0,0,0,0,0,0,0,0,0
565,116081,2021,Brazil,Poland,1,3,14,18,27/06/2021,0,0,0,0,6,1,2,9,0,2,1,3,0,0,0,0,0,0,0,0
566,116081,2021,Brazil,France,0,2,12,14,26/06/2021,0,0,0,0,3,1,3,7,2,1,4,7,0,0,0,0,2,0,1,3
567,116081,2021,Brazil,Russia,0,0,4,4,23/06/2021,0,0,0,0,4,1,1,6,0,5,3,8,0,0,0,0,0,0,0,0
568,116081,2021,Brazil,Germany,0,3,1,4,22/06/2021,0,0,0,0,1,0,4,5,0,1,0,1,0,0,0,0,0,0,0,0
569,116081,2021,Brazil,Italy,1,5,6,12,21/06/2021,0,0,1,1,5,2,7,14,1,7,3,11,0,0,1,1,1,0,0,1
570,118916,2021,Brazil,Poland,0,0,0,0,27/06/2021,0,0,7,7,0,0,0,0,0,0,0,0,7,1,5,13,8,1,1,10
571,118916,2021,Brazil,France,0,0,0,0,26/06/2021,0,0,5,5,0,0,0,0,0,0,0,0,4,1,6,11,8,2,0,10
572,118916,2021,Brazil,Russia,0,0,0,0,23/06/2021,0,0,4,4,0,0,0,0,0,0,0,0,5,1,11,17,4,3,0,7
573,118916,2021,Brazil,Germany,0,0,0,0,22/06/2021,0,0,3,3,0,0,0,0,0,0,0,0,7,1,6,14,10,2,0,12
574,118916,2021,Brazil,Italy,0,0,0,0,21/06/2021,0,1,4,5,0,0,0,0,0,0,0,0,6,0,11,17,13,2,2,17
575,118916,2021,Australia,Brazil,0,0,0,0,17/06/2021,0,0,0,0,0,0,0,0,0,0,0,0,0,0,0,0,0,0,0,0
576,118916,2021,Iran,Brazil,0,0,0,0,16/06/2021,0,0,5,5,0,0,0,0,0,0,0,0,6,0,9,15,13,2,0,15
577,118916,2021,Brazil,Slovenia,0,0,0,0,15/06/2021,0,0,3,3,0,0,0,0,0,0,0,0,8,0,12,20,8,3,1,12
578,118916,2021,Poland,Brazil,0,0,0,0,11/06/2021,0,0,4,4,0,0,0,0,0,0,0,0,5,0,7,12,4,3,0,7
579,118916,2021,Bulgaria,Brazil,0,0,0,0,10/06/2021,0,0,0,0,0,0,0,0,0,0,0,0,0,0,0,0,0,0,0,0
580,118916,2021,Netherlands,Brazil,0,0,0,0,09/06/2021,0,0,2,2,0,0,0,0,0,0,0,0,5,0,12,17,6,1,0,7
581,118916,2021,Brazil,Serbia,0,0,0,0,05/06/2021,0,0,6,6,0,0,0,0,0,0,0,0,7,2,6,15,3,0,0,3
582,118916,2021,Brazil,Japan,0,0,0,0,04/06/2021,0,0,1,1,0,0,0,0,0,0,0,0,8,0,8,16,1,0,0,1
583,118916,2021,Brazil,France,0,0,0,0,03/06/2021,0,0,3,3,0,0,0,0,0,0,0,0,8,1,9,18,9,4,3,16
584,118916,2021,Canada,Brazil,0,0,0,0,30/05/2021,0,0,6,6,0,0,0,0,0,0,0,0,13,0,9,22,7,4,1,12
585,118916,2021,USA,Brazil,0,0,0,0,29/05/2021,0,0,5,5,0,0,0,0,0,0,0,0,6,1,8,15,2,0,1,3
586,118916,2021,Brazil,Argentina,0,0,0,0,28/05/2021,0,0,8,8,0,0,0,0,0,0,0,0,8,0,3,11,7,3,0,10
587,136468,2021,Brazil,Poland,2,4,12,18,27/06/2021,0,0,6,6,10,1,10,21,1,1,3,5,4,0,14,18,12,4,3,19
588,136468,2021,Brazil,France,0,3,6,9,26/06/2021,0,0,1,1,9,5,3,17,0,1,2,3,3,0,18,21,3,3,0,6
589,136468,2021,Brazil,Russia,1,2,7,10,23/06/2021,0,0,3,3,6,3,1,10,0,0,1,1,4,2,13,19,5,2,0,7
590,136468,2021,Brazil,Italy,3,3,15,21,21/06/2021,0,0,7,7,15,3,10,28,3,5,6,14,7,1,16,24,9,4,1,14
591,136468,2021,Iran,Brazil,1,3,18,22,16/06/2021,0,0,4,4,17,5,9,31,2,0,2,4,2,0,10,12,5,1,0,6
592,136468,2021,Brazil,Slovenia,1,1,4,6,15/06/2021,0,0,1,1,1,3,4,8,0,0,0,0,1,1,7,9,1,0,0,1
593,136468,2021,Poland,Brazil,1,3,6,10,11/06/2021,0,0,9,9,14,1,7,22,1,1,0,2,3,0,9,12,6,4,0,10
594,136468,2021,Bulgaria,Brazil,5,3,15,23,10/06/2021,0,0,0,0,10,1,1,12,0,1,1,2,2,0,11,13,6,1,0,7
595,136468,2021,Netherlands,Brazil,0,0,0,0,09/06/2021,0,0,0,0,0,0,1,1,0,0,0,0,0,0,0,0,0,0,0,0
596,136468,2021,Brazil,Serbia,0,3,15,18,05/06/2021,0,0,2,2,14,3,5,22,4,4,3,11,12,2,20,34,7,0,1,8
597,136468,2021,Brazil,Japan,0,0,0,0,04/06/2021,0,0,0,0,0,0,0,0,0,0,0,0,0,0,0,0,0,0,0,0
598,136468,2021,Brazil,France,1,6,10,17,03/06/2021,0,0,0,0,11,5,9,25,0,4,4,8,10,0,18,28,7,2,1,10
599,136468,2021,Canada,Brazil,0,0,2,2,30/05/2021,0,0,0,0,2,0,4,6,0,0,1,1,0,0,3,3,3,0,0,3
600,136468,2021,USA,Brazil,0,3,6,9,29/05/2021,0,0,1,1,10,6,10,26,1,1,0,2,6,1,5,12,0,0,0,0
601,136468,2021,Brazil,Argentina,2,1,10,13,28/05/2021,0,0,0,0,12,2,5,19,0,3,1,4,11,1,10,22,5,2,0,7
602,136947,2021,Brazil,Poland,0,0,0,0,27/06/2021,0,0,0,0,0,0,0,0,0,0,0,0,0,0,0,0,0,0,0,0
603,136947,2021,Brazil,France,0,0,0,0,26/06/2021,0,0,0,0,0,0,0,0,0,0,0,0,0,0,0,0,0,0,0,0
604,136947,2021,Brazil,Russia,0,0,7,7,23/06/2021,0,0,0,0,4,0,2,6,1,1,1,3,0,0,0,0,0,0,0,0
605,136947,2021,Brazil,Germany,0,2,10,12,22/06/2021,0,0,0,0,13,2,7,22,1,3,1,5,1,0,1,2,4,1,0,5
606,136947,2021,Brazil,Italy,0,0,0,0,21/06/2021,0,0,0,0,0,0,1,1,0,0,0,0,0,0,0,0,0,0,0,0
607,136947,2021,Australia,Brazil,0,0,9,9,17/06/2021,0,0,1,1,9,3,7,19,0,2,3,5,0,0,1,1,3,3,1,7
608,136947,2021,Iran,Brazil,0,2,10,12,16/06/2021,0,0,3,3,13,6,12,31,3,2,1,6,0,0,0,0,7,1,0,8
609,136947,2021,Brazil,Slovenia,1,1,1,3,15/06/2021,0,0,0,0,0,2,1,3,0,0,1,1,0,0,0,0,2,0,0,2
610,136947,2021,Poland,Brazil,0,0,0,0,11/06/2021,0,0,2,2,0,0,0,0,0,0,0,0,0,0,0,0,1,0,0,1
611,136947,2021,Bulgaria,Brazil,1,3,6,10,10/06/2021,0,0,2,2,9,0,3,12,0,2,0,2,0,0,0,0,2,2,0,4
612,136947,2021,Netherlands,Brazil,0,0,0,0,09/06/2021,0,0,0,0,1,0,0,1,0,0,0,0,0,0,0,0,0,0,0,0
613,136947,2021,Brazil,Serbia,0,5,8,13,05/06/2021,0,0,0,0,17,2,8,27,2,4,2,8,0,0,0,0,7,2,1,10
614,136947,2021,Brazil,Japan,0,0,0,0,04/06/2021,0,0,0,0,0,0,0,0,0,0,1,1,0,0,0,0,0,0,0,0
615,136947,2021,Brazil,France,0,1,4,5,03/06/2021,0,0,0,0,9,1,2,12,0,4,1,5,0,0,0,0,2,1,2,5
616,136947,2021,Canada,Brazil,0,0,0,0,30/05/2021,0,0,0,0,0,0,0,0,0,0,0,0,0,0,0,0,0,0,0,0
617,136947,2021,USA,Brazil,1,0,5,6,29/05/2021,0,0,1,1,10,2,6,18,1,0,1,2,1,0,0,1,0,0,0,0
618,136956,2021,Brazil,Poland,0,0,0,0,27/06/2021,0,0,0,0,0,0,0,0,0,0,0,0,0,0,0,0,0,0,0,0
619,136956,2021,Brazil,France,0,0,0,0,26/06/2021,0,0,0,0,0,0,0,0,0,0,0,0,0,0,0,0,0,0,0,0
620,136956,2021,Brazil,Russia,0,0,4,4,23/06/2021,0,0,1,1,1,0,1,2,0,0,0,0,0,0,0,0,0,0,0,0
621,136956,2021,Brazil,Germany,0,0,7,7,22/06/2021,0,0,1,1,5,1,2,8,0,1,0,1,0,0,0,0,1,1,0,2
622,136956,2021,Brazil,Italy,0,0,0,0,21/06/2021,0,0,0,0,0,0,0,0,0,0,0,0,0,0,0,0,0,0,0,0
623,136956,2021,Australia,Brazil,0,2,12,14,17/06/2021,0,0,1,1,4,0,0,4,1,4,6,11,0,0,2,2,4,0,0,4
624,136956,2021,Iran,Brazil,0,0,0,0,16/06/2021,0,0,0,0,0,0,0,0,0,0,0,0,0,0,0,0,0,0,0,0
625,136956,2021,Brazil,Slovenia,0,0,12,12,15/06/2021,0,0,1,1,7,1,3,11,2,9,8,19,1,1,0,2,5,1,0,6
626,136956,2021,Poland,Brazil,0,0,0,0,11/06/2021,0,0,0,0,0,0,0,0,0,0,0,0,0,0,0,0,0,0,0,0
627,136956,2021,Bulgaria,Brazil,2,1,8,11,10/06/2021,0,0,0,0,5,0,4,9,3,3,1,7,0,1,0,1,0,1,0,1
628,136956,2021,Netherlands,Brazil,0,1,12,13,09/06/2021,0,0,0,0,5,2,2,9,2,3,2,7,0,0,0,0,3,0,0,3
629,136956,2021,Brazil,Serbia,0,2,7,9,05/06/2021,0,0,0,0,3,1,2,6,0,5,2,7,0,0,0,0,1,0,1,2
630,136956,2021,Brazil,Japan,0,0,9,9,04/06/2021,0,0,5,5,4,2,0,6,0,2,2,4,0,0,0,0,2,0,0,2
631,136956,2021,Brazil,France,0,0,11,11,03/06/2021,0,0,0,0,0,2,5,7,0,6,5,11,0,0,1,1,3,0,0,3
632,136956,2021,Canada,Brazil,1,2,15,18,30/05/2021,0,0,0,0,6,2,6,14,1,4,2,7,1,0,0,1,4,2,0,6
633,136956,2021,USA,Brazil,0,1,13,14,29/05/2021,0,0,0,0,2,2,5,9,0,1,1,2,0,0,1,1,1,0,0,1
634,136956,2021,Brazil,Argentina,1,1,10,12,28/05/2021,0,0,0,0,3,1,2,6,1,1,3,5,0,0,0,0,2,1,0,3
635,174445,2021,Slovenia,Bulgaria,1,2,10,13,23/06/2021,0,0,1,1,8,5,7,20,1,3,1,5,0,0,0,0,0,0,0,0
636,174445,2021,Bulgaria,USA,0,0,1,1,22/06/2021,0,1,0,1,0,3,2,5,0,0,0,0,0,0,0,0,1,0,0,1
637,174445,2021,Japan,Bulgaria,0,0,5,5,21/06/2021,0,0,0,0,6,3,10,19,0,1,0,1,0,0,0,0,4,1,0,5
638,174445,2021,Bulgaria,Russia,0,2,4,6,17/06/2021,0,1,0,1,1,3,6,10,1,1,2,4,0,0,0,0,0,0,0,0
639,174445,2021,Serbia,Bulgaria,0,0,1,1,16/06/2021,0,0,0,0,1,1,2,4,0,0,1,1,0,0,0,0,0,0,0,0
640,174445,2021,Argentina,Bulgaria,0,1,2,3,15/06/2021,0,0,1,1,3,1,4,8,0,0,1,1,0,0,0,0,0,1,0,1
641,174445,2021,Netherlands,Bulgaria,1,0,9,10,11/06/2021,0,0,1,1,14,1,9,24,0,1,2,3,0,0,0,0,0,3,0,3
642,174445,2021,Bulgaria,Brazil,0,2,5,7,10/06/2021,0,0,2,2,7,4,4,15,0,1,1,2,0,2,10,12,2,0,0,2
643,174445,2021,Poland,Bulgaria,1,1,2,4,09/06/2021,0,0,1,1,2,2,2,6,0,0,0,0,1,0,0,1,0,0,0,0
644,174445,2021,Bulgaria,Iran,0,4,6,10,05/06/2021,0,0,4,4,6,2,4,12,0,2,1,3,1,3,13,17,4,1,1,6
645,174445,2021,Canada,Bulgaria,0,1,1,2,04/06/2021,0,0,0,0,0,1,3,4,0,0,0,0,0,2,3,5,1,0,0,1
646,174445,2021,Italy,Bulgaria,0,0,2,2,03/06/2021,0,0,0,0,2,2,1,5,0,0,0,0,0,1,4,5,1,1,0,2
647,174445,2021,Germany,Bulgaria,1,0,1,2,30/05/2021,0,0,0,0,1,0,2,3,0,0,0,0,0,1,1,2,0,1,0,1
648,174445,2021,Australia,Bulgaria,0,1,1,2,29/05/2021,0,0,0,0,0,0,0,0,0,0,0,0,0,0,0,0,0,0,0,0
649,174445,2021,France,Bulgaria,0,3,1,4,28/05/2021,0,0,0,0,6,0,1,7,0,0,0,0,2,2,5,9,0,0,0,0
650,180588,2021,Slovenia,Bulgaria,0,3,3,6,23/06/2021,0,0,0,0,3,0,0,3,3,5,1,9,0,0,0,0,1,0,1,2
651,180588,2021,Bulgaria,USA,0,1,5,6,22/06/2021,0,0,0,0,4,0,2,6,0,4,6,10,0,0,2,2,4,1,0,5
652,180588,2021,Japan,Bulgaria,0,3,8,11,21/06/2021,0,0,0,0,2,0,2,4,1,4,3,8,0,0,1,1,2,0,0,2
653,180588,2021,Bulgaria,Russia,0,2,4,6,17/06/2021,0,0,0,0,0,0,0,0,0,3,2,5,0,0,0,0,1,0,0,1
654,180588,2021,Serbia,Bulgaria,0,4,7,11,16/06/2021,0,0,0,0,5,0,4,9,2,1,0,3,1,0,2,3,2,1,1,4
655,180588,2021,Argentina,Bulgaria,0,2,5,7,15/06/2021,0,0,0,0,4,2,0,6,0,2,2,4,0,0,0,0,3,1,0,4
656,180588,2021,Poland,Bulgaria,0,0,0,0,09/06/2021,0,0,0,0,0,0,0,0,0,0,0,0,0,0,0,0,0,0,0,0
657,180588,2021,Bulgaria,Iran,1,1,11,13,05/06/2021,0,0,0,0,3,0,3,6,1,6,3,10,0,0,0,0,1,1,0,2
658,180588,2021,Canada,Bulgaria,0,3,5,8,04/06/2021,0,0,0,0,3,0,2,5,0,2,1,3,0,0,0,0,2,2,0,4
659,180588,2021,Italy,Bulgaria,0,1,9,10,03/06/2021,0,0,1,1,4,0,3,7,1,2,0,3,0,0,1,1,1,0,0,1
660,180588,2021,Germany,Bulgaria,0,0,1,1,30/05/2021,0,0,0,0,0,0,2,2,0,0,1,1,1,0,0,1,0,0,0,0
661,180588,2021,Australia,Bulgaria,1,2,3,6,29/05/2021,0,0,0,0,0,0,1,1,1,0,3,4,0,0,0,0,1,0,0,1
662,180588,2021,France,Bulgaria,0,0,3,3,28/05/2021,0,0,0,0,0,0,0,0,0,0,0,0,0,0,0,0,0,0,0,0
663,173067,2021,Slovenia,Bulgaria,0,0,7,7,23/06/2021,0,0,2,2,4,0,0,4,2,3,2,7,0,0,1,1,0,0,1,1
664,173067,2021,Bulgaria,USA,0,0,12,12,22/06/2021,0,0,2,2,5,0,2,7,0,4,4,8,0,0,0,0,3,0,1,4
665,173067,2021,Japan,Bulgaria,0,0,6,6,21/06/2021,0,0,1,1,5,0,3,8,3,3,3,9,0,0,2,2,0,1,0,1
666,173067,2021,Bulgaria,Russia,1,1,8,10,17/06/2021,0,0,2,2,6,0,5,11,0,8,5,13,0,0,0,0,1,1,0,2
667,173067,2021,Serbia,Bulgaria,0,0,6,6,16/06/2021,0,0,0,0,1,2,0,3,0,5,2,7,0,0,1,1,0,0,1,1
668,173067,2021,Argentina,Bulgaria,0,0,13,13,15/06/2021,0,0,1,1,5,1,5,11,2,3,0,5,0,0,1,1,0,2,0,2
669,173067,2021,Netherlands,Bulgaria,0,0,12,12,11/06/2021,0,0,1,1,7,0,1,8,1,6,4,11,0,0,0,0,2,0,1,3
670,173067,2021,Bulgaria,Brazil,1,3,6,10,10/06/2021,0,0,0,0,3,0,1,4,0,4,0,4,0,0,1,1,0,0,0,0
671,173067,2021,Poland,Bulgaria,0,0,5,5,09/06/2021,0,0,0,0,1,2,1,4,0,2,0,2,0,0,1,1,0,1,0,1
672,173067,2021,Bulgaria,Iran,0,0,12,12,05/06/2021,0,0,2,2,7,0,6,13,1,6,5,12,0,0,0,0,0,1,0,1
673,173067,2021,Canada,Bulgaria,0,0,0,0,04/06/2021,0,0,0,0,0,0,0,0,0,0,0,0,0,0,0,0,1,0,0,1
674,173067,2021,Italy,Bulgaria,0,0,7,7,03/06/2021,0,0,2,2,3,1,4,8,1,3,1,5,0,0,2,2,2,1,0,3
675,173067,2021,Germany,Bulgaria,0,0,0,0,30/05/2021,0,0,0,0,0,0,0,0,0,0,0,0,0,0,0,0,0,0,0,0
676,173067,2021,Australia,Bulgaria,0,0,0,0,29/05/2021,0,0,0,0,0,0,0,0,0,0,0,0,0,0,0,0,0,0,0,0
677,173067,2021,France,Bulgaria,0,0,0,0,28/05/2021,0,0,0,0,0,0,0,0,0,0,0,0,0,0,0,0,0,0,0,0
678,156676,2021,Slovenia,Bulgaria,0,0,0,0,23/06/2021,0,0,0,0,0,0,0,0,0,0,0,0,0,0,0,0,0,0,0,0
679,156676,2021,Bulgaria,USA,0,0,0,0,22/06/2021,0,0,0,0,0,0,0,0,0,0,0,0,0,0,0,0,0,0,0,0
680,156676,2021,Japan,Bulgaria,1,0,9,10,21/06/2021,0,0,1,1,2,1,7,10,0,2,0,2,4,0,13,17,5,3,0,8
681,156676,2021,Bulgaria,Russia,2,2,9,13,17/06/2021,0,0,3,3,7,5,6,18,0,1,0,1,4,0,13,17,6,4,1,11
682,156676,2021,Serbia,Bulgaria,2,1,8,11,16/06/2021,0,0,2,2,7,2,7,16,1,4,0,5,4,0,11,15,1,1,0,2
683,156676,2021,Argentina,Bulgaria,2,4,9,15,15/06/2021,0,0,1,1,11,3,14,28,1,1,1,3,9,0,10,19,4,1,1,6
684,156676,2021,Netherlands,Bulgaria,0,0,0,0,11/06/2021,0,0,0,0,0,0,0,0,0,0,0,0,0,0,0,0,0,0,0,0
685,156676,2021,Bulgaria,Brazil,0,0,0,0,10/06/2021,0,0,0,0,0,0,0,0,0,0,0,0,0,0,0,0,0,0,0,0
686,156676,2021,Poland,Bulgaria,0,0,0,0,09/06/2021,0,0,0,0,0,0,0,0,0,0,0,0,0,0,0,0,0,0,0,0
687,156676,2021,Bulgaria,Iran,0,0,0,0,05/06/2021,0,0,0,0,0,0,0,0,0,0,0,0,0,0,0,0,0,0,0,0
688,156676,2021,Canada,Bulgaria,0,0,0,0,04/06/2021,0,0,0,0,0,0,0,0,0,0,0,0,0,0,0,0,0,0,0,0
689,156676,2021,Italy,Bulgaria,0,0,0,0,03/06/2021,0,0,0,0,0,0,0,0,0,0,0,0,0,0,0,0,0,0,0,0
690,156676,2021,Germany,Bulgaria,3,5,6,14,30/05/2021,0,0,0,0,6,7,9,22,1,2,0,3,6,2,16,24,5,1,0,6
691,156676,2021,Australia,Bulgaria,1,2,6,9,29/05/2021,0,0,0,0,10,5,5,20,2,1,1,4,9,0,11,20,5,0,1,6
692,156676,2021,France,Bulgaria,2,3,5,10,28/05/2021,0,0,0,0,2,4,8,14,1,2,0,3,2,0,6,8,0,0,0,0
693,162124,2021,Slovenia,Bulgaria,0,1,1,2,23/06/2021,0,0,0,0,0,0,0,0,0,0,0,0,0,0,0,0,0,0,0,0
694,162124,2021,Bulgaria,USA,0,4,7,11,22/06/2021,11,1,49,61,0,1,0,1,1,1,1,3,0,0,0,0,3,1,1,5
695,162124,2021,Japan,Bulgaria,0,1,1,2,21/06/2021,6,0,6,12,0,0,0,0,0,0,0,0,0,0,1,1,0,0,0,0
696,162124,2021,Bulgaria,Russia,0,0,7,7,17/06/2021,5,1,38,44,0,0,0,0,0,3,1,4,0,0,0,0,0,1,0,1
697,162124,2021,Serbia,Bulgaria,0,0,1,1,16/06/2021,1,1,6,8,0,0,0,0,0,0,0,0,0,0,0,0,0,0,0,0
698,162124,2021,Netherlands,Bulgaria,0,1,0,1,11/06/2021,3,0,5,8,0,0,0,0,0,0,1,1,0,0,0,0,1,0,1,2
699,162124,2021,Bulgaria,Brazil,0,0,2,2,10/06/2021,3,0,19,22,0,0,1,1,0,2,0,2,0,0,0,0,1,1,0,2
700,162124,2021,Bulgaria,Iran,2,4,11,17,05/06/2021,26,0,56,82,3,0,0,3,2,2,0,4,0,0,1,1,6,0,1,7
701,162124,2021,Canada,Bulgaria,0,0,0,0,04/06/2021,0,0,0,0,0,0,0,0,0,0,0,0,0,0,0,0,0,0,0,0
702,162124,2021,Italy,Bulgaria,0,1,6,7,03/06/2021,6,0,56,62,0,0,1,1,0,4,6,10,0,0,0,0,3,2,1,6
703,137012,2021,Slovenia,Bulgaria,1,2,5,8,23/06/2021,27,2,32,61,2,1,1,4,1,2,2,5,0,0,0,0,1,2,3,6
704,137012,2021,Bulgaria,USA,0,0,0,0,22/06/2021,1,0,12,13,0,0,0,0,0,0,0,0,0,0,0,0,0,1,0,1
705,137012,2021,Japan,Bulgaria,0,1,8,9,21/06/2021,13,0,44,57,0,1,0,1,2,0,3,5,0,0,0,0,2,3,0,5
706,137012,2021,Bulgaria,Russia,0,0,0,0,17/06/2021,0,0,0,0,0,0,0,0,0,0,0,0,0,0,0,0,0,0,0,0
707,137012,2021,Serbia,Bulgaria,0,1,6,7,16/06/2021,15,1,39,55,1,0,2,3,1,0,1,2,0,0,0,0,3,2,1,6
708,137012,2021,Argentina,Bulgaria,1,4,11,16,15/06/2021,12,1,75,88,1,0,0,1,1,5,3,9,0,0,1,1,5,2,0,7
709,137012,2021,Netherlands,Bulgaria,3,1,12,16,11/06/2021,26,2,45,73,2,0,0,2,1,2,1,4,0,0,0,0,7,0,0,7
710,137012,2021,Bulgaria,Brazil,0,1,4,5,10/06/2021,11,0,22,33,1,0,0,1,0,0,0,0,0,0,0,0,0,0,0,0
711,137012,2021,Poland,Bulgaria,0,1,3,4,09/06/2021,7,0,36,43,1,0,0,1,0,1,0,1,0,0,0,0,0,1,0,1
712,137012,2021,Bulgaria,Iran,0,0,0,0,05/06/2021,0,0,0,0,0,0,0,0,0,0,0,0,0,0,0,0,0,0,0,0
713,137012,2021,Canada,Bulgaria,2,1,16,19,04/06/2021,15,0,53,68,0,0,0,0,0,1,2,3,0,0,0,0,4,3,0,7
714,137012,2021,Italy,Bulgaria,0,0,7,7,03/06/2021,9,0,36,45,1,0,0,1,0,0,0,0,0,0,0,0,1,0,0,1
715,137012,2021,Germany,Bulgaria,0,2,18,20,30/05/2021,31,0,86,117,0,0,1,1,3,3,3,9,0,0,1,1,2,1,3,6
716,137012,2021,Australia,Bulgaria,1,3,6,10,29/05/2021,22,0,46,68,2,0,0,2,0,3,1,4,0,1,1,2,3,2,1,6
717,137012,2021,France,Bulgaria,0,2,13,15,28/05/2021,3,0,66,69,0,1,0,1,1,0,0,1,0,0,0,0,0,0,0,0
718,181285,2021,Slovenia,Bulgaria,0,0,0,0,23/06/2021,0,0,0,0,0,0,0,0,0,0,0,0,0,0,0,0,0,0,0,0
719,181285,2021,Bulgaria,Russia,1,0,2,3,17/06/2021,1,0,16,17,0,0,0,0,0,1,0,1,0,0,0,0,1,1,0,2
720,181285,2021,Serbia,Bulgaria,0,0,1,1,16/06/2021,0,0,0,0,0,0,0,0,0,0,0,0,0,0,0,0,0,1,0,1
721,181285,2021,Argentina,Bulgaria,0,0,0,0,15/06/2021,0,0,4,4,0,0,0,0,0,0,0,0,0,0,0,0,0,0,0,0
722,181285,2021,Poland,Bulgaria,0,0,1,1,09/06/2021,4,0,9,13,0,0,0,0,0,0,0,0,0,0,0,0,1,1,0,2
723,181285,2021,Bulgaria,Iran,0,0,0,0,05/06/2021,0,0,0,0,0,0,0,0,0,0,0,0,0,0,0,0,0,0,0,0
724,181285,2021,Germany,Bulgaria,0,0,0,0,30/05/2021,0,0,0,0,0,0,0,0,0,0,0,0,0,0,0,0,0,0,0,0
725,181285,2021,Australia,Bulgaria,0,0,0,0,29/05/2021,0,0,0,0,0,0,0,0,0,0,0,0,0,0,0,0,0,0,0,0
726,181285,2021,France,Bulgaria,0,0,0,0,28/05/2021,0,0,0,0,0,0,0,0,0,0,0,0,0,0,0,0,0,0,0,0
727,152619,2021,Germany,Bulgaria,0,3,10,13,30/05/2021,1,0,0,1,5,1,4,10,6,5,10,21,3,0,1,4,4,0,1,5
728,152619,2021,Australia,Bulgaria,5,3,6,14,29/05/2021,0,1,0,1,3,0,3,6,1,5,4,10,0,0,1,1,1,0,0,1
729,152619,2021,France,Bulgaria,0,3,6,9,28/05/2021,0,0,2,2,3,3,1,7,0,3,0,3,0,0,0,0,0,0,0,0
730,173010,2021,Slovenia,Bulgaria,0,2,3,5,23/06/2021,0,0,0,0,5,1,7,13,0,1,0,1,5,1,14,20,1,1,0,2
731,173010,2021,Bulgaria,USA,0,0,7,7,22/06/2021,0,0,0,0,7,1,8,16,0,2,4,6,5,1,11,17,3,0,0,3
732,173010,2021,Japan,Bulgaria,0,0,0,0,21/06/2021,0,0,0,0,0,0,0,0,0,0,0,0,0,0,0,0,0,0,0,0
733,173010,2021,Bulgaria,Russia,0,0,0,0,17/06/2021,0,0,0,0,0,0,0,0,0,0,0,0,0,0,0,0,0,0,0,0
734,173010,2021,Serbia,Bulgaria,0,1,2,3,16/06/2021,0,0,0,0,1,0,2,3,1,0,0,1,0,2,6,8,1,0,0,1
735,173010,2021,Argentina,Bulgaria,0,0,0,0,15/06/2021,0,0,0,0,0,0,0,0,0,0,0,0,0,0,0,0,0,0,0,0
736,173010,2021,Netherlands,Bulgaria,0,1,0,1,11/06/2021,0,0,0,0,0,1,0,1,0,2,0,2,1,1,0,2,0,0,0,0
737,173010,2021,Bulgaria,Brazil,0,1,0,1,10/06/2021,0,0,1,1,2,3,0,5,2,0,0,2,1,4,8,13,3,1,1,5
738,173010,2021,Poland,Bulgaria,0,4,4,8,09/06/2021,0,0,0,0,7,3,9,19,2,3,0,5,7,3,16,26,1,1,0,2
739,173010,2021,Bulgaria,Iran,0,4,3,7,05/06/2021,0,0,2,2,8,4,11,23,0,2,4,6,1,1,21,23,7,0,0,7
740,173010,2021,Canada,Bulgaria,0,0,1,1,04/06/2021,0,0,0,0,1,0,0,1,0,0,0,0,2,0,4,6,0,1,1,2
741,173010,2021,Italy,Bulgaria,0,1,3,4,03/06/2021,0,0,1,1,2,2,1,5,0,3,0,3,2,1,7,10,1,0,0,1
742,173010,2021,Germany,Bulgaria,0,0,2,2,30/05/2021,0,0,0,0,1,1,1,3,0,2,0,2,0,0,6,6,1,0,0,1
743,173010,2021,Australia,Bulgaria,0,0,0,0,29/05/2021,0,0,0,0,0,0,0,0,0,0,0,0,0,0,0,0,0,0,0,0
744,173010,2021,France,Bulgaria,0,1,2,3,28/05/2021,0,0,0,0,3,1,2,6,0,1,0,1,7,2,7,16,0,0,0,0
745,168269,2021,Slovenia,Bulgaria,0,4,5,9,23/06/2021,0,0,1,1,10,6,1,17,0,2,1,3,10,1,14,25,1,1,1,3
746,168269,2021,Bulgaria,USA,0,0,1,1,22/06/2021,0,0,0,0,2,0,1,3,0,0,0,0,0,0,4,4,0,0,0,0
747,168269,2021,Japan,Bulgaria,1,2,4,7,21/06/2021,0,0,0,0,14,3,6,23,2,2,2,6,3,3,14,20,3,3,0,6
748,168269,2021,Bulgaria,Russia,0,2,4,6,17/06/2021,0,0,1,1,9,1,7,17,1,3,3,7,5,4,12,21,2,1,0,3
749,168269,2021,Serbia,Bulgaria,1,2,5,8,16/06/2021,0,0,3,3,4,2,6,12,0,3,1,4,3,5,12,20,1,1,1,3
750,168269,2021,Argentina,Bulgaria,0,0,4,4,15/06/2021,0,0,1,1,2,0,4,6,0,2,0,2,4,0,5,9,1,1,0,2
751,168269,2021,Netherlands,Bulgaria,1,3,12,16,11/06/2021,0,0,4,4,9,2,9,20,2,2,3,7,7,5,21,33,7,4,0,11
752,168269,2021,Bulgaria,Brazil,0,0,6,6,10/06/2021,0,0,3,3,8,1,3,12,0,1,0,1,2,1,7,10,2,2,0,4
753,168269,2021,Poland,Bulgaria,0,2,3,5,09/06/2021,0,0,1,1,8,0,7,15,0,1,0,1,7,2,4,13,1,1,0,2
754,168269,2021,Bulgaria,Iran,1,2,3,6,05/06/2021,0,0,1,1,3,4,5,12,0,1,1,2,1,1,5,7,2,2,0,4
755,168269,2021,Canada,Bulgaria,0,4,4,8,04/06/2021,0,0,3,3,6,2,5,13,1,3,2,6,5,3,11,19,2,3,0,5
756,168269,2021,Italy,Bulgaria,1,2,12,15,03/06/2021,0,0,3,3,16,2,13,31,2,1,4,7,16,1,20,37,6,4,0,10
757,168269,2021,Germany,Bulgaria,3,4,13,20,30/05/2021,0,0,0,0,7,6,11,24,0,2,1,3,8,3,19,30,7,0,0,7
758,168269,2021,Australia,Bulgaria,3,3,8,14,29/05/2021,0,0,0,0,5,2,6,13,0,2,3,5,6,0,9,15,5,0,1,6
759,168269,2021,France,Bulgaria,0,0,4,4,28/05/2021,0,0,1,1,3,0,2,5,0,0,0,0,3,0,6,9,0,0,0,0
760,152624,2021,Slovenia,Bulgaria,0,2,1,3,23/06/2021,0,0,0,0,1,0,6,7,0,1,0,1,2,1,8,11,1,0,0,1
761,152624,2021,Bulgaria,USA,0,2,5,7,22/06/2021,0,0,1,1,8,5,7,20,1,2,0,3,5,2,12,19,1,1,1,3
762,152624,2021,Japan,Bulgaria,0,0,1,1,21/06/2021,0,0,0,0,1,0,2,3,0,1,0,1,1,0,4,5,1,0,0,1
763,152624,2021,Bulgaria,Russia,0,0,0,0,17/06/2021,0,0,0,0,0,0,0,0,0,0,0,0,0,0,0,0,0,0,0,0
764,152624,2021,Serbia,Bulgaria,0,0,0,0,16/06/2021,0,0,0,0,1,0,0,1,0,1,0,1,0,0,1,1,1,0,0,1
765,152624,2021,Argentina,Bulgaria,0,0,1,1,15/06/2021,0,0,0,0,0,1,0,1,0,0,0,0,0,0,2,2,0,0,0,0
766,152624,2021,Netherlands,Bulgaria,0,1,3,4,11/06/2021,0,0,0,0,0,0,0,0,0,0,0,0,0,0,0,0,0,1,0,1
767,152624,2021,Bulgaria,Brazil,0,0,3,3,10/06/2021,0,0,0,0,0,1,1,2,0,0,0,0,2,0,2,4,0,0,0,0
768,152624,2021,Poland,Bulgaria,0,0,2,2,09/06/2021,0,0,0,0,0,0,0,0,0,1,0,1,0,0,0,0,0,0,0,0
769,118484,2021,Slovenia,Bulgaria,0,0,0,0,23/06/2021,0,0,6,6,0,0,0,0,0,0,0,0,1,0,7,8,5,1,0,6
770,118484,2021,Bulgaria,USA,0,0,0,0,22/06/2021,0,0,0,0,0,0,0,0,0,0,0,0,0,0,0,0,0,0,0,0
771,118484,2021,Japan,Bulgaria,0,0,0,0,21/06/2021,0,0,8,8,0,0,0,0,0,0,0,0,3,0,10,13,8,5,0,13
772,118484,2021,Bulgaria,Russia,0,0,0,0,17/06/2021,0,0,2,2,0,0,0,0,0,0,0,0,1,1,5,7,3,2,0,5
773,118484,2021,Serbia,Bulgaria,0,0,0,0,16/06/2021,0,0,4,4,0,0,0,0,0,0,0,0,5,2,11,18,5,4,1,10
774,118484,2021,Argentina,Bulgaria,0,0,0,0,15/06/2021,0,0,4,4,0,0,0,0,0,0,0,0,4,2,11,17,12,6,2,20
775,118484,2021,Netherlands,Bulgaria,0,0,0,0,11/06/2021,0,0,10,10,0,0,0,0,0,0,0,0,5,3,16,24,9,6,1,16
776,118484,2021,Bulgaria,Brazil,0,0,0,0,10/06/2021,0,0,2,2,0,0,0,0,0,0,0,0,3,2,5,10,5,4,0,9
777,118484,2021,Poland,Bulgaria,0,0,0,0,09/06/2021,0,0,6,6,0,0,0,0,0,0,0,0,8,2,5,15,4,2,1,7
778,118484,2021,Canada,Bulgaria,0,0,0,0,04/06/2021,0,0,10,10,0,0,0,0,0,0,0,0,6,1,13,20,10,2,0,12
779,118484,2021,Italy,Bulgaria,0,0,0,0,03/06/2021,0,0,2,2,0,0,0,0,0,0,0,0,4,0,6,10,5,6,0,11
780,118484,2021,Germany,Bulgaria,0,0,0,0,30/05/2021,0,0,3,3,0,0,0,0,0,0,0,0,6,2,11,19,14,1,0,15
781,118484,2021,Australia,Bulgaria,0,0,0,0,29/05/2021,0,0,4,4,0,0,0,0,0,0,0,0,4,0,9,13,5,0,1,6
782,118484,2021,France,Bulgaria,0,0,0,0,28/05/2021,0,0,5,5,0,0,0,0,0,0,0,0,8,0,5,13,8,0,2,10
783,118488,2021,Netherlands,Bulgaria,0,0,0,0,11/06/2021,0,0,0,0,0,0,0,0,0,0,0,0,0,0,0,0,0,0,0,0
784,118488,2021,Bulgaria,Brazil,0,0,0,0,10/06/2021,0,0,0,0,0,0,0,0,0,0,0,0,0,0,0,0,0,0,0,0
785,118488,2021,Bulgaria,Iran,0,0,0,0,05/06/2021,0,0,0,0,0,0,0,0,0,0,0,0,0,0,0,0,0,0,0,0
786,118488,2021,Canada,Bulgaria,2,4,6,12,04/06/2021,0,0,1,1,20,8,11,39,1,4,1,6,0,0,3,3,5,1,1,7
787,118488,2021,Italy,Bulgaria,0,0,0,0,03/06/2021,0,0,0,0,0,0,0,0,0,0,0,0,0,0,0,0,0,0,0,0
788,118488,2021,Germany,Bulgaria,1,5,11,17,30/05/2021,0,0,0,0,23,7,13,43,2,4,1,7,0,0,0,0,7,2,3,12
789,118488,2021,Australia,Bulgaria,2,4,8,14,29/05/2021,0,0,0,0,10,6,11,27,0,3,1,4,0,0,0,0,3,1,0,4
790,118488,2021,France,Bulgaria,2,3,8,13,28/05/2021,0,0,0,0,15,5,11,31,2,1,0,3,0,0,0,0,0,0,0,0
791,162123,2021,Slovenia,Bulgaria,0,0,3,3,23/06/2021,0,0,0,0,1,1,2,4,1,3,0,4,0,0,0,0,1,0,1,2
792,162123,2021,Bulgaria,USA,0,0,0,0,22/06/2021,0,0,0,0,0,0,0,0,0,0,0,0,0,0,0,0,0,0,0,0
793,162123,2021,Japan,Bulgaria,0,0,0,0,21/06/2021,0,0,0,0,0,0,0,0,0,0,0,0,0,0,0,0,0,0,0,0
794,162123,2021,Argentina,Bulgaria,0,1,1,2,15/06/2021,0,0,1,1,0,0,2,2,0,1,0,1,0,0,0,0,2,0,0,2
795,162123,2021,Netherlands,Bulgaria,0,3,11,14,11/06/2021,0,0,0,0,6,0,4,10,1,6,6,13,0,0,0,0,1,0,0,1
796,162123,2021,Bulgaria,Brazil,0,2,4,6,10/06/2021,0,0,0,0,1,1,4,6,1,1,3,5,1,0,0,1,1,0,0,1
797,162123,2021,Poland,Bulgaria,0,2,6,8,09/06/2021,0,0,1,1,2,1,0,3,0,0,0,0,0,0,0,0,1,1,0,2
798,162123,2021,Bulgaria,Iran,0,0,0,0,05/06/2021,0,0,0,0,0,0,0,0,0,2,0,2,0,0,0,0,0,0,0,0
799,162123,2021,Canada,Bulgaria,0,0,11,11,04/06/2021,0,0,1,1,4,3,3,10,2,1,1,4,0,0,0,0,1,2,0,3
800,162123,2021,Italy,Bulgaria,0,1,17,18,03/06/2021,0,0,0,0,8,1,2,11,1,9,0,10,0,1,0,1,0,0,0,0
801,162123,2021,Germany,Bulgaria,1,3,14,18,30/05/2021,0,0,0,0,7,1,3,11,2,7,4,13,0,0,0,0,1,1,0,2
802,162123,2021,Australia,Bulgaria,0,1,4,5,29/05/2021,0,0,0,0,4,1,0,5,1,4,0,5,0,0,0,0,0,0,2,2
803,162123,2021,France,Bulgaria,0,2,8,10,28/05/2021,0,0,1,1,4,1,0,5,1,0,2,3,0,0,1,1,1,0,0,1
804,173009,2021,Slovenia,Bulgaria,0,0,0,0,23/06/2021,0,0,0,0,0,0,0,0,0,0,0,0,0,0,0,0,0,0,0,0
805,173009,2021,Bulgaria,USA,0,0,0,0,22/06/2021,0,0,1,1,0,0,0,0,0,0,0,0,4,1,14,19,5,3,1,9
806,173009,2021,Japan,Bulgaria,0,0,0,0,21/06/2021,0,0,0,0,0,0,0,0,0,0,0,0,0,0,0,0,0,0,0,0
807,173009,2021,Bulgaria,Russia,0,0,0,0,17/06/2021,0,0,0,0,0,0,0,0,0,0,0,0,3,1,3,7,3,0,0,3
808,173009,2021,Serbia,Bulgaria,0,0,0,0,16/06/2021,0,0,0,0,0,0,0,0,0,0,0,0,0,0,0,0,0,0,0,0
809,173009,2021,Argentina,Bulgaria,0,0,0,0,15/06/2021,0,0,0,0,0,0,0,0,0,0,0,0,0,0,0,0,0,0,0,0
810,173009,2021,Netherlands,Bulgaria,0,0,0,0,11/06/2021,0,0,0,0,0,0,0,0,0,0,0,0,0,0,0,0,0,0,0,0
811,173009,2021,Bulgaria,Brazil,0,0,0,0,10/06/2021,0,0,2,2,0,0,0,0,0,0,0,0,0,0,2,2,0,0,0,0
812,173009,2021,Poland,Bulgaria,0,0,0,0,09/06/2021,0,0,0,0,0,0,0,0,0,0,0,0,0,0,0,0,0,0,0,0
813,173009,2021,Bulgaria,Iran,0,0,0,0,05/06/2021,0,0,1,1,0,0,0,0,0,0,0,0,5,0,14,19,9,0,0,9
814,173009,2021,Canada,Bulgaria,0,0,0,0,04/06/2021,0,0,0,0,0,0,0,0,0,0,0,0,0,0,0,0,0,0,0,0
815,173009,2021,Italy,Bulgaria,0,0,0,0,03/06/2021,0,0,2,2,0,0,0,0,0,0,0,0,2,0,11,13,6,0,2,8
816,173009,2021,Germany,Bulgaria,0,0,0,0,30/05/2021,0,0,0,0,0,0,0,0,0,0,0,0,0,0,0,0,0,0,0,0
817,173009,2021,Australia,Bulgaria,0,0,0,0,29/05/2021,0,0,0,0,0,0,0,0,0,0,0,0,0,0,0,0,0,0,0,0
818,173009,2021,France,Bulgaria,0,0,0,0,28/05/2021,0,0,0,0,0,0,0,0,0,0,0,0,0,0,0,0,0,0,0,0
819,150277,2021,Slovenia,Bulgaria,0,1,1,2,23/06/2021,0,0,0,0,0,2,0,2,0,0,0,0,0,0,0,0,0,0,0,0
820,150277,2021,Bulgaria,USA,0,2,6,8,22/06/2021,0,0,1,1,4,9,8,21,0,4,3,7,0,0,0,0,2,2,0,4
821,150277,2021,Japan,Bulgaria,0,1,2,3,21/06/2021,0,0,0,0,3,3,4,10,0,0,0,0,0,0,0,0,0,1,0,1
822,150277,2021,Bulgaria,Russia,1,1,4,6,17/06/2021,0,0,0,0,1,3,5,9,1,0,2,3,0,0,0,0,3,0,0,3
823,150277,2021,Serbia,Bulgaria,0,1,5,6,16/06/2021,0,0,0,0,11,5,5,21,2,0,1,3,0,0,0,0,4,2,1,7
824,150277,2021,Argentina,Bulgaria,0,4,6,10,15/06/2021,0,0,1,1,11,4,5,20,2,3,5,10,0,0,0,0,2,3,0,5
825,150277,2021,Netherlands,Bulgaria,0,4,3,7,11/06/2021,0,0,1,1,7,2,7,16,1,4,2,7,0,0,0,0,2,2,0,4
826,150277,2021,Bulgaria,Brazil,0,2,3,5,10/06/2021,0,0,0,0,7,4,3,14,1,1,1,3,0,0,0,0,0,0,0,0
827,150277,2021,Poland,Bulgaria,0,3,5,8,09/06/2021,0,0,1,1,6,6,4,16,0,0,1,1,0,0,0,0,0,3,0,3
828,150277,2021,Bulgaria,Iran,0,4,5,9,05/06/2021,0,0,1,1,10,8,11,29,1,2,1,4,0,0,1,1,6,1,0,7
829,150277,2021,Canada,Bulgaria,0,0,0,0,04/06/2021,0,0,0,0,0,0,0,0,0,0,0,0,0,0,0,0,0,0,0,0
830,150277,2021,Italy,Bulgaria,1,5,10,16,03/06/2021,0,0,1,1,17,8,10,35,4,1,3,8,0,0,0,0,4,3,2,9
831,150277,2021,Germany,Bulgaria,1,2,1,4,30/05/2021,0,0,0,0,5,0,0,5,0,1,0,1,0,1,0,1,2,0,0,2
832,150277,2021,Australia,Bulgaria,0,0,0,0,29/05/2021,0,0,0,0,0,0,0,0,0,0,0,0,0,0,0,0,0,0,0,0
833,150277,2021,France,Bulgaria,0,0,0,0,28/05/2021,0,0,0,0,0,0,0,0,0,0,0,0,0,0,0,0,0,0,0,0
834,164812,2021,Bulgaria,USA,0,0,0,0,22/06/2021,0,0,0,0,0,0,1,1,0,0,0,0,0,1,1,2,0,0,0,0
835,164812,2021,Japan,Bulgaria,0,1,2,3,21/06/2021,0,0,0,0,1,1,2,4,0,1,0,1,0,0,7,7,0,2,0,2
836,164812,2021,Bulgaria,Russia,0,0,0,0,17/06/2021,0,0,0,0,0,0,0,0,0,0,0,0,0,0,0,0,0,0,0,0
837,164812,2021,Serbia,Bulgaria,0,0,0,0,16/06/2021,0,0,0,0,0,0,0,0,0,0,0,0,0,0,0,0,0,0,0,0
838,164812,2021,Argentina,Bulgaria,1,0,10,11,15/06/2021,0,0,0,0,8,0,11,19,1,1,0,2,7,4,11,22,0,1,0,1
839,164812,2021,Netherlands,Bulgaria,2,1,15,18,11/06/2021,0,0,2,2,8,4,9,21,3,2,1,6,5,1,15,21,3,2,1,6
840,164812,2021,Bulgaria,Brazil,0,1,5,6,10/06/2021,0,0,2,2,2,1,3,6,0,0,0,0,3,1,6,10,3,1,0,4
841,164812,2021,Poland,Bulgaria,0,0,2,2,09/06/2021,0,0,0,0,0,0,1,1,0,0,0,0,0,1,2,3,0,1,0,1
842,164812,2021,Bulgaria,Iran,0,0,0,0,05/06/2021,0,0,0,0,0,0,0,0,0,0,0,0,0,0,0,0,0,0,0,0
843,164812,2021,Canada,Bulgaria,0,2,3,5,04/06/2021,0,0,0,0,5,1,5,11,0,2,1,3,6,1,6,13,2,0,0,2
844,164812,2021,Italy,Bulgaria,0,1,7,8,03/06/2021,0,0,0,0,7,2,4,13,0,1,1,2,4,3,5,12,2,2,0,4
845,136299,2021,Japan,Canada,0,0,12,12,17/06/2021,28,1,35,64,0,0,3,3,0,1,2,3,0,0,0,0,9,1,2,12
846,136299,2021,Canada,Poland,0,2,9,11,15/06/2021,15,1,47,63,0,0,0,0,0,4,2,6,0,0,0,0,6,0,0,6
847,136299,2021,Canada,France,0,1,12,13,11/06/2021,26,2,73,101,1,0,1,2,3,3,2,8,0,0,0,0,7,1,0,8
848,136299,2021,Russia,Canada,0,0,0,0,10/06/2021,0,0,0,0,0,0,0,0,0,0,0,0,0,0,0,0,0,0,0,0
849,136299,2021,Slovenia,Canada,1,2,8,11,09/06/2021,9,1,49,59,0,0,0,0,0,1,0,1,0,0,0,0,2,3,0,5
850,136299,2021,Canada,Italy,0,1,3,4,05/06/2021,4,0,22,26,0,0,0,0,0,0,2,2,0,0,0,0,2,0,1,3
851,136299,2021,Canada,Bulgaria,0,0,11,11,04/06/2021,17,0,42,59,0,0,0,0,0,1,1,2,0,0,1,1,2,1,1,4
852,136299,2021,Iran,Canada,0,0,3,3,03/06/2021,12,1,18,31,0,0,0,0,0,1,0,1,0,0,0,0,1,2,0,3
853,124556,2021,Canada,Serbia,1,3,19,23,23/06/2021,0,0,4,4,11,3,16,30,2,4,5,11,10,4,15,29,9,2,0,11
854,124556,2021,Canada,Australia,0,0,0,0,22/06/2021,0,0,0,0,0,0,0,0,0,0,0,0,0,0,0,0,0,0,0,0
855,124556,2021,Canada,Netherlands,0,2,6,8,21/06/2021,0,0,1,1,11,2,7,20,0,2,1,3,6,0,7,13,7,2,1,10
856,124556,2021,Japan,Canada,2,2,12,16,17/06/2021,0,0,6,6,12,1,9,22,0,1,2,3,7,1,12,20,4,2,1,7
857,124556,2021,Canada,Poland,1,2,9,12,15/06/2021,0,0,2,2,7,1,7,15,1,1,1,3,3,2,12,17,3,4,2,9
858,124556,2021,Canada,France,1,4,10,15,11/06/2021,0,0,4,4,12,6,12,30,2,1,4,7,8,1,16,25,5,1,0,6
859,124556,2021,Russia,Canada,0,0,0,0,10/06/2021,0,0,1,1,0,0,0,0,0,0,0,0,0,0,0,0,0,0,0,0
860,124556,2021,Slovenia,Canada,0,2,14,16,09/06/2021,0,0,1,1,10,1,12,23,0,1,1,2,4,1,7,12,3,5,1,9
861,124556,2021,Canada,Italy,0,0,3,3,05/06/2021,0,0,2,2,9,1,8,18,1,2,1,4,3,2,2,7,1,0,0,1
862,124556,2021,Canada,Bulgaria,1,3,12,16,04/06/2021,0,0,4,4,8,1,8,17,2,3,2,7,1,1,11,13,7,1,0,8
863,124556,2021,Iran,Canada,0,3,16,19,03/06/2021,0,0,5,5,13,3,8,24,3,5,1,9,5,1,18,24,3,2,1,6
864,124556,2021,Argentina,Canada,1,3,9,13,29/05/2021,0,1,0,1,10,1,7,18,1,2,1,4,4,1,8,13,9,0,0,9
865,124556,2021,USA,Canada,0,1,8,9,28/05/2021,0,1,0,1,6,0,12,18,0,2,2,4,3,1,9,13,4,1,0,5
866,139429,2021,Canada,Serbia,0,1,8,9,23/06/2021,0,0,4,4,1,3,10,14,6,0,2,8,3,1,4,8,9,0,0,9
867,139429,2021,Canada,Australia,0,1,6,7,22/06/2021,0,0,1,1,2,1,1,4,0,2,0,2,1,0,2,3,2,0,0,2
868,139429,2021,Canada,Netherlands,0,0,0,0,21/06/2021,0,0,0,0,0,0,0,0,0,0,0,0,0,0,0,0,0,0,0,0
869,139429,2021,Japan,Canada,0,0,0,0,17/06/2021,0,0,0,0,0,0,0,0,0,0,0,0,0,0,0,0,0,0,0,0
870,139429,2021,Canada,Germany,0,0,0,0,16/06/2021,0,0,0,0,0,0,0,0,0,0,0,0,1,0,1,2,0,0,0,0
871,139429,2021,Canada,Poland,0,0,0,0,15/06/2021,0,0,4,4,0,0,0,0,0,0,0,0,2,2,18,22,5,1,1,7
872,139429,2021,Canada,France,0,0,0,0,11/06/2021,0,0,3,3,0,0,0,0,0,0,0,0,14,1,14,29,14,2,2,18
873,139429,2021,Russia,Canada,0,0,0,0,10/06/2021,0,0,3,3,0,0,0,0,0,0,0,0,11,3,15,29,10,5,0,15
874,139429,2021,Slovenia,Canada,0,0,0,0,09/06/2021,0,0,2,2,0,0,0,0,0,0,0,0,5,2,8,15,2,4,1,7
875,139429,2021,Canada,Italy,0,0,0,0,05/06/2021,0,0,0,0,0,0,0,0,0,0,0,0,0,0,0,0,0,0,0,0
876,139429,2021,Canada,Bulgaria,0,0,0,0,04/06/2021,0,0,0,0,0,0,0,0,0,0,0,0,0,0,0,0,0,0,0,0
877,139429,2021,Iran,Canada,0,1,8,9,03/06/2021,0,0,0,0,0,2,2,4,0,1,1,2,1,0,5,6,3,0,1,4
878,139429,2021,Canada,Brazil,0,0,0,0,30/05/2021,0,0,0,0,0,0,0,0,0,0,0,0,1,0,3,4,2,1,0,3
879,136291,2021,Canada,Serbia,0,0,0,0,23/06/2021,0,0,1,1,0,0,0,0,0,0,0,0,0,0,0,0,0,0,0,0
880,136291,2021,Canada,Australia,2,0,10,12,22/06/2021,0,0,3,3,4,1,3,8,0,0,3,3,4,0,6,10,5,1,1,7
881,136291,2021,Canada,Netherlands,4,3,8,15,21/06/2021,0,1,1,2,6,6,5,17,1,2,6,9,5,0,8,13,5,0,0,5
882,136291,2021,Japan,Canada,0,0,0,0,17/06/2021,0,0,0,0,0,0,0,0,0,0,0,0,0,0,0,0,0,0,0,0
883,136291,2021,Canada,Germany,0,3,11,14,16/06/2021,0,0,4,4,9,4,6,19,1,0,0,1,5,2,8,15,2,3,1,6
884,136291,2021,Canada,Poland,1,4,4,9,15/06/2021,0,0,3,3,9,3,10,22,1,3,4,8,1,0,16,17,1,2,2,5
885,136291,2021,Canada,France,0,1,2,3,11/06/2021,0,0,0,0,3,1,3,7,0,0,1,1,0,0,1,1,1,1,0,2
886,136291,2021,Russia,Canada,2,4,10,16,10/06/2021,0,0,3,3,10,5,8,23,1,1,1,3,8,2,17,27,4,3,0,7
887,136291,2021,Slovenia,Canada,1,3,4,8,09/06/2021,0,0,1,1,14,3,6,23,1,3,0,4,4,2,22,28,2,0,1,3
888,136291,2021,Canada,Italy,1,5,16,22,05/06/2021,0,0,7,7,16,10,16,42,1,2,0,3,16,0,18,34,5,0,1,6
889,136291,2021,Canada,Bulgaria,4,2,11,17,04/06/2021,0,0,1,1,12,3,7,22,0,1,1,2,5,1,14,20,2,2,3,7
890,136291,2021,Iran,Canada,0,1,4,5,03/06/2021,0,0,1,1,0,0,0,0,0,0,0,0,0,0,0,0,0,0,0,0
891,136291,2021,Canada,Brazil,0,3,10,13,30/05/2021,0,0,0,0,7,5,9,21,1,0,1,2,10,3,15,28,5,2,0,7
892,136291,2021,Argentina,Canada,2,3,6,11,29/05/2021,0,0,0,0,5,4,7,16,2,3,1,6,5,0,5,10,4,2,0,6
893,136291,2021,USA,Canada,0,0,2,2,28/05/2021,0,0,0,0,0,0,1,1,0,0,0,0,0,0,0,0,0,0,0,0
894,157334,2021,Japan,Canada,0,0,0,0,17/06/2021,0,0,0,0,0,0,0,0,0,0,0,0,0,0,0,0,0,0,0,0
895,157334,2021,Canada,Germany,0,0,0,0,16/06/2021,0,0,0,0,0,0,0,0,0,0,0,0,0,0,0,0,0,0,0,0
896,157334,2021,Canada,Poland,0,0,0,0,15/06/2021,0,0,0,0,0,0,0,0,0,0,0,0,0,0,0,0,0,0,0,0
897,157334,2021,Canada,France,0,0,0,0,11/06/2021,0,0,0,0,0,0,0,0,0,0,0,0,0,0,0,0,0,0,0,0
898,157334,2021,Russia,Canada,0,0,0,0,10/06/2021,0,0,0,0,0,0,0,0,0,0,0,0,0,0,0,0,1,0,0,1
899,157334,2021,Slovenia,Canada,0,0,0,0,09/06/2021,0,0,0,0,0,0,0,0,0,0,0,0,0,0,0,0,0,0,0,0
900,157334,2021,Canada,Italy,0,0,0,0,05/06/2021,0,0,0,0,0,0,0,0,0,0,0,0,0,0,0,0,0,0,0,0
901,157334,2021,Canada,Bulgaria,0,0,0,0,04/06/2021,0,0,0,0,0,0,0,0,0,0,0,0,0,0,0,0,0,0,0,0
902,157334,2021,Iran,Canada,0,0,0,0,03/06/2021,0,0,0,0,0,0,0,0,0,0,0,0,0,0,0,0,0,0,0,0
903,157334,2021,Canada,Brazil,0,0,0,0,30/05/2021,0,0,2,2,0,0,0,0,0,0,0,0,0,0,0,0,5,4,1,10
904,157334,2021,Argentina,Canada,0,0,0,0,29/05/2021,0,0,0,0,0,0,0,0,0,0,0,0,0,0,0,0,0,0,0,0
905,157334,2021,USA,Canada,0,0,0,0,28/05/2021,0,0,0,0,0,0,0,0,0,0,0,0,0,0,0,0,0,0,0,0
906,140061,2021,Canada,Serbia,0,0,3,3,23/06/2021,0,1,3,4,2,2,8,12,1,2,1,4,4,3,6,13,1,0,1,2
907,140061,2021,Canada,Australia,1,5,6,12,22/06/2021,0,0,3,3,10,1,9,20,2,1,2,5,5,0,4,9,5,0,0,5
908,140061,2021,Canada,Netherlands,0,0,0,0,21/06/2021,0,0,0,0,1,0,0,1,0,0,0,0,0,0,0,0,1,0,0,1
909,140061,2021,Japan,Canada,1,2,7,10,17/06/2021,0,0,1,1,8,3,10,21,2,2,2,6,2,0,11,13,5,2,3,10
910,140061,2021,Canada,Germany,0,3,5,8,16/06/2021,0,0,2,2,10,1,10,21,1,2,0,3,4,1,14,19,2,0,1,3
911,140061,2021,Canada,Poland,0,0,0,0,15/06/2021,0,0,0,0,1,2,1,4,0,0,0,0,0,0,0,0,1,0,0,1
912,140061,2021,Slovenia,Canada,0,0,0,0,09/06/2021,0,0,0,0,0,0,0,0,0,0,0,0,0,0,0,0,0,0,0,0
913,140061,2021,Canada,Brazil,0,0,0,0,30/05/2021,0,0,0,0,0,0,0,0,0,0,0,0,0,0,0,0,0,0,0,0
914,140061,2021,Argentina,Canada,0,0,0,0,29/05/2021,0,0,0,0,0,0,0,0,0,0,0,0,0,0,0,0,0,0,0,0
915,140061,2021,USA,Canada,0,4,1,5,28/05/2021,0,0,0,0,8,5,5,18,1,0,1,2,2,1,10,13,5,1,0,6
916,124553,2021,Canada,Serbia,0,0,18,18,23/06/2021,20,0,79,99,0,1,4,5,0,4,1,5,0,0,0,0,9,2,2,13
917,124553,2021,Canada,Australia,0,1,10,11,22/06/2021,22,1,30,53,2,0,2,4,0,1,2,3,0,0,0,0,8,3,1,12
918,124553,2021,Canada,Netherlands,0,2,13,15,21/06/2021,20,2,35,57,1,0,0,1,1,0,2,3,0,0,1,1,3,0,2,5
919,124553,2021,Japan,Canada,0,0,0,0,17/06/2021,0,0,0,0,0,0,0,0,0,0,0,0,0,0,0,0,0,0,0,0
920,124553,2021,Canada,Germany,1,1,15,17,16/06/2021,8,0,51,59,2,0,1,3,0,2,0,2,0,0,0,0,9,2,0,11
921,124553,2021,Canada,Poland,0,0,0,0,15/06/2021,2,0,4,6,0,0,0,0,0,0,0,0,0,0,0,0,1,0,0,1
922,124553,2021,Canada,France,0,0,0,0,11/06/2021,0,0,0,0,0,0,0,0,0,0,0,0,0,0,0,0,0,0,0,0
923,124553,2021,Russia,Canada,0,2,10,12,10/06/2021,19,0,68,87,1,0,2,3,1,1,0,2,0,1,1,2,5,6,1,12
924,124553,2021,Slovenia,Canada,0,0,1,1,09/06/2021,0,0,3,3,0,0,0,0,0,0,0,0,0,0,0,0,0,0,0,0
925,124553,2021,Canada,Italy,1,1,10,12,05/06/2021,23,0,62,85,1,0,3,4,0,3,2,5,0,0,0,0,5,5,1,11
926,124553,2021,Iran,Canada,0,2,7,9,03/06/2021,25,0,28,53,2,0,1,3,0,1,0,1,0,0,1,1,6,1,0,7
927,124553,2021,Canada,Brazil,0,0,0,0,30/05/2021,0,0,0,0,0,0,0,0,0,0,0,0,0,0,0,0,0,0,0,0
928,124553,2021,Argentina,Canada,0,0,0,0,29/05/2021,0,0,0,0,0,0,0,0,0,0,0,0,0,0,0,0,0,0,0,0
929,124553,2021,USA,Canada,0,0,6,6,28/05/2021,14,0,58,72,2,0,1,3,1,1,1,3,0,0,1,1,6,3,1,10
930,140428,2021,Canada,Serbia,0,1,8,9,23/06/2021,0,0,0,0,16,4,9,29,1,5,6,12,0,0,1,1,8,1,2,11
931,140428,2021,Canada,Australia,2,2,10,14,22/06/2021,0,0,0,0,12,1,9,22,2,3,3,8,0,0,0,0,7,0,0,7
932,140428,2021,Canada,Netherlands,0,0,3,3,21/06/2021,0,0,0,0,0,0,0,0,0,0,0,0,0,0,0,0,1,0,0,1
933,140428,2021,Japan,Canada,1,4,6,11,17/06/2021,0,0,2,2,15,1,8,24,0,5,4,9,0,0,0,0,2,2,3,7
934,140428,2021,Canada,Germany,0,0,0,0,16/06/2021,0,0,0,0,0,0,0,0,0,0,0,0,0,0,0,0,0,0,0,0
935,140428,2021,Canada,Poland,0,0,3,3,15/06/2021,0,0,0,0,0,0,0,0,0,0,0,0,0,0,0,0,1,0,0,1
936,140428,2021,Canada,France,0,3,7,10,11/06/2021,0,0,4,4,11,7,12,30,0,5,3,8,0,0,0,0,8,4,0,12
937,140428,2021,Russia,Canada,0,1,2,3,10/06/2021,0,0,0,0,0,0,0,0,0,0,0,0,0,0,0,0,0,1,0,1
938,140428,2021,Slovenia,Canada,0,1,3,4,09/06/2021,0,0,0,0,1,0,3,4,0,1,1,2,0,0,0,0,2,0,0,2
939,140428,2021,Canada,Italy,1,1,4,6,05/06/2021,0,0,0,0,2,6,8,16,0,4,3,7,0,0,0,0,4,0,0,4
940,140428,2021,Canada,Bulgaria,0,0,0,0,04/06/2021,0,0,0,0,0,0,0,0,0,0,0,0,0,0,0,0,0,0,0,0
941,140428,2021,Iran,Canada,1,3,8,12,03/06/2021,0,0,0,0,16,7,14,37,0,6,5,11,0,0,1,1,8,2,0,10
942,140428,2021,Canada,Brazil,0,0,4,4,30/05/2021,0,0,0,0,0,0,0,0,0,0,0,0,0,0,0,0,0,0,0,0
943,140428,2021,Argentina,Canada,1,4,11,16,29/05/2021,0,0,0,0,11,3,0,14,2,2,0,4,0,0,0,0,4,1,0,5
944,140428,2021,USA,Canada,0,0,2,2,28/05/2021,0,0,0,0,1,1,3,5,1,0,0,1,0,0,0,0,0,0,0,0
945,139499,2021,Canada,Serbia,0,0,0,0,23/06/2021,0,0,0,0,0,0,0,0,0,0,0,0,0,0,0,0,0,0,0,0
946,139499,2021,Canada,Australia,0,1,7,8,22/06/2021,0,0,0,0,7,0,1,8,2,1,6,9,1,0,0,1,0,1,1,2
947,139499,2021,Canada,Netherlands,0,0,0,0,21/06/2021,0,0,0,0,0,0,0,0,0,0,0,0,0,0,0,0,0,0,0,0
948,139499,2021,Japan,Canada,0,0,0,0,17/06/2021,0,0,0,0,0,0,0,0,0,0,0,0,0,0,0,0,0,0,0,0
949,139499,2021,Canada,Germany,0,1,11,12,16/06/2021,0,0,0,0,2,0,4,6,1,4,1,6,1,0,1,2,2,0,0,2
950,139499,2021,Canada,Poland,0,0,0,0,15/06/2021,0,0,0,0,0,0,0,0,0,0,0,0,0,0,0,0,0,0,0,0
951,139499,2021,Canada,France,0,3,2,5,11/06/2021,0,0,0,0,5,3,1,9,1,4,5,10,1,0,1,2,2,1,0,3
952,139499,2021,Russia,Canada,0,2,10,12,10/06/2021,0,0,1,1,4,2,4,10,1,0,1,2,1,0,1,2,2,1,0,3
953,139499,2021,Slovenia,Canada,0,0,5,5,09/06/2021,0,0,0,0,2,0,0,2,1,1,1,3,0,0,0,0,0,0,0,0
954,139499,2021,Canada,Italy,0,2,7,9,05/06/2021,0,0,2,2,5,2,4,11,1,5,1,7,0,0,2,2,3,1,0,4
955,139499,2021,Canada,Bulgaria,0,0,10,10,04/06/2021,0,0,0,0,3,2,1,6,2,4,0,6,0,0,1,1,3,3,0,6
956,139499,2021,Iran,Canada,0,0,0,0,03/06/2021,0,0,0,0,0,0,0,0,0,0,0,0,0,0,0,0,0,0,0,0
957,139499,2021,Canada,Brazil,0,0,0,0,30/05/2021,0,0,0,0,0,0,0,0,0,0,0,0,0,0,0,0,0,0,0,0
958,139499,2021,Argentina,Canada,0,2,10,12,29/05/2021,0,0,0,0,1,1,1,3,1,2,2,5,0,0,1,1,0,0,0,0
959,139499,2021,USA,Canada,0,0,5,5,28/05/2021,0,0,0,0,3,0,0,3,0,1,1,2,0,0,0,0,0,0,0,0
960,136296,2021,Canada,Serbia,0,1,21,22,23/06/2021,1,0,2,3,4,1,3,8,5,5,2,12,1,0,0,1,0,0,0,0
961,136296,2021,Canada,Australia,0,0,0,0,22/06/2021,0,0,0,0,0,0,0,0,0,0,0,0,0,0,0,0,0,0,0,0
962,136296,2021,Canada,Netherlands,0,1,11,12,21/06/2021,0,0,0,0,7,0,3,10,2,2,4,8,1,0,0,1,0,1,0,1
963,136296,2021,Japan,Canada,0,0,0,0,17/06/2021,0,0,0,0,0,0,0,0,0,0,0,0,0,0,0,0,0,0,0,0
964,136296,2021,Canada,Germany,0,0,0,0,16/06/2021,0,0,0,0,0,0,0,0,0,0,0,0,0,0,0,0,0,0,0,0
965,136296,2021,Canada,Poland,0,0,9,9,15/06/2021,0,0,0,0,5,0,4,9,1,7,4,12,0,0,2,2,3,0,0,3
966,136296,2021,Canada,France,0,2,13,15,11/06/2021,0,0,0,0,2,2,2,6,3,3,1,7,0,0,0,0,3,0,0,3
967,136296,2021,Russia,Canada,0,0,0,0,10/06/2021,0,0,0,0,0,0,0,0,0,0,0,0,0,0,0,0,0,0,0,0
968,136296,2021,Slovenia,Canada,0,0,4,4,09/06/2021,0,0,0,0,3,0,1,4,2,3,3,8,0,0,2,2,0,0,0,0
969,136296,2021,Canada,Italy,0,0,12,12,05/06/2021,0,0,1,1,6,1,3,10,2,6,3,11,0,0,1,1,4,2,0,6
970,136296,2021,Canada,Bulgaria,0,0,0,0,04/06/2021,0,0,0,0,0,0,0,0,0,0,0,0,0,0,0,0,0,0,0,0
971,136296,2021,Iran,Canada,0,0,11,11,03/06/2021,0,0,3,3,7,1,2,10,2,5,5,12,0,1,4,5,4,2,0,6
972,136296,2021,Canada,Brazil,1,0,14,15,30/05/2021,0,0,0,0,4,0,2,6,3,7,2,12,2,0,3,5,0,0,0,0
973,136296,2021,Argentina,Canada,0,0,1,1,29/05/2021,0,0,0,0,0,0,0,0,0,0,0,0,0,0,0,0,0,0,0,0
974,157321,2021,Canada,Serbia,0,3,4,7,23/06/2021,0,0,2,2,7,2,7,16,2,1,1,4,0,0,1,1,0,4,0,4
975,157321,2021,Canada,Australia,0,0,0,0,22/06/2021,0,0,0,0,0,0,0,0,0,0,0,0,0,0,0,0,0,0,0,0
976,157321,2021,Canada,Netherlands,0,1,6,7,21/06/2021,0,0,1,1,11,1,2,14,3,1,4,8,0,0,0,0,4,4,0,8
977,157321,2021,Japan,Canada,0,0,0,0,17/06/2021,0,0,0,0,0,0,0,0,0,0,0,0,0,0,0,0,0,0,0,0
978,157321,2021,Canada,Germany,0,3,9,12,16/06/2021,1,0,4,5,14,3,11,28,1,1,0,2,0,0,0,0,4,4,0,8
979,157321,2021,Canada,Poland,2,3,7,12,15/06/2021,0,0,1,1,13,3,4,20,1,7,3,11,1,0,2,3,5,0,0,5
980,157321,2021,Canada,France,0,0,0,0,11/06/2021,0,0,0,0,0,0,0,0,0,0,0,0,0,0,0,0,0,0,0,0
981,157321,2021,Russia,Canada,1,7,7,15,10/06/2021,0,0,0,0,13,6,12,31,1,2,0,3,0,0,1,1,2,2,0,4
982,157321,2021,Slovenia,Canada,0,4,3,7,09/06/2021,0,0,1,1,4,3,1,8,0,1,0,1,0,0,0,0,4,1,1,6
983,157321,2021,Canada,Italy,4,6,7,17,05/06/2021,0,0,1,1,6,5,3,14,2,2,1,5,0,0,0,0,9,0,1,10
984,157321,2021,Canada,Bulgaria,0,2,7,9,04/06/2021,0,0,4,4,9,2,8,19,3,6,0,9,0,0,0,0,2,1,0,3
985,157321,2021,Iran,Canada,0,2,0,2,03/06/2021,0,0,0,0,1,1,1,3,0,0,0,0,0,0,0,0,0,0,0,0
986,157321,2021,Canada,Brazil,1,6,7,14,30/05/2021,0,0,0,0,21,5,18,44,2,4,2,8,0,0,1,1,5,4,2,11
987,157321,2021,Argentina,Canada,0,0,0,0,29/05/2021,0,0,0,0,0,0,0,0,0,0,0,0,0,0,0,0,0,0,0,0
988,157321,2021,USA,Canada,2,1,9,12,28/05/2021,0,0,0,0,4,6,7,17,1,1,2,4,0,0,0,0,4,0,0,4
989,157327,2021,Canada,Serbia,0,0,0,0,23/06/2021,0,0,0,0,0,0,0,0,0,0,0,0,0,0,0,0,0,0,0,0
990,157327,2021,Canada,Australia,0,0,0,0,22/06/2021,0,0,0,0,0,0,0,0,0,0,0,0,0,0,0,0,0,0,0,0
991,157327,2021,Canada,Netherlands,0,0,0,0,21/06/2021,0,0,0,0,0,0,0,0,0,0,0,0,0,0,0,0,0,0,0,0
992,157327,2021,Canada,Germany,0,0,0,0,16/06/2021,0,0,0,0,0,0,0,0,0,0,0,0,0,0,0,0,0,0,0,0
993,157327,2021,Canada,Poland,0,0,0,0,15/06/2021,0,0,0,0,0,0,0,0,0,0,0,0,0,0,0,0,0,0,0,0
994,157327,2021,Canada,France,0,2,15,17,11/06/2021,0,0,4,4,17,5,11,33,0,6,1,7,7,2,18,27,7,1,2,10
995,157327,2021,Russia,Canada,0,1,8,9,10/06/2021,0,1,5,6,10,5,12,27,0,2,2,4,4,0,11,15,6,3,0,9
996,157327,2021,Slovenia,Canada,0,0,0,0,09/06/2021,0,0,0,0,0,0,0,0,0,1,0,1,0,0,0,0,0,0,0,0
997,157327,2021,Canada,Italy,1,2,12,15,05/06/2021,0,0,2,2,13,6,6,25,1,4,2,7,7,1,16,24,9,1,0,10
998,157327,2021,Canada,Bulgaria,0,0,0,0,04/06/2021,0,0,0,0,0,0,0,0,0,0,0,0,0,0,0,0,0,0,0,0
999,157327,2021,Iran,Canada,1,2,5,8,03/06/2021,0,0,1,1,5,3,5,13,0,2,1,3,3,3,8,14,1,1,0,2
1000,157327,2021,Canada,Brazil,0,1,12,13,30/05/2021,0,0,0,0,13,2,11,26,1,2,2,5,6,0,15,21,7,3,2,12
1001,157327,2021,Argentina,Canada,0,0,0,0,29/05/2021,0,0,0,0,0,0,0,0,0,0,0,0,0,0,0,0,0,0,0,0
1002,157327,2021,USA,Canada,0,1,2,3,28/05/2021,0,0,0,0,0,2,2,4,0,0,0,0,2,1,6,9,1,1,0,2
1003,124551,2021,Canada,Serbia,0,3,8,11,23/06/2021,0,0,0,0,5,1,4,10,2,7,5,14,0,0,0,0,4,1,0,5
1004,124551,2021,Canada,Australia,0,0,0,0,22/06/2021,0,0,0,0,0,0,0,0,0,0,0,0,0,0,0,0,0,0,0,0
1005,124551,2021,Canada,Netherlands,1,0,13,14,21/06/2021,0,0,1,1,5,0,0,5,4,2,2,8,0,0,0,0,1,2,1,4
1006,124551,2021,Japan,Canada,2,0,10,12,17/06/2021,0,0,1,1,3,0,5,8,0,5,2,7,0,0,2,2,1,0,0,1
1007,124551,2021,Canada,Germany,0,0,7,7,16/06/2021,0,0,0,0,2,0,1,3,1,3,2,6,0,0,0,0,2,3,0,5
1008,124551,2021,Canada,Poland,0,0,0,0,15/06/2021,0,0,0,0,0,0,0,0,0,0,0,0,0,0,0,0,0,0,0,0
1009,124551,2021,Argentina,Canada,0,1,10,11,29/05/2021,0,0,0,0,6,0,1,7,0,1,2,3,1,0,0,1,0,2,0,2
1010,124551,2021,USA,Canada,0,0,10,10,28/05/2021,0,1,0,1,5,0,3,8,1,2,2,5,1,1,0,2,2,0,0,2
1011,139490,2021,Canada,Serbia,0,0,0,0,23/06/2021,0,0,6,6,0,0,0,0,0,0,0,0,7,0,16,23,17,3,1,21
1012,139490,2021,Canada,Australia,0,0,0,0,22/06/2021,0,0,5,5,0,0,0,0,0,0,0,0,6,2,3,11,11,2,1,14
1013,139490,2021,Canada,Netherlands,0,0,0,0,21/06/2021,0,0,3,3,0,0,0,0,0,0,0,0,2,0,12,14,6,3,0,9
1014,139490,2021,Japan,Canada,0,0,0,0,17/06/2021,0,1,6,7,0,0,0,0,0,0,0,0,5,0,13,18,6,0,2,8
1015,139490,2021,Canada,Germany,0,0,0,0,16/06/2021,0,0,6,6,0,0,0,0,0,0,0,0,8,0,3,11,9,3,0,12
1016,139490,2021,Canada,Italy,0,0,0,0,05/06/2021,0,0,15,15,0,0,0,0,0,0,0,0,9,2,15,26,13,3,0,16
1017,139490,2021,Canada,Bulgaria,0,0,0,0,04/06/2021,0,0,4,4,0,0,0,0,0,0,0,0,6,2,7,15,7,2,2,11
1018,139490,2021,Iran,Canada,0,0,0,0,03/06/2021,0,0,7,7,0,0,0,0,0,0,0,0,10,1,14,25,8,3,0,11
1019,139490,2021,Canada,Brazil,0,0,0,0,30/05/2021,0,0,1,1,0,0,0,0,0,0,0,0,9,2,15,26,4,1,1,6
1020,139490,2021,Argentina,Canada,0,0,0,0,29/05/2021,0,0,0,0,0,0,0,0,0,0,0,0,7,1,7,15,3,2,0,5
1021,139490,2021,USA,Canada,0,0,0,0,28/05/2021,0,0,2,2,0,0,0,0,0,0,0,0,9,0,10,19,12,5,0,17
1022,151871,2021,Canada,Serbia,0,2,0,2,23/06/2021,0,0,0,0,1,0,1,2,0,1,3,4,0,0,0,0,0,0,0,0
1023,151871,2021,Canada,Australia,0,5,4,9,22/06/2021,0,0,0,0,4,0,4,8,3,2,6,11,0,0,0,0,2,0,1,3
1024,151871,2021,Canada,Netherlands,0,0,0,0,21/06/2021,0,0,0,0,0,0,0,0,0,0,0,0,0,0,0,0,0,0,0,0
1025,151871,2021,Japan,Canada,1,3,9,13,17/06/2021,0,0,0,0,6,0,1,7,4,10,5,19,1,0,0,1,3,0,0,3
1026,151871,2021,Canada,Germany,0,0,3,3,16/06/2021,0,0,0,0,0,0,0,0,1,2,0,3,0,0,0,0,0,0,0,0
1027,151871,2021,Canada,Poland,1,3,5,9,15/06/2021,0,1,1,2,4,0,3,7,0,1,4,5,0,0,0,0,2,0,2,4
1028,151871,2021,Canada,France,0,0,0,0,11/06/2021,0,0,0,0,0,0,0,0,0,0,0,0,0,0,0,0,0,0,0,0
1029,151871,2021,Russia,Canada,4,0,14,18,10/06/2021,0,0,1,1,6,3,2,11,1,2,2,5,1,0,1,2,0,1,0,1
1030,151871,2021,Slovenia,Canada,0,2,6,8,09/06/2021,0,2,4,6,0,0,3,3,1,2,3,6,1,0,1,2,0,1,0,1
1031,151871,2021,Canada,Italy,0,1,4,5,05/06/2021,0,0,0,0,3,3,0,6,0,0,0,0,0,0,1,1,0,2,0,2
1032,151871,2021,Canada,Bulgaria,2,3,8,13,04/06/2021,0,0,0,0,9,2,1,12,3,4,2,9,1,0,0,1,2,0,0,2
1033,151871,2021,Iran,Canada,1,2,11,14,03/06/2021,0,0,1,1,7,2,4,13,2,4,3,9,0,0,0,0,2,2,0,4
1034,151871,2021,Canada,Brazil,0,3,11,14,30/05/2021,0,0,0,0,6,2,3,11,4,3,2,9,0,1,0,1,4,0,0,4
1035,151871,2021,Argentina,Canada,0,0,0,0,29/05/2021,0,0,0,0,0,0,0,0,0,0,0,0,0,0,0,0,0,0,0,0
1036,151871,2021,USA,Canada,1,1,6,8,28/05/2021,0,0,1,1,1,2,0,3,1,3,2,6,0,0,0,0,0,0,0,0
1037,143745,2021,Canada,Serbia,0,0,0,0,23/06/2021,0,0,1,1,0,0,0,0,0,0,0,0,0,0,0,0,0,0,0,0
1038,143745,2021,Canada,Australia,0,0,0,0,22/06/2021,0,0,4,4,0,0,0,0,1,0,0,1,0,0,0,0,0,0,0,0
1039,143745,2021,Canada,Netherlands,0,0,0,0,21/06/2021,1,0,3,4,0,0,0,0,0,0,0,0,0,0,0,0,0,0,0,0
1040,143745,2021,Canada,Germany,0,0,0,0,16/06/2021,0,0,1,1,0,0,0,0,0,0,0,0,0,0,0,0,0,0,0,0
1041,143745,2021,Canada,France,0,0,0,0,11/06/2021,1,0,5,6,0,0,0,0,0,0,0,0,0,0,0,0,0,0,0,0
1042,143745,2021,Russia,Canada,0,0,0,0,10/06/2021,0,0,0,0,0,0,0,0,0,0,0,0,0,0,0,0,0,0,0,0
1043,143745,2021,Canada,Bulgaria,0,1,0,1,04/06/2021,0,0,2,2,0,0,1,1,0,0,0,0,0,0,0,0,0,0,0,0
1044,143745,2021,Canada,Brazil,0,4,11,15,30/05/2021,24,1,78,103,1,1,1,3,1,1,4,6,0,0,0,0,3,4,0,7
1045,143745,2021,Argentina,Canada,0,0,9,9,29/05/2021,17,0,38,55,0,0,2,2,1,3,1,5,0,0,0,0,2,3,0,5
1046,143745,2021,USA,Canada,0,1,0,1,28/05/2021,4,0,0,4,0,0,0,0,0,0,0,0,0,0,1,1,2,0,0,2
1047,140042,2021,Canada,France,0,1,7,8,11/06/2021,0,0,0,0,1,1,1,3,0,1,3,4,0,0,0,0,0,0,0,0
1048,140042,2021,Russia,Canada,0,0,0,0,10/06/2021,0,0,0,0,0,0,0,0,0,0,0,0,0,0,0,0,0,0,0,0
1049,140042,2021,Slovenia,Canada,0,0,0,0,09/06/2021,0,0,0,0,0,0,0,0,0,0,0,0,0,0,0,0,0,0,0,0
1050,140042,2021,Canada,Italy,0,0,0,0,05/06/2021,0,0,0,0,0,0,0,0,0,0,0,0,0,0,0,0,0,0,0,0
1051,140042,2021,Canada,Bulgaria,0,0,0,0,04/06/2021,0,0,0,0,0,0,0,0,0,0,0,0,0,0,0,0,0,0,0,0
1052,140042,2021,Iran,Canada,0,0,0,0,03/06/2021,0,0,0,0,0,0,0,0,0,0,0,0,0,0,0,0,0,0,0,0
1053,140042,2021,Canada,Brazil,0,0,0,0,30/05/2021,0,0,0,0,0,0,0,0,0,0,0,0,0,0,0,0,0,0,0,0
1054,140042,2021,USA,Canada,0,0,0,0,28/05/2021,0,0,0,0,0,0,0,0,0,0,0,0,0,0,0,0,0,0,0,0
1055,152494,2021,France,Slovenia,0,0,9,9,27/06/2021,0,0,1,1,4,2,0,6,1,3,5,9,0,0,0,0,1,1,0,2
1056,152494,2021,Brazil,France,0,0,10,10,26/06/2021,1,0,1,2,5,2,1,8,0,5,3,8,0,0,1,1,1,1,0,2
1057,152494,2021,France,Poland,0,3,17,20,23/06/2021,0,0,1,1,6,1,5,12,0,3,2,5,0,0,0,0,2,0,0,2
1058,152494,2021,France,Argentina,2,0,14,16,22/06/2021,0,0,0,0,7,1,1,9,0,6,1,7,1,0,0,1,4,2,0,6
1059,152494,2021,France,Iran,0,2,7,9,21/06/2021,0,0,0,0,5,0,2,7,2,2,0,4,0,0,0,0,2,1,0,3
1060,152494,2021,France,Italy,1,1,11,13,17/06/2021,0,0,0,0,2,1,5,8,2,1,2,5,0,0,1,1,1,0,0,1
1061,152494,2021,USA,France,0,2,13,15,16/06/2021,0,1,1,2,6,1,5,12,2,3,7,12,2,0,0,2,4,0,3,7
1062,152494,2021,Netherlands,France,0,2,15,17,15/06/2021,0,0,1,1,11,1,3,15,2,7,4,13,0,0,0,0,1,0,0,1
1063,152494,2021,Canada,France,0,0,16,16,11/06/2021,1,0,4,5,3,1,5,9,2,6,2,10,0,0,0,0,2,1,0,3
1064,152494,2021,France,Slovenia,0,0,0,0,10/06/2021,0,0,0,0,0,0,0,0,0,0,0,0,0,0,0,0,0,0,0,0
1065,152494,2021,France,Russia,0,1,8,9,09/06/2021,0,0,3,3,2,0,6,8,3,5,8,16,0,0,0,0,4,1,1,6
1066,152494,2021,France,Japan,1,1,13,15,05/06/2021,0,0,1,1,8,1,6,15,3,5,2,10,1,0,0,1,3,0,0,3
1067,152494,2021,Serbia,France,0,2,11,13,04/06/2021,0,0,0,0,3,1,4,8,0,8,2,10,3,1,0,4,2,0,1,3
1068,152494,2021,Brazil,France,0,1,10,11,03/06/2021,0,0,2,2,6,1,4,11,1,9,4,14,1,0,1,2,4,0,0,4
1069,152494,2021,Australia,France,0,0,1,1,30/05/2021,0,0,0,0,3,0,0,3,0,1,0,1,0,0,0,0,2,0,0,2
1070,152494,2021,Germany,France,0,4,12,16,29/05/2021,0,0,0,0,8,1,4,13,3,3,3,9,2,0,0,2,0,0,0,0
1071,152494,2021,France,Bulgaria,0,2,7,9,28/05/2021,0,0,1,1,5,1,2,8,2,0,0,2,0,0,0,0,0,0,0,0
1072,119792,2021,France,Slovenia,0,0,0,0,27/06/2021,1,0,7,8,0,0,0,0,0,0,0,0,6,0,4,10,6,1,1,8
1073,119792,2021,Brazil,France,0,0,0,0,26/06/2021,0,0,2,2,0,0,0,0,0,0,0,0,3,1,9,13,6,5,2,13
1074,119792,2021,France,Poland,0,0,0,0,23/06/2021,0,0,2,2,0,0,0,0,0,0,0,0,10,1,10,21,12,2,0,14
1075,119792,2021,France,Argentina,0,0,0,0,22/06/2021,0,0,6,6,0,0,0,0,0,0,0,0,5,0,6,11,12,2,0,14
1076,119792,2021,France,Iran,0,0,0,0,21/06/2021,0,0,0,0,0,0,0,0,0,0,0,0,13,0,11,24,5,6,2,13
1077,119792,2021,France,Italy,0,0,0,0,17/06/2021,0,0,3,3,0,0,0,0,0,0,0,0,0,0,2,2,4,2,0,6
1078,119792,2021,USA,France,0,0,0,0,16/06/2021,0,0,10,10,0,0,0,0,0,0,0,0,8,0,16,24,11,5,2,18
1079,119792,2021,Netherlands,France,0,0,0,0,15/06/2021,0,0,7,7,0,0,0,0,0,0,0,0,8,0,12,20,17,2,1,20
1080,119792,2021,Canada,France,0,0,0,0,11/06/2021,0,0,7,7,0,0,0,0,0,0,0,0,8,0,16,24,8,4,0,12
1081,119792,2021,France,Slovenia,0,0,0,0,10/06/2021,0,0,3,3,0,0,0,0,0,0,0,0,9,1,3,13,10,4,3,17
1082,119792,2021,France,Russia,0,0,0,0,09/06/2021,0,0,4,4,0,0,0,0,0,0,0,0,6,0,10,16,15,2,1,18
1083,119792,2021,France,Japan,0,0,0,0,05/06/2021,0,0,3,3,0,0,0,0,0,0,0,0,6,3,13,22,8,6,1,15
1084,119792,2021,Serbia,France,0,0,0,0,04/06/2021,0,0,4,4,0,0,0,0,0,0,0,0,7,1,16,24,10,3,3,16
1085,119792,2021,Brazil,France,0,0,0,0,03/06/2021,0,0,4,4,0,0,0,0,0,0,0,0,7,1,14,22,13,6,3,22
1086,142694,2021,France,Slovenia,0,0,0,0,27/06/2021,0,0,0,0,0,0,0,0,0,0,0,0,0,0,0,0,0,0,0,0
1087,142694,2021,Brazil,France,0,2,4,6,26/06/2021,0,0,0,0,11,0,8,19,1,5,1,7,0,0,0,0,3,0,1,4
1088,142694,2021,France,Poland,2,1,8,11,23/06/2021,0,0,0,0,6,6,7,19,1,5,3,9,0,0,0,0,8,1,2,11
1089,142694,2021,France,Argentina,1,1,9,11,22/06/2021,0,0,1,1,12,7,8,27,1,1,1,3,0,0,0,0,3,2,1,6
1090,142694,2021,France,Iran,0,0,0,0,21/06/2021,0,0,0,0,0,0,0,0,0,0,0,0,0,0,0,0,0,0,0,0
1091,142694,2021,France,Italy,0,0,0,0,17/06/2021,0,0,0,0,0,0,0,0,0,0,0,0,0,0,0,0,0,0,0,0
1092,142694,2021,USA,France,0,1,12,13,16/06/2021,0,0,6,6,13,4,9,26,1,1,6,8,0,0,0,0,8,2,0,10
1093,142694,2021,Canada,France,0,2,11,13,11/06/2021,0,0,5,5,13,2,9,24,0,0,4,4,0,0,0,0,3,1,1,5
1094,142694,2021,France,Russia,4,3,15,22,09/06/2021,0,0,2,2,14,5,13,32,0,3,4,7,0,0,0,0,5,5,0,10
1095,142694,2021,France,Japan,1,8,12,21,05/06/2021,0,0,1,1,16,4,16,36,2,4,0,6,0,0,0,0,2,3,1,6
1096,142694,2021,Brazil,France,0,3,14,17,03/06/2021,0,0,0,0,20,4,15,39,0,4,0,4,0,0,0,0,5,0,0,5
1097,142694,2021,Australia,France,2,2,15,19,30/05/2021,0,0,0,0,14,6,6,26,1,3,3,7,0,0,0,0,7,0,1,8
1098,142694,2021,Germany,France,0,0,1,1,29/05/2021,0,0,0,0,0,0,0,0,0,1,0,1,0,0,0,0,1,0,0,1
1099,142694,2021,France,Bulgaria,1,4,7,12,28/05/2021,0,0,0,0,8,4,13,25,1,0,0,1,0,0,0,0,1,0,0,1
1100,119804,2021,France,Slovenia,0,0,0,0,27/06/2021,0,0,0,0,0,0,0,0,0,0,0,0,0,0,0,0,0,0,0,0
1101,119804,2021,Brazil,France,0,0,6,6,26/06/2021,7,0,30,37,0,0,0,0,0,0,0,0,0,0,0,0,1,0,0,1
1102,119804,2021,France,Poland,1,1,7,9,23/06/2021,4,1,47,52,0,0,0,0,0,1,2,3,0,0,0,0,3,0,0,3
1103,119804,2021,France,Argentina,0,0,0,0,22/06/2021,0,0,0,0,0,0,0,0,0,0,0,0,0,0,0,0,0,0,0,0
1104,119804,2021,France,Iran,0,1,11,12,21/06/2021,17,0,49,66,0,0,0,0,0,1,3,4,0,0,0,0,5,3,0,8
1105,119804,2021,France,Italy,0,1,7,8,17/06/2021,13,0,46,59,0,0,0,0,1,1,0,2,0,0,0,0,3,2,0,5
1106,119804,2021,USA,France,0,1,13,14,16/06/2021,13,0,50,63,0,0,0,0,0,1,0,1,0,0,0,0,9,0,1,10
1107,119804,2021,Netherlands,France,0,0,0,0,15/06/2021,0,0,0,0,0,0,0,0,0,0,0,0,0,0,0,0,0,0,0,0
1108,119804,2021,Canada,France,0,0,8,8,11/06/2021,9,1,31,41,0,0,0,0,0,1,1,2,0,0,0,0,4,1,2,7
1109,119804,2021,France,Slovenia,0,1,13,14,10/06/2021,38,0,33,71,0,0,0,0,0,3,3,6,0,0,0,0,2,3,0,5
1110,119804,2021,France,Russia,0,0,0,0,09/06/2021,0,0,0,0,0,0,0,0,0,0,0,0,0,0,0,0,0,0,0,0
1111,119804,2021,Serbia,France,0,3,12,15,04/06/2021,19,1,90,110,0,0,2,2,0,3,2,5,0,0,1,1,4,4,1,9
1112,119804,2021,Brazil,France,0,1,10,11,03/06/2021,34,0,52,86,0,0,0,0,1,3,3,7,0,0,0,0,5,1,0,6
1113,119804,2021,Germany,France,0,2,11,13,29/05/2021,25,0,0,25,1,0,0,1,1,0,0,1,0,0,0,0,3,2,0,5
1114,119804,2021,France,Bulgaria,0,0,0,0,28/05/2021,0,0,0,0,0,0,0,0,0,0,0,0,0,0,0,0,0,0,0,0
1115,124518,2021,France,Slovenia,0,1,2,3,27/06/2021,0,0,0,0,0,0,0,0,0,0,0,0,0,0,0,0,0,1,0,1
1116,124518,2021,Brazil,France,0,0,3,3,26/06/2021,0,0,1,1,3,3,5,11,0,0,0,0,1,0,4,5,3,0,0,3
1117,124518,2021,France,Poland,0,3,6,9,23/06/2021,0,0,2,2,4,4,6,14,2,1,0,3,5,0,13,18,2,3,1,6
1118,124518,2021,France,Argentina,0,0,0,0,22/06/2021,0,0,0,0,0,0,0,0,0,0,0,0,0,0,0,0,0,0,0,0
1119,124518,2021,France,Iran,0,0,7,7,21/06/2021,0,0,0,0,8,1,3,12,0,0,1,1,4,0,6,10,1,2,0,3
1120,124518,2021,France,Italy,0,1,4,5,17/06/2021,0,0,2,2,10,1,3,14,0,1,0,1,3,2,10,15,1,1,0,2
1121,124518,2021,USA,France,0,1,6,7,16/06/2021,0,0,2,2,7,1,4,12,0,1,2,3,4,0,7,11,4,2,0,6
1122,124518,2021,Netherlands,France,0,1,1,2,15/06/2021,0,0,0,0,2,0,1,3,0,0,1,1,1,1,2,4,1,3,1,5
1123,124518,2021,Canada,France,0,1,9,10,11/06/2021,0,0,2,2,13,2,15,30,4,1,4,9,12,1,9,22,7,1,0,8
1124,124518,2021,France,Slovenia,0,2,2,4,10/06/2021,0,0,0,0,5,1,5,11,0,1,0,1,3,2,7,12,1,1,0,2
1125,124518,2021,France,Russia,0,1,4,5,09/06/2021,0,0,0,0,0,0,0,0,0,0,0,0,0,0,0,0,2,0,0,2
1126,124518,2021,France,Japan,1,1,13,15,05/06/2021,0,0,2,2,13,2,6,21,1,3,0,4,7,1,12,20,1,2,0,3
1127,124518,2021,Brazil,France,1,4,14,19,03/06/2021,0,0,4,4,12,3,7,22,0,2,1,3,4,1,10,15,5,5,2,12
1128,124518,2021,Australia,France,2,2,14,18,30/05/2021,0,0,0,0,12,0,8,20,2,3,4,9,5,0,9,14,9,1,4,14
1129,124518,2021,Germany,France,0,1,2,3,29/05/2021,0,0,0,0,0,0,0,0,0,0,0,0,0,0,0,0,0,0,0,0
1130,124518,2021,France,Bulgaria,1,1,13,15,28/05/2021,0,0,1,1,7,1,5,13,0,1,0,1,6,2,13,21,1,0,0,1
1131,119798,2021,Canada,France,1,1,5,7,11/06/2021,0,0,1,1,1,3,3,7,1,0,0,1,4,0,9,13,2,5,0,7
1132,119798,2021,France,Slovenia,1,2,2,5,10/06/2021,0,0,0,0,0,0,0,0,0,0,0,0,0,0,0,0,0,0,0,0
1133,119798,2021,France,Japan,0,1,8,9,05/06/2021,0,0,0,0,1,2,2,5,0,0,0,0,1,0,4,5,1,0,0,1
1134,119798,2021,Serbia,France,0,2,9,11,04/06/2021,0,0,2,2,4,2,1,7,0,1,0,1,6,0,5,11,2,2,0,4
1135,119798,2021,Australia,France,0,0,0,0,30/05/2021,0,0,2,2,0,0,0,0,0,0,0,0,2,1,4,7,3,0,0,3
1136,119798,2021,Germany,France,0,0,0,0,29/05/2021,0,0,0,0,0,0,0,0,0,0,0,0,3,0,10,13,6,2,0,8
1137,119798,2021,France,Bulgaria,0,0,0,0,28/05/2021,0,0,0,0,0,0,0,0,0,0,0,0,0,0,0,0,0,0,0,0
1138,119800,2021,France,Slovenia,3,4,9,16,27/06/2021,0,0,7,7,14,3,0,17,1,4,1,6,4,2,14,20,3,1,0,4
1139,119800,2021,Brazil,France,1,4,8,13,26/06/2021,0,0,5,5,4,5,7,16,0,2,1,3,9,1,14,24,8,0,0,8
1140,119800,2021,France,Poland,1,5,11,17,23/06/2021,0,0,12,12,15,6,7,28,2,2,1,5,14,2,15,31,7,2,0,9
1141,119800,2021,France,Argentina,0,0,0,0,22/06/2021,0,0,0,0,0,0,0,0,0,0,0,0,0,0,0,0,0,0,0,0
1142,119800,2021,France,Iran,2,3,15,20,21/06/2021,0,0,3,3,7,5,2,14,0,3,0,3,5,2,10,17,3,1,1,5
1143,119800,2021,USA,France,3,5,11,19,16/06/2021,0,0,7,7,12,7,16,35,1,2,1,4,4,1,19,24,10,4,0,14
1144,119800,2021,Netherlands,France,0,4,7,11,15/06/2021,0,0,4,4,7,2,5,14,0,1,0,1,4,0,14,18,3,2,1,6
1145,119800,2021,France,Slovenia,1,4,8,13,10/06/2021,0,0,4,4,12,2,2,16,1,1,2,4,8,2,6,16,4,1,1,6
1146,119800,2021,France,Russia,3,4,13,20,09/06/2021,0,0,7,7,18,6,7,31,0,1,2,3,8,1,20,29,8,1,2,11
1147,119800,2021,Serbia,France,3,1,9,13,04/06/2021,0,0,1,1,5,1,2,8,0,4,0,4,4,0,4,8,0,3,1,4
1148,119800,2021,Brazil,France,1,7,4,12,03/06/2021,0,0,5,5,11,1,12,24,0,5,0,5,6,2,15,23,6,1,1,8
1149,119800,2021,Australia,France,0,1,5,6,30/05/2021,0,0,0,0,6,5,11,22,0,1,0,1,7,0,17,24,4,1,1,6
1150,136851,2021,France,Slovenia,1,3,9,13,27/06/2021,14,0,34,48,4,0,1,5,3,0,3,6,0,0,1,1,2,0,0,2
1151,136851,2021,Brazil,France,1,1,3,5,26/06/2021,8,0,22,30,0,0,2,2,1,0,0,1,0,0,0,0,2,0,0,2
1152,136851,2021,France,Poland,1,2,6,9,23/06/2021,17,0,31,48,3,0,0,3,1,0,2,3,0,0,0,0,2,2,0,4
1153,136851,2021,France,Argentina,2,3,9,14,22/06/2021,24,2,44,70,3,0,2,5,2,1,1,4,0,0,2,2,5,2,0,7
1154,136851,2021,France,Iran,0,0,0,0,21/06/2021,0,0,0,0,0,0,0,0,0,0,0,0,0,0,0,0,0,0,0,0
1155,136851,2021,France,Italy,0,3,9,12,17/06/2021,9,0,46,55,0,1,0,1,1,2,0,3,0,0,0,0,3,0,0,3
1156,136851,2021,USA,France,0,1,3,4,16/06/2021,9,0,27,36,0,0,1,1,0,1,1,2,0,0,0,0,3,0,0,3
1157,136851,2021,Netherlands,France,0,3,14,17,15/06/2021,38,0,69,107,1,0,2,3,2,2,4,8,0,0,0,0,5,2,1,8
1158,136851,2021,Canada,France,0,3,7,10,11/06/2021,9,1,36,46,1,0,0,1,0,1,1,2,0,0,0,0,7,2,2,11
1159,136851,2021,France,Slovenia,0,0,2,2,10/06/2021,9,0,9,18,0,0,0,0,0,1,2,3,0,0,0,0,1,2,0,3
1160,136851,2021,France,Russia,0,3,13,16,09/06/2021,33,0,53,86,2,0,0,2,0,5,4,9,0,0,2,2,4,0,1,5
1161,136851,2021,France,Japan,1,4,12,17,05/06/2021,25,0,82,107,4,0,1,5,2,2,1,5,0,0,0,0,3,5,0,8
1162,136851,2021,Serbia,France,0,0,0,0,04/06/2021,0,0,0,0,0,0,0,0,0,0,0,0,0,0,0,0,0,0,0,0
1163,136851,2021,Australia,France,0,2,8,10,30/05/2021,26,0,42,68,4,1,1,6,3,2,2,7,0,0,1,1,4,1,1,6
1164,136851,2021,Germany,France,0,0,8,8,29/05/2021,15,0,2,17,1,0,2,3,1,2,0,3,0,0,0,0,2,1,2,5
1165,136851,2021,France,Bulgaria,0,6,6,12,28/05/2021,3,0,62,65,3,0,0,3,1,0,0,1,0,0,0,0,0,0,0,0
1166,142710,2021,France,Slovenia,1,2,7,10,27/06/2021,0,0,3,3,13,3,8,24,1,5,2,8,0,0,2,2,7,0,1,8
1167,142710,2021,Brazil,France,0,0,1,1,26/06/2021,0,0,0,0,2,1,2,5,0,0,1,1,0,0,0,0,0,1,0,1
1168,142710,2021,France,Poland,0,1,6,7,23/06/2021,0,0,0,0,5,4,3,12,3,0,2,5,0,0,0,0,3,0,0,3
1169,142710,2021,France,Argentina,0,0,0,0,22/06/2021,0,0,0,0,0,0,0,0,0,0,0,0,0,0,0,0,0,0,0,0
1170,142710,2021,France,Iran,1,5,3,9,21/06/2021,0,0,1,1,15,3,8,26,1,2,1,4,0,0,0,0,1,1,1,3
1171,142710,2021,France,Italy,0,3,13,16,17/06/2021,0,0,1,1,21,7,21,49,0,3,1,4,0,0,0,0,3,6,0,9
1172,142710,2021,USA,France,0,2,3,5,16/06/2021,0,0,1,1,10,2,4,16,0,1,1,2,0,0,0,0,2,2,1,5
1173,142710,2021,Netherlands,France,0,0,0,0,15/06/2021,0,0,0,0,0,0,0,0,0,0,0,0,0,0,0,0,0,0,0,0
1174,142710,2021,France,Slovenia,0,5,7,12,10/06/2021,0,0,1,1,8,7,7,22,0,1,3,4,0,0,0,0,2,4,2,8
1175,142710,2021,France,Russia,0,0,0,0,09/06/2021,0,0,0,0,0,0,0,0,0,0,0,0,0,0,0,0,0,0,0,0
1176,142710,2021,Serbia,France,2,3,12,17,04/06/2021,0,0,0,0,22,5,12,39,2,4,0,6,0,0,0,0,5,5,2,12
1177,142710,2021,Brazil,France,0,0,0,0,03/06/2021,0,0,0,0,0,0,0,0,0,0,0,0,0,0,0,0,0,0,0,0
1178,142710,2021,Australia,France,0,0,0,0,30/05/2021,0,0,0,0,0,0,0,0,0,0,0,0,0,0,0,0,0,0,0,0
1179,142710,2021,Germany,France,0,3,11,14,29/05/2021,0,0,0,0,17,5,10,32,3,1,6,10,0,0,0,0,7,4,0,11
1180,142710,2021,France,Bulgaria,0,0,0,0,28/05/2021,0,0,0,0,0,0,0,0,0,0,0,0,0,0,0,0,0,0,0,0
1181,125073,2021,France,Slovenia,0,1,11,12,27/06/2021,0,0,2,2,3,1,4,8,3,1,3,7,0,0,0,0,3,0,0,3
1182,125073,2021,Brazil,France,0,1,6,7,26/06/2021,0,0,0,0,3,2,1,6,1,1,1,3,0,0,0,0,1,2,1,4
1183,125073,2021,France,Poland,0,2,14,16,23/06/2021,0,0,1,1,8,1,7,16,2,7,11,20,0,0,0,0,3,0,0,3
1184,125073,2021,France,Argentina,0,0,0,0,22/06/2021,0,0,0,0,0,0,0,0,0,0,0,0,0,0,0,0,0,0,0,0
1185,125073,2021,France,Iran,1,1,10,12,21/06/2021,0,0,1,1,4,1,1,6,4,2,1,7,0,0,1,1,2,0,0,2
1186,125073,2021,France,Italy,0,0,0,0,17/06/2021,0,0,0,0,0,0,0,0,0,0,0,0,0,0,0,0,0,0,0,0
1187,125073,2021,USA,France,0,0,15,15,16/06/2021,0,0,2,2,4,1,3,8,0,4,4,8,1,0,1,2,2,0,0,2
1188,125073,2021,Netherlands,France,0,3,11,14,15/06/2021,0,0,2,2,11,2,4,17,4,3,5,12,0,0,0,0,3,0,1,4
1189,125073,2021,Canada,France,0,0,0,0,11/06/2021,0,0,0,0,0,0,0,0,0,0,0,0,0,0,0,0,0,0,0,0
1190,125073,2021,France,Slovenia,0,1,13,14,10/06/2021,0,0,2,2,4,1,1,6,2,1,4,7,0,0,1,1,2,0,0,2
1191,125073,2021,France,Russia,0,1,9,10,09/06/2021,0,0,0,0,7,1,2,10,5,3,6,14,0,0,0,0,1,0,0,1
1192,125073,2021,France,Japan,0,0,0,0,05/06/2021,0,0,0,0,0,0,0,0,0,0,0,0,0,0,0,0,0,0,0,0
1193,125073,2021,Serbia,France,0,0,0,0,04/06/2021,0,0,0,0,0,0,0,0,0,0,0,0,0,0,0,0,0,0,0,0
1194,125073,2021,Brazil,France,1,1,13,15,03/06/2021,0,0,2,2,2,1,1,4,4,6,4,14,0,0,0,0,1,2,0,3
1195,125073,2021,Australia,France,0,2,8,10,30/05/2021,0,0,0,0,1,0,3,4,1,4,7,12,0,0,0,0,2,0,1,3
1196,125073,2021,Germany,France,0,0,0,0,29/05/2021,0,0,0,0,0,0,0,0,0,0,0,0,0,0,0,0,0,0,0,0
1197,125073,2021,France,Bulgaria,1,1,6,8,28/05/2021,0,0,1,1,4,2,3,9,2,2,0,4,0,0,1,1,0,0,0,0
1198,142677,2021,France,Slovenia,0,0,0,0,27/06/2021,0,0,0,0,0,0,0,0,0,0,0,0,0,0,0,0,0,0,0,0
1199,142677,2021,Brazil,France,0,0,0,0,26/06/2021,0,0,0,0,0,0,0,0,0,0,0,0,0,0,0,0,0,0,0,0
1200,142677,2021,France,Poland,0,0,0,0,23/06/2021,0,0,0,0,0,0,0,0,0,0,0,0,0,0,0,0,0,0,0,0
1201,142677,2021,France,Argentina,0,4,4,8,22/06/2021,0,0,0,0,6,0,2,8,2,1,2,5,0,0,1,1,2,0,0,2
1202,142677,2021,France,Iran,0,0,0,0,21/06/2021,0,0,0,0,0,0,0,0,0,0,0,0,0,0,0,0,0,0,0,0
1203,142677,2021,France,Italy,2,4,10,16,17/06/2021,0,0,0,0,10,1,3,14,1,0,3,4,0,0,0,0,2,1,0,3
1204,142677,2021,USA,France,0,0,0,0,16/06/2021,0,0,0,0,0,0,0,0,0,0,0,0,0,0,0,0,0,0,0,0
1205,142677,2021,Netherlands,France,0,0,0,0,15/06/2021,0,0,0,0,0,0,0,0,0,0,0,0,0,0,0,0,0,0,0,0
1206,142677,2021,Canada,France,2,2,15,19,11/06/2021,0,0,0,0,4,2,2,8,2,2,2,6,0,0,0,0,2,1,0,3
1207,142677,2021,France,Slovenia,2,3,10,15,10/06/2021,0,0,0,0,5,3,8,16,0,8,5,13,0,0,1,1,2,1,0,3
1208,142677,2021,France,Russia,0,0,0,0,09/06/2021,0,0,0,0,0,0,0,0,0,0,0,0,0,0,0,0,0,0,0,0
1209,142677,2021,France,Japan,1,1,8,10,05/06/2021,0,0,0,0,7,3,1,11,0,5,0,5,1,0,0,1,0,1,0,1
1210,142677,2021,Serbia,France,1,4,6,11,04/06/2021,0,0,0,0,8,3,2,13,3,4,5,12,2,0,0,2,2,0,1,3
1211,142677,2021,Brazil,France,0,0,0,0,03/06/2021,0,0,0,0,0,0,0,0,0,0,0,0,0,0,0,0,0,0,0,0
1212,142677,2021,Australia,France,0,4,7,11,30/05/2021,0,0,0,0,0,2,7,9,2,4,4,10,0,1,1,2,2,3,1,6
1213,142677,2021,Germany,France,0,5,9,14,29/05/2021,0,0,0,0,12,1,0,13,1,5,2,8,0,0,0,0,2,0,0,2
1214,142677,2021,France,Bulgaria,0,0,0,0,28/05/2021,0,0,0,0,0,0,0,0,0,0,0,0,0,0,0,0,0,0,0,0
1215,132948,2021,France,Slovenia,0,1,8,9,27/06/2021,0,0,2,2,6,1,8,15,2,3,1,6,7,1,7,15,8,1,0,9
1216,132948,2021,Brazil,France,0,1,5,6,26/06/2021,0,0,0,0,3,3,6,12,0,2,0,2,6,1,11,18,1,2,0,3
1217,132948,2021,France,Poland,0,1,6,7,23/06/2021,0,0,1,1,10,2,6,18,0,2,1,3,5,0,4,9,2,0,0,2
1218,132948,2021,France,Argentina,0,3,8,11,22/06/2021,0,0,1,1,8,4,7,19,1,3,4,8,4,0,16,20,3,2,1,6
1219,132948,2021,France,Iran,1,1,2,4,21/06/2021,0,0,0,0,2,1,2,5,1,0,0,1,0,0,0,0,1,0,0,1
1220,132948,2021,France,Italy,0,1,9,10,17/06/2021,0,0,1,1,5,1,4,10,1,1,0,2,1,0,10,11,1,2,0,3
1221,132948,2021,USA,France,0,2,6,8,16/06/2021,0,0,2,2,5,6,7,18,2,1,1,4,6,2,5,13,5,0,0,5
1222,132948,2021,Canada,France,1,0,8,9,11/06/2021,0,0,3,3,7,3,4,14,4,1,1,6,3,0,7,10,4,2,0,6
1223,132948,2021,France,Russia,0,3,13,16,09/06/2021,0,0,2,2,13,2,9,24,1,2,2,5,5,2,14,21,5,3,2,10
1224,132948,2021,France,Japan,0,2,11,13,05/06/2021,0,0,0,0,12,2,3,17,1,2,0,3,8,0,10,18,4,1,0,5
1225,132948,2021,Brazil,France,0,0,3,3,03/06/2021,0,0,0,0,3,0,2,5,0,0,1,1,4,0,3,7,0,1,1,2
1226,132948,2021,Australia,France,0,0,1,1,30/05/2021,0,0,0,0,0,0,0,0,0,0,0,0,0,0,0,0,0,1,0,1
1227,132948,2021,Germany,France,5,1,18,24,29/05/2021,0,0,1,1,14,5,9,28,2,4,2,8,17,0,12,29,9,2,1,12
1228,132948,2021,France,Bulgaria,0,0,7,7,28/05/2021,0,0,0,0,4,0,1,5,0,0,0,0,4,0,2,6,0,0,0,0
1229,136867,2021,France,Italy,0,1,11,12,17/06/2021,0,0,1,1,8,4,2,14,0,0,0,0,6,1,7,14,0,1,0,1
1230,136867,2021,USA,France,0,0,2,2,16/06/2021,0,0,1,1,0,0,0,0,0,0,0,0,0,0,0,0,0,0,0,0
1231,136867,2021,Netherlands,France,2,3,6,11,15/06/2021,0,0,3,3,8,2,2,12,0,1,0,1,6,1,7,14,3,2,1,6
1232,136867,2021,France,Slovenia,2,4,12,18,10/06/2021,0,0,1,1,12,3,11,26,0,2,2,4,12,0,14,26,10,6,1,17
1233,136867,2021,France,Russia,0,2,1,3,09/06/2021,0,0,0,0,0,0,0,0,0,0,0,0,0,0,0,0,0,0,0,0
1234,136867,2021,Serbia,France,2,4,9,15,04/06/2021,0,0,1,1,5,4,5,14,0,2,0,2,9,1,13,23,2,2,0,4
1235,136867,2021,Brazil,France,0,1,4,5,03/06/2021,0,0,0,0,0,0,0,0,0,0,0,0,0,0,0,0,2,0,0,2
1236,136867,2021,Australia,France,2,2,4,8,30/05/2021,0,0,0,0,5,1,3,9,0,0,1,1,4,0,3,7,2,0,0,2
1237,136867,2021,Germany,France,0,3,11,14,29/05/2021,0,0,0,0,9,1,11,21,0,1,0,1,7,2,10,19,2,2,1,5
1238,136867,2021,France,Bulgaria,0,1,2,3,28/05/2021,0,0,0,0,0,0,0,0,0,0,0,0,0,0,0,0,0,0,0,0
1239,120735,2021,France,Slovenia,0,0,1,1,27/06/2021,0,0,0,0,0,0,0,0,0,0,0,0,0,0,0,0,0,1,0,1
1240,120735,2021,Brazil,France,0,1,1,2,26/06/2021,0,0,0,0,0,0,0,0,0,0,0,0,0,0,0,0,0,0,0,0
1241,120735,2021,France,Poland,0,1,1,2,23/06/2021,0,0,0,0,0,0,0,0,0,0,0,0,0,0,0,0,0,0,1,1
1242,120735,2021,France,Argentina,1,2,11,14,22/06/2021,0,0,2,2,5,3,7,15,2,0,0,2,5,0,13,18,4,1,0,5
1243,120735,2021,France,Iran,0,0,0,0,21/06/2021,0,0,0,0,0,0,0,0,0,0,0,0,0,0,0,0,0,0,0,0
1244,120735,2021,France,Italy,0,3,3,6,17/06/2021,0,0,0,0,4,2,10,16,0,2,0,2,4,2,24,30,5,6,0,11
1245,120735,2021,USA,France,0,0,0,0,16/06/2021,0,0,0,0,0,0,0,0,0,0,0,0,0,0,0,0,0,0,0,0
1246,120735,2021,Netherlands,France,0,2,11,13,15/06/2021,0,0,2,2,10,4,11,25,1,6,3,10,7,5,25,37,6,2,0,8
1247,120735,2021,Canada,France,0,0,0,0,11/06/2021,0,0,0,0,0,0,0,0,0,0,0,0,0,0,0,0,0,0,0,0
1248,120735,2021,France,Japan,1,1,7,9,05/06/2021,0,0,1,1,4,2,6,12,0,2,0,2,8,1,11,20,1,0,0,1
1249,120735,2021,Serbia,France,1,2,8,11,04/06/2021,0,0,0,0,11,4,11,26,0,2,0,2,4,0,11,15,5,1,0,6
1250,120735,2021,Germany,France,0,1,3,4,29/05/2021,0,0,0,0,1,2,4,7,0,1,0,1,7,0,2,9,2,0,0,2
1251,120735,2021,France,Bulgaria,1,4,4,9,28/05/2021,0,1,0,1,8,0,6,14,1,1,1,3,7,2,4,13,0,0,1,1
1252,152506,2021,France,Slovenia,0,0,0,0,27/06/2021,0,0,0,0,0,0,0,0,0,0,0,0,0,0,0,0,0,0,0,0
1253,152506,2021,Brazil,France,0,0,0,0,26/06/2021,0,0,0,0,0,0,0,0,0,0,0,0,0,0,0,0,0,0,0,0
1254,152506,2021,France,Poland,0,0,0,0,23/06/2021,0,0,0,0,0,0,0,0,0,0,0,0,0,0,0,0,0,0,0,0
1255,152506,2021,France,Argentina,0,0,0,0,22/06/2021,0,0,0,0,0,0,0,0,0,0,0,0,0,0,0,0,0,0,0,0
1256,152506,2021,France,Iran,0,0,0,0,21/06/2021,0,0,0,0,0,0,0,0,0,0,0,0,0,0,0,0,0,0,0,0
1257,152506,2021,France,Italy,0,0,0,0,17/06/2021,0,0,4,4,0,0,0,0,0,0,0,0,10,1,8,19,6,6,0,12
1258,152506,2021,USA,France,0,0,0,0,16/06/2021,0,0,0,0,0,0,0,0,0,0,0,0,0,0,0,0,0,0,0,0
1259,152506,2021,Netherlands,France,0,0,0,0,15/06/2021,0,0,0,0,0,0,0,0,0,0,0,0,0,0,0,0,0,0,0,0
1260,152506,2021,Canada,France,0,0,0,0,11/06/2021,0,0,0,0,0,0,0,0,0,0,0,0,0,0,0,0,0,0,0,0
1261,152506,2021,France,Slovenia,0,0,0,0,10/06/2021,0,0,0,0,0,0,0,0,0,0,0,0,0,0,0,0,0,0,0,0
1262,152506,2021,France,Russia,0,0,0,0,09/06/2021,0,0,0,0,0,0,0,0,0,0,0,0,0,0,0,0,0,0,0,0
1263,152506,2021,France,Japan,0,0,0,0,05/06/2021,0,0,0,0,0,0,0,0,0,0,0,0,0,0,0,0,1,0,0,1
1264,152506,2021,Serbia,France,0,0,0,0,04/06/2021,0,0,0,0,0,0,0,0,0,0,0,0,0,0,0,0,0,0,0,0
1265,152506,2021,Brazil,France,0,0,0,0,03/06/2021,0,0,0,0,0,0,0,0,0,0,0,0,0,0,0,0,0,0,0,0
1266,152506,2021,Australia,France,0,0,0,0,30/05/2021,0,0,3,3,0,0,0,0,0,0,0,0,4,1,7,12,6,2,1,9
1267,152506,2021,Germany,France,0,0,0,0,29/05/2021,0,0,0,0,0,0,0,0,0,0,0,0,2,3,4,9,3,4,0,7
1268,152506,2021,France,Bulgaria,0,0,0,0,28/05/2021,0,0,5,5,0,0,0,0,0,0,0,0,7,0,6,13,9,0,1,10
1269,163309,2021,Netherlands,France,4,6,22,32,15/06/2021,0,0,2,2,23,3,14,40,3,7,7,17,0,0,0,0,8,5,2,15
1270,163309,2021,Canada,France,0,1,1,2,11/06/2021,0,0,0,0,4,5,4,13,1,1,2,4,0,0,0,0,0,2,0,2
1271,163309,2021,France,Slovenia,0,0,4,4,10/06/2021,0,0,0,0,2,2,2,6,0,0,2,2,0,0,0,0,1,1,2,4
1272,163309,2021,France,Japan,0,0,0,0,05/06/2021,0,0,0,0,0,0,0,0,0,0,0,0,0,0,0,0,0,0,0,0
1273,163309,2021,Serbia,France,0,0,0,0,04/06/2021,0,0,0,0,0,0,0,0,0,0,0,0,0,0,0,0,0,0,0,0
1274,152514,2021,France,Japan,0,0,0,0,05/06/2021,0,0,0,0,0,0,0,0,0,0,0,0,0,0,0,0,0,0,0,0
1275,152514,2021,Brazil,France,0,0,0,0,03/06/2021,0,0,0,0,0,0,0,0,0,0,0,0,0,0,0,0,0,0,0,0
1276,152514,2021,Australia,France,0,1,4,5,30/05/2021,11,0,16,27,1,0,0,1,1,1,1,3,0,0,0,0,0,1,0,1
1277,181197,2021,France,Slovenia,0,0,0,0,27/06/2021,0,0,0,0,0,0,0,0,0,0,0,0,0,0,0,0,0,0,0,0
1278,181197,2021,Brazil,France,0,0,0,0,26/06/2021,0,0,0,0,0,0,0,0,0,0,0,0,0,0,0,0,0,0,0,0
1279,181197,2021,France,Poland,0,0,0,0,23/06/2021,0,0,0,0,0,0,0,0,0,0,0,0,0,0,0,0,0,0,0,0
1280,181197,2021,France,Argentina,0,0,0,0,22/06/2021,0,0,0,0,0,0,0,0,0,0,0,0,0,0,0,0,0,0,0,0
1281,181197,2021,France,Iran,0,0,0,0,21/06/2021,0,0,0,0,0,0,0,0,0,0,0,0,0,0,0,0,0,0,0,0
1282,181197,2021,France,Italy,0,0,4,4,17/06/2021,0,0,0,0,5,0,2,7,2,3,1,6,0,0,0,0,1,0,0,1
1283,181197,2021,Netherlands,France,0,0,0,0,15/06/2021,0,0,0,0,0,0,0,0,0,0,0,0,0,0,0,0,0,0,0,0
1284,181197,2021,Canada,France,0,0,0,0,11/06/2021,0,0,0,0,0,0,0,0,0,0,0,0,0,0,0,0,0,0,0,0
1285,181197,2021,France,Slovenia,0,0,0,0,10/06/2021,0,0,0,0,0,0,0,0,0,0,0,0,0,0,0,0,0,0,0,0
1286,181197,2021,France,Russia,0,0,0,0,09/06/2021,0,0,0,0,0,0,0,0,0,0,0,0,0,0,0,0,0,0,0,0
1287,181197,2021,France,Japan,0,0,0,0,05/06/2021,0,0,0,0,0,0,0,0,0,0,0,0,0,0,0,0,0,0,0,0
1288,181197,2021,Serbia,France,0,0,0,0,04/06/2021,0,0,0,0,0,0,0,0,0,0,0,0,0,0,0,0,0,0,0,0
1289,181197,2021,Brazil,France,0,0,0,0,03/06/2021,0,0,0,0,0,0,0,0,0,0,0,0,0,0,0,0,0,0,0,0
1290,181197,2021,Australia,France,1,2,5,8,30/05/2021,0,0,0,0,3,2,2,7,0,3,1,4,0,0,1,1,1,0,0,1
1291,181197,2021,Germany,France,0,0,0,0,29/05/2021,0,0,0,0,0,0,0,0,0,0,0,0,0,0,0,0,0,0,0,0
1292,181197,2021,France,Bulgaria,0,0,0,0,28/05/2021,0,0,0,0,0,0,0,0,0,0,0,0,0,0,0,0,0,0,0,0
1293,119779,2021,Italy,Germany,0,0,0,0,23/06/2021,0,0,0,0,0,0,0,0,0,0,0,0,0,0,0,0,0,0,0,0
1294,119779,2021,Brazil,Germany,0,2,8,10,22/06/2021,0,0,3,3,3,3,13,19,0,1,1,2,3,2,11,16,1,2,0,3
1295,119779,2021,Germany,Russia,0,0,0,0,21/06/2021,0,0,1,1,0,0,1,1,0,0,0,0,0,0,0,0,0,0,0,0
1296,119779,2021,Germany,Poland,0,3,7,10,17/06/2021,0,0,3,3,11,5,11,27,0,3,1,4,4,0,12,16,4,1,0,5
1297,119779,2021,Canada,Germany,0,0,0,0,16/06/2021,0,0,0,0,1,0,0,1,0,1,0,1,0,0,0,0,0,0,0,0
1298,119779,2021,Japan,Germany,0,0,0,0,15/06/2021,0,0,0,0,0,0,0,0,0,0,0,0,0,0,0,0,0,0,0,0
1299,119779,2021,Iran,Germany,0,0,0,0,11/06/2021,0,0,0,0,0,0,0,0,0,0,0,0,0,0,0,0,0,0,0,0
1300,119779,2021,Germany,USA,0,1,3,4,10/06/2021,0,1,2,3,3,3,6,12,0,0,0,0,1,0,12,13,2,0,0,2
1301,119779,2021,Serbia,Germany,0,2,4,6,09/06/2021,0,0,1,1,8,3,9,20,0,2,2,4,2,1,2,5,4,2,1,7
1302,119779,2021,Slovenia,Germany,1,4,5,10,05/06/2021,0,0,1,1,18,2,16,36,1,0,2,3,7,2,8,17,7,0,0,7
1303,119779,2021,Netherlands,Germany,2,2,1,5,04/06/2021,0,0,2,2,2,0,1,3,0,1,0,1,2,1,5,8,0,0,0,0
1304,119779,2021,Germany,Argentina,0,0,0,0,03/06/2021,0,0,0,0,0,0,0,0,0,0,0,0,0,0,0,0,0,0,0,0
1305,119779,2021,Germany,Bulgaria,0,2,6,8,30/05/2021,0,0,0,0,6,1,4,11,0,0,2,2,0,1,3,4,2,1,0,3
1306,119779,2021,Germany,France,0,0,0,0,29/05/2021,0,0,0,0,0,0,0,0,0,0,0,0,0,0,0,0,0,0,0,0
1307,119779,2021,Germany,Australia,0,4,9,13,28/05/2021,0,0,1,1,14,1,5,20,1,4,1,6,2,0,4,6,2,0,0,2
1308,136441,2021,Italy,Germany,3,3,15,21,23/06/2021,0,1,8,9,10,5,16,31,1,5,0,6,15,2,26,43,10,1,1,12
1309,136441,2021,Brazil,Germany,1,4,5,10,22/06/2021,0,0,5,5,12,0,10,22,0,4,1,5,10,1,10,21,1,5,0,6
1310,136441,2021,Germany,Russia,0,2,3,5,21/06/2021,0,0,0,0,0,0,0,0,0,0,0,0,0,0,0,0,0,0,0,0
1311,136441,2021,Germany,Poland,0,0,0,0,17/06/2021,0,0,0,0,0,0,0,0,0,0,0,0,0,0,0,0,0,0,0,0
1312,136441,2021,Canada,Germany,0,3,7,10,16/06/2021,0,0,1,1,4,4,8,16,0,5,0,5,13,1,6,20,6,6,0,12
1313,136441,2021,Japan,Germany,0,2,3,5,15/06/2021,0,0,0,0,7,1,8,16,0,1,1,2,6,2,10,18,2,5,0,7
1314,136441,2021,Iran,Germany,1,3,3,7,11/06/2021,0,0,1,1,1,0,3,4,1,2,0,3,2,1,2,5,2,2,0,4
1315,136441,2021,Germany,USA,0,3,8,11,10/06/2021,0,0,4,4,3,3,7,13,0,2,1,3,6,1,5,12,4,1,1,6
1316,136441,2021,Serbia,Germany,4,3,10,17,09/06/2021,0,1,7,8,9,5,7,21,0,0,2,2,10,3,23,36,8,3,3,14
1317,136441,2021,Slovenia,Germany,2,3,8,13,05/06/2021,0,1,5,6,9,3,5,17,0,1,1,2,3,1,11,15,8,4,2,14
1318,136441,2021,Netherlands,Germany,1,5,16,22,04/06/2021,0,0,2,2,10,2,7,19,0,2,2,4,16,3,13,32,7,4,1,12
1319,136441,2021,Germany,Argentina,1,5,13,19,03/06/2021,0,0,8,8,6,2,10,18,1,6,6,13,15,1,15,31,5,3,1,9
1320,136441,2021,Germany,Bulgaria,3,2,10,15,30/05/2021,0,0,0,0,5,4,8,17,0,2,2,4,4,2,13,19,8,0,0,8
1321,136441,2021,Germany,France,1,1,17,19,29/05/2021,0,0,0,0,9,1,5,15,0,3,0,3,13,1,16,30,7,0,0,7
1322,136441,2021,Germany,Australia,1,1,2,4,28/05/2021,0,0,0,0,0,0,0,0,0,0,0,0,0,0,0,0,0,0,0,0
1323,139386,2021,Italy,Germany,1,3,9,13,23/06/2021,0,0,2,2,6,6,9,21,2,0,2,4,4,1,6,11,6,3,0,9
1324,139386,2021,Brazil,Germany,0,0,1,1,22/06/2021,0,0,1,1,0,0,0,0,0,0,0,0,1,0,1,2,0,0,0,0
1325,139386,2021,Germany,Russia,0,3,11,14,21/06/2021,0,0,5,5,12,4,13,29,0,4,2,6,8,3,13,24,3,1,1,5
1326,139386,2021,Germany,Poland,0,0,0,0,17/06/2021,0,0,0,0,2,0,0,2,0,0,0,0,0,0,1,1,0,1,0,1
1327,139386,2021,Canada,Germany,0,0,0,0,16/06/2021,0,0,0,0,0,0,0,0,0,0,0,0,0,0,0,0,0,0,0,0
1328,139386,2021,Japan,Germany,2,2,8,12,15/06/2021,0,0,1,1,8,1,8,17,0,1,1,2,3,0,7,10,2,0,0,2
1329,139386,2021,Iran,Germany,0,4,17,21,11/06/2021,0,0,0,0,7,1,9,17,0,2,0,2,5,0,8,13,2,2,2,6
1330,139386,2021,Germany,USA,0,1,0,1,10/06/2021,0,0,0,0,0,0,0,0,0,0,0,0,0,1,0,1,1,0,0,1
1331,139386,2021,Serbia,Germany,0,2,6,8,09/06/2021,0,0,0,0,4,1,5,10,0,1,0,1,0,1,2,3,4,1,1,6
1332,139386,2021,Slovenia,Germany,0,0,2,2,05/06/2021,1,0,0,1,0,0,0,0,0,0,0,0,0,0,2,2,1,0,0,1
1333,139386,2021,Netherlands,Germany,1,3,13,17,04/06/2021,0,0,3,3,9,3,9,21,0,3,4,7,3,2,7,12,5,0,0,5
1334,139386,2021,Germany,Argentina,0,2,17,19,03/06/2021,0,1,3,4,9,3,8,20,0,2,0,2,11,1,15,27,3,1,1,5
1335,139386,2021,Germany,Bulgaria,0,3,5,8,30/05/2021,0,0,0,0,6,3,7,16,1,1,0,2,4,0,14,18,3,0,0,3
1336,139386,2021,Germany,France,0,6,8,14,29/05/2021,0,0,0,0,15,7,23,45,4,1,1,6,12,0,16,28,7,3,1,11
1337,139386,2021,Germany,Australia,0,1,0,1,28/05/2021,0,0,1,1,0,0,0,0,0,0,0,0,0,0,1,1,0,0,0,0
1338,119775,2021,Italy,Germany,0,0,0,0,23/06/2021,0,0,0,0,0,0,0,0,0,0,0,0,0,0,0,0,0,0,0,0
1339,119775,2021,Brazil,Germany,0,0,0,0,22/06/2021,0,0,0,0,0,0,0,0,0,0,0,0,0,0,0,0,0,0,0,0
1340,119775,2021,Germany,Russia,0,4,12,16,21/06/2021,0,0,5,5,9,1,7,17,1,3,1,5,8,2,19,29,6,1,3,10
1341,119775,2021,Germany,Poland,0,0,0,0,17/06/2021,0,0,0,0,0,0,0,0,0,0,0,0,0,0,0,0,0,0,0,0
1342,119775,2021,Canada,Germany,0,2,10,12,16/06/2021,0,0,3,3,6,0,7,13,1,2,0,3,6,0,15,21,7,2,0,9
1343,119775,2021,Japan,Germany,0,1,5,6,15/06/2021,0,0,3,3,3,3,3,9,0,1,0,1,6,0,10,16,1,1,0,2
1344,119775,2021,Iran,Germany,0,3,13,16,11/06/2021,0,0,3,3,12,1,10,23,1,0,4,5,3,0,17,20,6,3,0,9
1345,119775,2021,Germany,USA,0,0,0,0,10/06/2021,0,0,0,0,0,0,0,0,0,0,0,0,0,0,0,0,0,0,0,0
1346,119775,2021,Netherlands,Germany,0,0,0,0,04/06/2021,0,0,0,0,0,0,0,0,0,0,0,0,0,0,0,0,0,0,0,0
1347,119775,2021,Germany,Argentina,0,0,0,0,03/06/2021,0,0,0,0,0,0,0,0,0,0,0,0,0,0,0,0,0,0,0,0
1348,119775,2021,Germany,Bulgaria,1,4,14,19,30/05/2021,0,0,0,0,10,6,10,26,1,0,2,3,2,4,4,10,7,1,1,9
1349,119775,2021,Germany,France,0,0,0,0,29/05/2021,0,0,0,0,0,0,0,0,0,0,0,0,0,0,0,0,0,0,0,0
1350,119775,2021,Germany,Australia,1,3,7,11,28/05/2021,0,0,0,0,7,1,7,15,1,1,0,2,4,0,10,14,7,0,0,7
1351,156599,2021,Italy,Germany,0,4,5,9,23/06/2021,0,0,2,2,1,2,5,8,0,1,2,3,0,1,8,9,2,0,1,3
1352,156599,2021,Brazil,Germany,0,0,1,1,22/06/2021,0,0,0,0,0,0,0,0,0,0,0,0,0,0,0,0,0,0,0,0
1353,156599,2021,Germany,Russia,0,1,1,2,21/06/2021,0,0,0,0,0,0,0,0,0,0,0,0,0,0,0,0,0,0,0,0
1354,156599,2021,Germany,Poland,1,3,5,9,17/06/2021,0,0,3,3,8,2,5,15,0,0,3,3,4,0,19,23,6,3,0,9
1355,156599,2021,Canada,Germany,0,2,0,2,16/06/2021,0,0,0,0,0,0,0,0,0,0,0,0,0,0,0,0,0,0,0,0
1356,156599,2021,Japan,Germany,0,1,1,2,15/06/2021,0,0,0,0,0,0,0,0,0,0,0,0,0,0,0,0,0,0,0,0
1357,156599,2021,Slovenia,Germany,0,3,5,8,05/06/2021,0,0,6,6,5,2,6,13,0,3,1,4,1,2,6,9,4,2,0,6
1358,156599,2021,Netherlands,Germany,0,2,3,5,04/06/2021,0,0,0,0,0,0,0,0,0,0,0,0,0,0,0,0,1,0,0,1
1359,156599,2021,Germany,Argentina,0,1,4,5,03/06/2021,0,0,0,0,3,1,1,5,1,1,0,2,0,0,2,2,0,0,1,1
1360,156599,2021,Germany,Bulgaria,2,1,5,8,30/05/2021,1,0,0,1,0,0,0,0,0,0,0,0,0,0,0,0,0,0,0,0
1361,156599,2021,Germany,France,2,2,6,10,29/05/2021,0,0,0,0,0,0,0,0,0,0,0,0,0,0,0,0,0,0,0,0
1362,156599,2021,Germany,Australia,0,0,0,0,28/05/2021,0,0,0,0,0,0,0,0,0,0,0,0,0,0,0,0,0,0,0,0
1363,116015,2021,Italy,Germany,0,1,6,7,23/06/2021,0,0,0,0,4,1,2,7,0,5,0,5,0,0,1,1,1,0,1,2
1364,116015,2021,Brazil,Germany,0,0,0,0,22/06/2021,0,0,0,0,0,0,0,0,0,0,0,0,0,0,0,0,0,0,0,0
1365,116015,2021,Germany,Russia,0,0,0,0,21/06/2021,0,0,0,0,0,0,0,0,0,0,0,0,0,0,0,0,0,0,0,0
1366,116015,2021,Germany,Poland,0,1,10,11,17/06/2021,0,0,0,0,3,2,1,6,1,6,2,9,0,0,1,1,1,1,0,2
1367,116015,2021,Canada,Germany,0,0,0,0,16/06/2021,0,0,0,0,0,0,0,0,0,0,0,0,0,0,0,0,0,0,0,0
1368,116015,2021,Japan,Germany,0,0,0,0,15/06/2021,0,0,0,0,0,0,0,0,0,0,0,0,0,0,0,0,0,0,0,0
1369,116015,2021,Serbia,Germany,0,0,0,0,09/06/2021,0,0,0,0,0,0,0,0,0,0,0,0,0,0,0,0,0,0,0,0
1370,116015,2021,Slovenia,Germany,0,0,0,0,05/06/2021,0,0,0,0,0,0,0,0,0,0,0,0,0,0,0,0,0,0,0,0
1371,116015,2021,Netherlands,Germany,0,0,2,2,04/06/2021,0,0,0,0,1,0,2,3,0,1,0,1,0,0,0,0,1,1,0,2
1372,116015,2021,Germany,Argentina,0,0,8,8,03/06/2021,0,0,0,0,4,0,2,6,1,7,4,12,0,0,0,0,0,0,1,1
1373,116015,2021,Germany,Bulgaria,0,0,6,6,30/05/2021,0,0,0,0,5,1,2,8,1,3,3,7,0,0,0,0,1,0,1,2
1374,116015,2021,Germany,France,0,0,6,6,29/05/2021,0,0,0,0,8,0,4,12,1,5,0,6,0,0,1,1,0,1,0,1
1375,116015,2021,Germany,Australia,0,0,0,0,28/05/2021,0,0,0,0,0,0,0,0,0,0,0,0,0,0,0,0,0,0,0,0
1376,152470,2021,Italy,Germany,0,0,0,0,23/06/2021,0,0,7,7,0,0,0,0,0,0,0,0,8,1,13,22,11,6,3,20
1377,152470,2021,Brazil,Germany,0,0,0,0,22/06/2021,0,0,4,4,0,0,0,0,0,0,0,0,5,0,10,15,8,2,1,11
1378,152470,2021,Germany,Russia,0,0,0,0,21/06/2021,0,0,4,4,0,0,0,0,0,0,0,0,7,2,11,20,8,2,1,11
1379,152470,2021,Germany,Poland,0,0,0,0,17/06/2021,0,0,7,7,0,0,0,0,0,0,0,0,5,1,7,13,6,3,2,11
1380,152470,2021,Canada,Germany,0,0,0,0,16/06/2021,0,0,5,5,0,0,0,0,0,0,0,0,9,0,11,20,7,3,2,12
1381,152470,2021,Japan,Germany,0,0,0,0,15/06/2021,0,0,4,4,0,0,0,0,0,0,0,0,4,2,11,17,2,6,1,9
1382,152470,2021,Iran,Germany,0,0,0,0,11/06/2021,0,0,3,3,0,0,0,0,0,0,0,0,12,2,17,31,13,8,1,22
1383,152470,2021,Germany,USA,0,0,0,0,10/06/2021,0,0,1,1,0,0,0,0,0,0,0,0,4,2,11,17,7,2,0,9
1384,152470,2021,Serbia,Germany,0,0,0,0,09/06/2021,0,1,5,6,0,0,0,0,0,0,0,0,4,2,17,23,14,2,2,18
1385,152470,2021,Slovenia,Germany,0,0,0,0,05/06/2021,0,0,5,5,0,0,0,0,0,0,0,0,7,0,13,20,15,6,0,21
1386,152470,2021,Netherlands,Germany,0,0,0,0,04/06/2021,0,0,2,2,0,0,0,0,0,0,0,0,17,3,16,36,12,6,4,22
1387,152470,2021,Germany,Argentina,0,0,0,0,03/06/2021,0,0,5,5,0,0,0,0,0,0,0,0,6,0,13,19,8,5,2,15
1388,152470,2021,Germany,Bulgaria,0,0,0,0,30/05/2021,0,0,7,7,0,0,0,0,0,0,0,0,15,2,16,33,14,6,2,22
1389,152470,2021,Germany,France,0,0,0,0,29/05/2021,0,0,0,0,0,0,0,0,0,0,0,0,10,3,14,27,7,1,1,9
1390,152470,2021,Germany,Australia,0,0,0,0,28/05/2021,1,0,2,3,0,0,0,0,0,0,0,0,8,0,10,18,9,0,1,10
1391,116575,2021,,,-,-,-,-,-,-,-,-,-,-,-,-,-,-,-,-,-,-,-,-,-,-,-,-,-
1392,136253,2021,Italy,Germany,1,1,17,19,23/06/2021,0,0,4,4,12,6,15,33,2,1,2,5,0,0,1,1,8,2,0,10
1393,136253,2021,Brazil,Germany,0,0,0,0,22/06/2021,0,0,0,0,1,0,1,2,0,0,0,0,0,0,0,0,0,0,0,0
1394,136253,2021,Germany,Russia,0,1,11,12,21/06/2021,0,0,2,2,9,5,13,27,1,3,2,6,1,0,0,1,7,2,0,9
1395,136253,2021,Germany,Poland,1,2,10,13,17/06/2021,0,0,3,3,7,4,12,23,0,3,3,6,0,1,0,1,3,1,0,4
1396,136253,2021,Canada,Germany,0,0,0,0,16/06/2021,0,0,0,0,2,0,3,5,0,0,1,1,0,0,0,0,0,0,0,0
1397,136253,2021,Japan,Germany,0,0,0,0,15/06/2021,0,0,1,1,0,0,0,0,0,0,0,0,0,0,0,0,0,0,0,0
1398,136253,2021,Iran,Germany,0,0,0,0,11/06/2021,0,0,0,0,0,0,0,0,0,0,0,0,0,0,0,0,0,0,0,0
1399,136253,2021,Germany,USA,0,0,0,0,10/06/2021,0,0,0,0,0,0,0,0,0,0,0,0,0,0,0,0,0,0,0,0
1400,136253,2021,Serbia,Germany,0,0,0,0,09/06/2021,0,0,0,0,0,0,0,0,0,0,0,0,0,0,0,0,0,0,0,0
1401,136253,2021,Netherlands,Germany,0,0,4,4,04/06/2021,0,0,1,1,2,1,2,5,0,0,0,0,0,0,0,0,0,1,1,2
1402,136253,2021,Germany,Argentina,0,2,4,6,03/06/2021,0,0,0,0,6,1,5,12,2,1,1,4,0,0,0,0,0,0,0,0
1403,136253,2021,Germany,Bulgaria,1,3,9,13,30/05/2021,0,0,0,0,10,4,9,23,1,4,1,6,0,0,0,0,4,1,1,6
1404,136253,2021,Germany,France,0,4,9,13,29/05/2021,0,0,0,0,14,4,8,26,1,5,2,8,0,0,0,0,6,1,0,7
1405,136253,2021,Germany,Australia,0,0,0,0,28/05/2021,0,0,0,0,0,0,0,0,1,0,0,1,0,0,0,0,0,0,0,0
1406,156596,2021,Italy,Germany,0,1,4,5,23/06/2021,0,0,0,0,2,0,2,4,1,1,3,5,0,0,0,0,2,0,0,2
1407,156596,2021,Germany,Poland,0,1,11,12,17/06/2021,0,1,0,1,3,0,0,3,0,2,1,3,0,0,1,1,1,1,0,2
1408,156596,2021,Iran,Germany,0,0,2,2,11/06/2021,0,0,0,0,1,0,2,3,0,0,1,1,0,0,0,0,0,0,0,0
1409,156596,2021,Germany,USA,0,0,0,0,10/06/2021,0,0,0,0,0,0,0,0,0,0,0,0,0,0,0,0,0,0,0,0
1410,156596,2021,Serbia,Germany,0,0,3,3,09/06/2021,0,0,0,0,0,0,0,0,0,3,0,3,0,0,0,0,0,0,0,0
1411,156596,2021,Slovenia,Germany,0,0,0,0,05/06/2021,0,0,0,0,0,0,0,0,0,0,0,0,0,0,0,0,0,0,0,0
1412,156596,2021,Netherlands,Germany,0,1,9,10,04/06/2021,0,0,0,0,5,1,0,6,3,5,3,11,0,0,0,0,0,1,0,1
1413,156596,2021,Germany,Bulgaria,0,1,0,1,30/05/2021,0,0,0,0,0,0,0,0,0,0,0,0,0,0,0,0,0,0,0,0
1414,156596,2021,Germany,France,0,0,0,0,29/05/2021,0,0,0,0,0,0,0,0,0,0,0,0,0,0,0,0,0,0,0,0
1415,156596,2021,Germany,Australia,0,0,0,0,28/05/2021,0,0,0,0,0,0,0,0,0,0,0,0,0,0,0,0,0,0,0,0
1416,162788,2021,Italy,Germany,0,0,0,0,23/06/2021,0,0,0,0,0,0,0,0,0,0,0,0,0,0,0,0,0,0,0,0
1417,162788,2021,Brazil,Germany,1,2,2,5,22/06/2021,1,0,5,6,0,0,0,0,0,0,0,0,0,0,0,0,0,0,0,0
1418,162788,2021,Germany,Russia,0,0,1,1,21/06/2021,0,0,7,7,0,0,0,0,0,0,0,0,0,0,0,0,1,0,0,1
1419,162788,2021,Germany,Poland,0,0,0,0,17/06/2021,1,0,4,5,0,0,0,0,0,0,0,0,0,0,0,0,0,1,1,2
1420,162788,2021,Canada,Germany,0,0,0,0,16/06/2021,3,1,5,9,0,0,0,0,0,0,0,0,0,0,1,1,0,0,0,0
1421,162788,2021,Japan,Germany,0,0,0,0,15/06/2021,0,0,1,1,0,0,0,0,0,0,0,0,0,0,0,0,0,0,0,0
1422,162788,2021,Iran,Germany,1,1,1,3,11/06/2021,0,0,0,0,0,0,0,0,0,0,0,0,0,0,0,0,0,0,0,0
1423,162788,2021,Germany,USA,0,1,0,1,10/06/2021,1,0,4,5,0,0,0,0,0,0,0,0,0,0,0,0,0,1,0,1
1424,162788,2021,Serbia,Germany,0,0,1,1,09/06/2021,0,0,0,0,0,0,0,0,0,0,0,0,0,0,0,0,0,0,0,0
1425,162788,2021,Slovenia,Germany,0,0,0,0,05/06/2021,0,0,0,0,0,0,0,0,0,0,0,0,0,0,0,0,0,0,0,0
1426,162788,2021,Netherlands,Germany,0,0,0,0,04/06/2021,0,0,1,1,0,0,0,0,0,0,0,0,0,0,0,0,0,0,0,0
1427,162788,2021,Germany,Argentina,0,0,3,3,03/06/2021,0,0,0,0,0,0,0,0,0,0,0,0,0,0,0,0,1,0,0,1
1428,162788,2021,Germany,Bulgaria,0,1,0,1,30/05/2021,0,0,0,0,0,0,0,0,0,0,0,0,0,0,0,0,0,0,0,0
1429,162788,2021,Germany,France,0,1,1,2,29/05/2021,0,0,0,0,0,0,0,0,0,0,0,0,0,0,0,0,0,0,0,0
1430,162788,2021,Germany,Australia,0,0,0,0,28/05/2021,0,0,0,0,0,0,0,0,0,0,0,0,0,0,0,0,0,0,0,0
1431,136442,2021,Italy,Germany,0,4,10,14,23/06/2021,33,0,74,107,2,0,0,2,0,5,3,8,0,0,0,0,9,2,1,12
1432,136442,2021,Brazil,Germany,0,2,7,9,22/06/2021,10,0,50,60,0,0,0,0,0,0,1,1,0,0,2,2,4,1,0,5
1433,136442,2021,Germany,Russia,0,3,8,11,21/06/2021,20,1,51,72,0,0,2,2,0,4,2,6,0,0,0,0,5,5,1,11
1434,136442,2021,Germany,Poland,0,2,6,8,17/06/2021,14,1,41,56,0,0,0,0,1,0,2,3,0,0,1,1,5,2,1,8
1435,136442,2021,Canada,Germany,0,1,9,10,16/06/2021,15,2,49,66,1,0,1,2,0,0,0,0,0,0,0,0,0,3,0,3
1436,136442,2021,Japan,Germany,0,1,8,9,15/06/2021,5,0,65,70,1,0,0,1,0,1,0,1,0,0,1,1,3,2,0,5
1437,136442,2021,Iran,Germany,1,2,14,17,11/06/2021,20,0,58,78,1,1,0,2,2,4,0,6,0,1,1,2,1,3,0,4
1438,136442,2021,Germany,USA,0,1,7,8,10/06/2021,21,0,39,60,0,0,1,1,0,1,4,5,0,0,0,0,4,1,0,5
1439,136442,2021,Serbia,Germany,1,2,8,11,09/06/2021,33,0,49,82,0,1,1,2,0,1,1,2,0,0,0,0,1,2,2,5
1440,136442,2021,Slovenia,Germany,0,3,10,13,05/06/2021,24,1,70,95,1,0,2,3,1,4,2,7,0,0,0,0,12,2,1,15
1441,136442,2021,Netherlands,Germany,0,2,13,15,04/06/2021,11,2,85,98,1,0,1,2,0,2,2,4,0,0,0,0,6,3,0,9
1442,136442,2021,Germany,Argentina,1,2,13,16,03/06/2021,19,1,75,95,0,0,1,1,2,2,2,6,0,0,0,0,9,5,1,15
1443,136442,2021,Germany,Bulgaria,2,0,14,16,30/05/2021,21,0,90,111,0,0,0,0,0,0,5,5,0,0,0,0,7,5,1,13
1444,136442,2021,Germany,France,1,2,9,12,29/05/2021,45,2,0,47,1,0,0,1,2,1,3,6,0,0,1,1,3,3,2,8
1445,136442,2021,Germany,Australia,1,1,10,12,28/05/2021,20,0,46,66,0,0,0,0,0,2,1,3,0,0,1,1,4,0,0,4
1446,162790,2021,Brazil,Germany,1,1,9,11,22/06/2021,0,0,0,0,2,0,1,3,3,7,0,10,1,0,0,1,1,1,0,2
1447,162790,2021,Germany,Russia,0,0,8,8,21/06/2021,0,0,0,0,2,3,2,7,4,2,0,6,0,1,0,1,1,0,0,1
1448,162790,2021,Canada,Germany,0,1,5,6,16/06/2021,0,0,0,0,5,1,4,10,1,3,1,5,0,0,0,0,0,1,0,1
1449,162790,2021,Japan,Germany,0,0,8,8,15/06/2021,0,0,0,0,3,1,3,7,1,1,0,2,0,0,0,0,2,2,0,4
1450,162790,2021,Iran,Germany,1,1,12,14,11/06/2021,0,0,0,0,9,0,1,10,3,6,0,9,0,0,0,0,0,0,0,0
1451,162790,2021,Germany,USA,0,0,7,7,10/06/2021,0,0,0,0,5,1,1,7,1,5,3,9,0,0,1,1,1,1,0,2
1452,162790,2021,Serbia,Germany,0,2,11,13,09/06/2021,0,0,0,0,2,2,1,5,1,2,3,6,0,0,0,0,0,0,0,0
1453,162790,2021,Slovenia,Germany,1,1,16,18,05/06/2021,0,0,1,1,1,0,4,5,1,4,2,7,0,0,2,2,3,2,0,5
1454,162790,2021,Netherlands,Germany,0,2,8,10,04/06/2021,0,0,1,1,8,3,2,13,1,7,2,10,0,0,0,0,1,0,0,1
1455,162790,2021,Germany,Argentina,1,0,5,6,03/06/2021,0,0,0,0,2,0,1,3,0,1,0,1,0,0,0,0,0,0,1,1
1456,162790,2021,Germany,Bulgaria,0,3,8,11,30/05/2021,0,0,0,0,6,1,2,9,2,7,2,11,0,1,0,1,1,0,0,1
1457,162790,2021,Germany,France,0,0,6,6,29/05/2021,0,0,0,0,1,1,0,2,1,4,1,6,1,1,1,3,1,1,0,2
1458,162790,2021,Germany,Australia,0,1,9,10,28/05/2021,0,0,0,0,4,1,4,9,1,4,0,5,0,0,0,0,0,0,1,1
1459,174660,2021,Italy,Germany,0,0,0,0,23/06/2021,0,0,0,0,0,0,0,0,0,0,0,0,0,0,0,0,0,0,0,0
1460,174660,2021,Brazil,Germany,0,0,0,0,22/06/2021,0,0,0,0,0,0,0,0,0,0,0,0,0,0,0,0,0,0,0,0
1461,174660,2021,Germany,Russia,0,0,0,0,21/06/2021,0,0,0,0,0,0,0,0,0,0,0,0,0,0,0,0,0,0,0,0
1462,174660,2021,Germany,Poland,0,0,0,0,17/06/2021,0,0,0,0,0,0,0,0,0,0,0,0,0,0,0,0,0,0,0,0
1463,174660,2021,Canada,Germany,0,0,0,0,16/06/2021,0,0,0,0,0,0,0,0,0,0,0,0,0,0,0,0,0,0,0,0
1464,174660,2021,Japan,Germany,0,0,0,0,15/06/2021,0,0,0,0,0,0,0,0,0,0,0,0,0,0,0,0,0,0,0,0
1465,174660,2021,Iran,Germany,0,0,0,0,11/06/2021,0,0,0,0,0,0,0,0,0,0,0,0,0,0,0,0,0,0,0,0
1466,174660,2021,Germany,USA,2,2,3,7,10/06/2021,0,0,0,0,4,3,3,10,0,2,1,3,0,2,10,12,2,0,0,2
1467,174660,2021,Serbia,Germany,0,1,0,1,09/06/2021,0,0,0,0,1,0,1,2,0,0,0,0,0,0,1,1,0,0,0,0
1468,174660,2021,Slovenia,Germany,0,0,0,0,05/06/2021,0,0,0,0,0,0,0,0,0,0,0,0,0,0,0,0,0,0,0,0
1469,174660,2021,Netherlands,Germany,0,0,0,0,04/06/2021,0,0,0,0,0,0,0,0,0,0,0,0,0,0,0,0,0,0,0,0
1470,174660,2021,Germany,Argentina,0,0,0,0,03/06/2021,0,0,0,0,0,0,0,0,0,0,0,0,0,0,0,0,0,0,0,0
1471,174660,2021,Germany,Bulgaria,0,0,0,0,30/05/2021,0,0,0,0,0,0,0,0,0,0,0,0,0,0,0,0,0,0,0,0
1472,162082,2021,Italy,Germany,0,1,1,2,23/06/2021,0,0,0,0,2,3,4,9,0,0,0,0,0,0,0,0,0,1,1,2
1473,162082,2021,Brazil,Germany,0,3,5,8,22/06/2021,0,0,0,0,10,6,8,24,2,2,0,4,0,0,0,0,1,1,1,3
1474,162082,2021,Germany,Russia,0,0,0,0,21/06/2021,0,0,0,0,0,1,1,2,0,0,0,0,0,0,0,0,1,0,0,1
1475,162082,2021,Canada,Germany,3,2,8,13,16/06/2021,0,0,0,0,12,5,7,24,1,3,2,6,0,0,0,0,1,1,0,2
1476,162082,2021,Japan,Germany,0,6,5,11,15/06/2021,0,0,1,1,13,1,10,24,2,3,1,6,1,0,0,1,0,1,0,1
1477,162082,2021,Iran,Germany,2,8,9,19,11/06/2021,0,0,2,2,11,6,8,25,2,0,1,3,0,0,0,0,5,1,0,6
1478,162082,2021,Germany,USA,1,6,3,10,10/06/2021,0,0,1,1,8,7,10,25,1,2,2,5,0,0,0,0,2,1,0,3
1479,162082,2021,Serbia,Germany,1,4,5,10,09/06/2021,0,0,1,1,13,4,8,25,1,2,4,7,1,0,0,1,1,0,1,2
1480,162082,2021,Slovenia,Germany,1,4,13,18,05/06/2021,0,0,0,0,10,3,17,30,1,4,2,7,0,0,0,0,3,2,3,8
1481,162082,2021,Netherlands,Germany,1,2,9,12,04/06/2021,0,0,0,0,17,4,16,37,2,1,4,7,0,0,0,0,1,0,1,2
1482,162082,2021,Germany,Argentina,1,3,9,13,03/06/2021,0,0,0,0,13,4,10,27,0,3,3,6,0,0,0,0,1,1,0,2
1483,162082,2021,Germany,France,1,3,7,11,29/05/2021,0,0,0,0,7,2,4,13,1,1,0,2,0,0,0,0,3,0,0,3
1484,162082,2021,Germany,Australia,1,5,8,14,28/05/2021,0,0,0,0,12,3,4,19,1,2,0,3,0,0,0,0,5,2,0,7
1485,152349,2021,Italy,Germany,0,3,6,9,23/06/2021,0,0,0,0,13,2,1,16,3,5,2,10,0,0,0,0,4,0,0,4
1486,152349,2021,Brazil,Germany,0,3,9,12,22/06/2021,0,0,1,1,6,1,2,9,0,2,3,5,0,0,0,0,0,0,0,0
1487,152349,2021,Germany,Russia,0,2,6,8,21/06/2021,0,0,1,1,10,1,2,13,1,4,5,10,0,0,2,2,2,0,0,2
1488,152349,2021,Germany,Poland,0,0,0,0,17/06/2021,0,0,0,0,0,0,0,0,0,0,0,0,0,0,0,0,0,0,0,0
1489,152349,2021,Canada,Germany,0,4,7,11,16/06/2021,0,1,0,1,7,1,5,13,0,4,1,5,0,0,0,0,0,0,0,0
1490,152349,2021,Japan,Germany,0,4,4,8,15/06/2021,0,0,0,0,3,1,3,7,2,3,0,5,1,0,0,1,0,0,0,0
1491,152349,2021,Iran,Germany,0,3,4,7,11/06/2021,0,0,0,0,5,1,1,7,4,5,4,13,0,1,0,1,2,1,0,3
1492,152349,2021,Germany,USA,1,4,5,10,10/06/2021,0,0,0,0,1,0,2,3,1,2,2,5,0,0,0,0,4,0,1,5
1493,152349,2021,Serbia,Germany,0,5,6,11,09/06/2021,0,0,0,0,4,3,1,8,3,3,9,15,0,0,1,1,3,0,0,3
1494,152349,2021,Slovenia,Germany,2,4,5,11,05/06/2021,0,0,0,0,4,0,4,8,4,3,9,16,1,0,1,2,2,0,0,2
1495,152349,2021,Germany,Argentina,0,3,7,10,03/06/2021,0,0,0,0,13,0,4,17,2,6,6,14,0,0,0,0,4,0,0,4
1496,152349,2021,Germany,Bulgaria,0,2,2,4,30/05/2021,0,0,0,0,5,3,2,10,6,2,6,14,0,0,2,2,0,0,1,1
1497,152349,2021,Germany,France,0,3,7,10,29/05/2021,0,0,0,0,7,2,3,12,2,2,1,5,0,0,1,1,1,0,0,1
1498,152349,2021,Germany,Australia,1,3,3,7,28/05/2021,0,0,0,0,5,0,2,7,0,2,5,7,0,0,0,0,3,0,0,3
1499,152352,2021,Germany,Poland,0,0,0,0,17/06/2021,0,0,0,0,0,0,1,1,0,0,1,1,0,0,0,0,0,0,0,0
1500,152352,2021,Iran,Germany,0,0,0,0,11/06/2021,0,0,1,1,0,0,0,0,0,0,1,1,0,0,0,0,0,0,0,0
1501,152352,2021,Germany,USA,0,0,0,0,10/06/2021,0,0,0,0,0,0,2,2,0,0,0,0,0,0,0,0,0,1,0,1
1502,152352,2021,Serbia,Germany,0,0,0,0,09/06/2021,0,0,0,0,0,0,0,0,0,2,0,2,0,0,0,0,0,1,0,1
1503,152352,2021,Slovenia,Germany,0,0,0,0,05/06/2021,0,0,0,0,0,0,0,0,0,0,0,0,0,0,0,0,0,0,0,0
1504,136751,2021,Iran,Argentina,2,4,10,16,23/06/2021,0,0,2,2,12,2,9,23,1,5,2,8,4,1,10,15,3,0,0,3
1505,136751,2021,Iran,Poland,0,0,0,0,22/06/2021,0,0,0,0,0,0,0,0,0,0,0,0,0,0,0,0,0,0,0,0
1506,136751,2021,France,Iran,0,3,5,8,21/06/2021,0,0,4,4,5,2,8,15,2,2,0,4,6,1,10,17,2,1,0,3
1507,136751,2021,Iran,Slovenia,1,3,14,18,17/06/2021,0,0,3,3,10,2,10,22,1,1,2,4,8,0,14,22,1,7,1,9
1508,136751,2021,Iran,Brazil,0,4,9,13,16/06/2021,0,0,5,5,10,3,6,19,1,3,0,4,19,2,9,30,2,1,0,3
1509,136751,2021,Iran,Australia,1,3,11,15,15/06/2021,0,0,2,2,8,6,8,22,0,1,0,1,20,1,16,37,5,5,0,10
1510,136751,2021,Iran,Germany,0,6,10,16,11/06/2021,0,0,3,3,7,7,4,18,1,1,1,3,12,3,12,27,8,4,1,13
1511,136751,2021,Serbia,Iran,0,0,0,0,10/06/2021,0,0,0,0,0,0,0,0,0,0,0,0,0,0,0,0,0,0,0,0
1512,136751,2021,Iran,USA,0,1,11,12,09/06/2021,0,0,5,5,6,3,12,21,0,2,1,3,7,1,15,23,5,1,1,7
1513,136751,2021,Iran,Italy,2,3,11,16,04/06/2021,0,0,3,3,6,3,11,20,0,2,0,2,5,3,10,18,5,1,0,6
1514,136751,2021,Iran,Canada,0,3,13,16,03/06/2021,0,0,0,0,11,5,7,23,1,5,0,6,7,1,16,24,10,3,0,13
1515,136751,2021,Iran,Russia,0,0,0,0,29/05/2021,0,0,0,0,0,0,0,0,0,0,0,0,0,0,0,0,0,0,0,0
1516,136751,2021,Japan,Iran,0,2,9,11,28/05/2021,0,0,2,2,7,5,9,21,4,0,0,4,19,0,18,37,0,0,0,0
1517,150817,2021,Iran,Argentina,0,0,0,0,23/06/2021,0,0,0,0,0,0,0,0,0,0,0,0,0,0,0,0,0,0,0,0
1518,150817,2021,Iran,Poland,0,0,2,2,22/06/2021,0,0,1,1,0,0,0,0,1,0,0,1,0,0,0,0,0,0,0,0
1519,150817,2021,Iran,Slovenia,0,0,0,0,17/06/2021,0,0,0,0,0,0,0,0,0,0,0,0,0,0,0,0,0,0,0,0
1520,150817,2021,Iran,Brazil,0,2,0,2,16/06/2021,0,0,0,0,0,1,0,1,1,1,0,2,0,0,0,0,0,0,0,0
1521,150817,2021,Iran,Australia,0,0,0,0,15/06/2021,0,0,0,0,0,0,0,0,0,0,0,0,0,0,0,0,0,0,0,0
1522,150817,2021,Iran,Germany,0,1,1,2,11/06/2021,0,0,0,0,0,0,0,0,0,0,1,1,0,0,0,0,0,0,0,0
1523,150817,2021,Serbia,Iran,1,2,13,16,10/06/2021,0,0,1,1,7,1,1,9,3,2,2,7,0,0,0,0,1,0,1,2
1524,150817,2021,Iran,USA,0,0,0,0,09/06/2021,0,0,0,0,0,0,0,0,0,0,0,0,0,0,0,0,0,0,0,0
1525,150817,2021,Bulgaria,Iran,0,1,14,15,05/06/2021,0,0,1,1,1,1,0,2,4,6,3,13,0,0,1,1,3,1,1,5
1526,150817,2021,Iran,Italy,0,0,3,3,04/06/2021,0,0,0,0,0,0,0,0,0,0,0,0,0,0,0,0,0,0,0,0
1527,150817,2021,Japan,Iran,0,0,0,0,28/05/2021,0,0,0,0,0,0,0,0,0,0,0,0,0,0,0,0,0,0,0,0
1528,117478,2021,Iran,Argentina,0,1,6,7,23/06/2021,18,1,31,50,1,0,0,1,0,2,2,4,0,0,0,0,1,0,0,1
1529,117478,2021,Iran,Poland,0,0,0,0,22/06/2021,3,0,9,12,0,0,0,0,0,0,0,0,0,0,0,0,3,0,0,3
1530,117478,2021,France,Iran,0,0,2,2,21/06/2021,8,1,11,20,0,0,1,1,0,1,0,1,0,0,0,0,1,0,0,1
1531,117478,2021,Iran,Slovenia,0,0,14,14,17/06/2021,19,2,61,82,1,0,1,2,0,2,0,2,0,1,0,1,4,5,0,9
1532,117478,2021,Iran,Brazil,0,0,8,8,16/06/2021,10,0,47,57,0,0,4,4,0,0,0,0,0,0,1,1,2,2,0,4
1533,117478,2021,Iran,Australia,1,2,17,20,15/06/2021,19,0,91,110,1,0,1,2,0,1,0,1,0,0,1,1,8,4,1,13
1534,117478,2021,Iran,Germany,1,2,15,18,11/06/2021,34,2,47,83,2,0,0,2,0,1,3,4,0,0,1,1,7,0,0,7
1535,117478,2021,Serbia,Iran,0,0,2,2,10/06/2021,5,1,4,10,0,0,0,0,0,0,0,0,0,0,0,0,0,0,1,1
1536,117478,2021,Iran,USA,0,1,10,11,09/06/2021,12,3,61,76,2,0,3,5,0,1,5,6,0,0,1,1,2,2,0,4
1537,117478,2021,Bulgaria,Iran,0,0,3,3,05/06/2021,3,0,13,16,0,0,0,0,0,0,1,1,0,0,1,1,4,1,0,5
1538,117478,2021,Iran,Italy,0,2,12,14,04/06/2021,20,0,89,109,0,0,2,2,0,2,2,4,0,0,0,0,7,4,0,11
1539,117478,2021,Iran,Canada,0,1,10,11,03/06/2021,35,1,49,85,1,0,0,1,0,1,1,2,0,0,0,0,6,3,1,10
1540,117478,2021,Netherlands,Iran,0,0,0,0,30/05/2021,6,0,0,6,0,0,0,0,0,0,0,0,0,0,0,0,0,0,0,0
1541,118827,2021,Iran,Argentina,0,4,10,14,23/06/2021,0,1,1,2,7,1,1,9,3,8,3,14,0,0,1,1,2,1,1,4
1542,118827,2021,Iran,Poland,0,0,0,0,22/06/2021,0,0,0,0,0,0,0,0,0,0,0,0,0,0,0,0,0,0,0,0
1543,118827,2021,France,Iran,0,1,5,6,21/06/2021,0,0,2,2,2,1,1,4,2,6,1,9,1,0,0,1,0,0,0,0
1544,118827,2021,Iran,Slovenia,1,3,10,14,17/06/2021,0,0,1,1,4,2,2,8,5,4,0,9,0,1,2,3,1,1,0,2
1545,118827,2021,Iran,Brazil,1,4,5,10,16/06/2021,0,0,2,2,4,3,6,13,2,5,1,8,0,0,0,0,1,0,0,1
1546,118827,2021,Iran,Australia,1,2,9,12,15/06/2021,0,0,4,4,8,6,7,21,5,6,1,12,0,0,3,3,0,2,0,2
1547,118827,2021,Iran,Germany,0,7,7,14,11/06/2021,0,0,1,1,9,3,4,16,1,5,5,11,2,0,1,3,3,0,0,3
1548,118827,2021,Iran,USA,0,0,11,11,09/06/2021,0,0,2,2,5,0,5,10,2,2,3,7,0,0,1,1,2,1,4,7
1549,118827,2021,Bulgaria,Iran,3,3,8,14,05/06/2021,0,0,1,1,4,1,4,9,3,5,6,14,0,0,1,1,6,0,1,7
1550,118827,2021,Iran,Italy,0,0,0,0,04/06/2021,0,0,0,0,0,0,0,0,0,0,0,0,0,0,0,0,0,0,0,0
1551,118827,2021,Iran,Canada,1,5,7,13,03/06/2021,0,0,3,3,9,1,2,12,6,7,6,19,0,0,1,1,0,1,2,3
1552,118827,2021,Netherlands,Iran,0,4,5,9,30/05/2021,0,0,0,0,9,0,1,10,1,2,2,5,0,0,0,0,0,0,1,1
1553,118827,2021,Iran,Russia,0,0,0,0,29/05/2021,0,0,0,0,0,0,0,0,0,0,0,0,0,0,0,0,0,0,0,0
1554,118827,2021,Japan,Iran,0,2,5,7,28/05/2021,0,0,0,0,5,0,4,9,0,0,0,0,1,0,0,1,1,0,0,1
1555,162173,2021,Iran,Argentina,0,0,0,0,23/06/2021,0,0,0,0,0,0,0,0,0,0,0,0,0,0,0,0,0,0,0,0
1556,162173,2021,Iran,Australia,0,0,0,0,15/06/2021,0,0,0,0,0,0,0,0,0,0,0,0,0,0,0,0,0,0,0,0
1557,162173,2021,Iran,Germany,0,0,0,0,11/06/2021,0,0,0,0,0,0,0,0,0,0,0,0,0,0,0,0,0,0,0,0
1558,162173,2021,Serbia,Iran,0,0,0,0,10/06/2021,0,0,0,0,0,0,0,0,0,0,0,0,0,1,6,7,1,0,0,1
1559,162173,2021,Iran,USA,0,0,0,0,09/06/2021,0,0,0,0,0,0,0,0,0,0,0,0,0,0,0,0,0,1,0,1
1560,162173,2021,Bulgaria,Iran,0,0,2,2,05/06/2021,0,0,0,0,0,0,3,3,0,0,3,3,0,0,1,1,0,0,0,0
1561,162173,2021,Iran,Italy,0,0,2,2,04/06/2021,0,1,0,1,0,0,3,3,0,2,0,2,1,1,6,8,2,0,0,2
1562,162173,2021,Iran,Canada,0,0,0,0,03/06/2021,0,0,0,0,0,0,0,0,0,0,0,0,0,0,0,0,0,0,0,0
1563,162173,2021,Netherlands,Iran,0,0,0,0,30/05/2021,0,0,0,0,0,0,0,0,0,0,0,0,0,0,1,1,0,1,0,1
1564,162173,2021,Iran,Russia,0,0,1,1,29/05/2021,0,0,0,0,0,0,1,1,0,0,0,0,1,1,1,3,1,0,0,1
1565,162173,2021,Japan,Iran,0,1,11,12,28/05/2021,1,0,1,2,2,1,6,9,0,0,0,0,6,2,10,18,1,0,0,1
1566,163176,2021,Iran,Argentina,0,0,0,0,23/06/2021,0,0,4,4,0,0,0,0,0,0,0,0,8,0,8,16,8,3,1,12
1567,163176,2021,Iran,Poland,0,0,0,0,22/06/2021,0,0,0,0,0,0,0,0,0,0,0,0,0,0,0,0,0,0,0,0
1568,163176,2021,France,Iran,0,0,0,0,21/06/2021,0,0,0,0,0,0,0,0,0,0,0,0,0,0,0,0,0,0,0,0
1569,163176,2021,Iran,Slovenia,0,0,0,0,17/06/2021,0,0,0,0,0,0,0,0,0,0,0,0,0,0,0,0,0,0,0,0
1570,163176,2021,Iran,Brazil,0,0,0,0,16/06/2021,0,0,0,0,0,0,0,0,0,0,0,0,0,0,0,0,0,0,0,0
1571,163176,2021,Iran,Australia,0,0,0,0,15/06/2021,0,0,1,1,0,0,0,0,0,0,0,0,5,0,10,15,3,2,0,5
1572,163176,2021,Iran,Germany,0,0,0,0,11/06/2021,0,0,0,0,0,0,0,0,0,0,0,0,0,0,0,0,0,0,0,0
1573,163176,2021,Serbia,Iran,0,0,0,0,10/06/2021,0,0,13,13,0,0,0,0,0,0,0,0,9,0,10,19,3,3,2,8
1574,163176,2021,Bulgaria,Iran,0,0,0,0,05/06/2021,0,0,2,2,0,0,0,0,0,0,0,0,4,2,11,17,6,4,2,12
1575,163176,2021,Iran,Italy,0,0,0,0,04/06/2021,0,0,0,0,0,0,0,0,0,0,0,0,0,0,0,0,0,0,0,0
1576,163176,2021,Iran,Canada,0,0,0,0,03/06/2021,0,0,4,4,0,0,0,0,0,0,0,0,8,0,8,16,1,3,1,5
1577,163176,2021,Netherlands,Iran,0,0,0,0,30/05/2021,0,0,0,0,0,0,0,0,0,0,0,0,0,0,0,0,0,0,0,0
1578,163176,2021,Japan,Iran,0,0,0,0,28/05/2021,0,0,4,4,0,0,0,0,0,0,0,0,4,0,4,8,3,0,0,3
1579,142078,2021,Iran,Argentina,1,0,18,19,23/06/2021,1,1,0,2,5,2,1,8,3,3,2,8,0,0,1,1,1,2,0,3
1580,142078,2021,Iran,Poland,0,2,6,8,22/06/2021,0,1,0,1,1,1,5,7,0,4,4,8,1,0,0,1,0,0,0,0
1581,142078,2021,France,Iran,0,0,0,0,21/06/2021,0,0,0,0,0,0,0,0,0,0,0,0,0,0,0,0,0,0,0,0
1582,142078,2021,Iran,Slovenia,1,0,17,18,17/06/2021,0,0,2,2,5,1,4,10,3,5,0,8,0,0,0,0,1,1,0,2
1583,142078,2021,Iran,Brazil,0,0,0,0,16/06/2021,0,0,0,0,0,0,0,0,0,0,0,0,0,0,0,0,0,0,0,0
1584,142078,2021,Iran,Australia,0,0,13,13,15/06/2021,0,0,0,0,3,0,1,4,1,2,1,4,0,0,0,0,0,1,0,1
1585,142078,2021,Iran,Germany,0,2,12,14,11/06/2021,0,0,4,4,5,2,2,9,0,3,2,5,1,0,0,1,2,0,0,2
1586,142078,2021,Serbia,Iran,0,0,0,0,10/06/2021,0,0,0,0,0,0,0,0,0,0,0,0,0,0,0,0,0,0,0,0
1587,142078,2021,Iran,USA,0,2,10,12,09/06/2021,0,0,0,0,6,1,1,8,2,2,2,6,0,0,0,0,4,0,0,4
1588,142078,2021,Bulgaria,Iran,0,0,0,0,05/06/2021,0,0,0,0,0,0,0,0,0,0,0,0,0,0,0,0,0,0,0,0
1589,142078,2021,Iran,Italy,2,1,16,19,04/06/2021,0,0,1,1,3,1,6,10,3,4,2,9,1,0,0,1,1,5,0,6
1590,142078,2021,Iran,Canada,0,0,15,15,03/06/2021,0,0,3,3,8,0,2,10,4,5,3,12,0,0,0,0,2,1,1,4
1591,142078,2021,Netherlands,Iran,0,0,0,0,30/05/2021,0,0,0,0,0,0,0,0,0,0,0,0,0,0,0,0,0,0,0,0
1592,142078,2021,Iran,Russia,1,3,9,13,29/05/2021,0,0,0,0,5,1,4,10,1,4,7,12,2,0,1,3,2,1,0,3
1593,142078,2021,Japan,Iran,0,0,0,0,28/05/2021,0,0,0,0,0,0,0,0,0,0,0,0,0,0,0,0,0,0,0,0
1594,124584,2021,Iran,Argentina,0,4,5,9,23/06/2021,0,0,3,3,12,5,2,19,1,1,2,4,1,0,3,4,1,2,2,5
1595,124584,2021,Iran,Poland,0,0,5,5,22/06/2021,1,0,7,8,1,1,2,4,0,1,1,2,0,0,0,0,0,0,0,0
1596,124584,2021,France,Iran,0,1,3,4,21/06/2021,0,0,1,1,5,3,1,9,2,2,1,5,0,0,1,1,0,0,0,0
1597,124584,2021,Iran,Russia,0,0,0,0,29/05/2021,0,0,0,0,0,0,0,0,0,0,0,0,0,0,0,0,0,0,0,0
1598,124584,2021,Japan,Iran,0,3,5,8,28/05/2021,0,0,2,2,15,4,7,26,0,0,0,0,0,0,0,0,0,0,1,1
1599,164188,2021,Iran,Argentina,1,1,10,12,23/06/2021,0,0,2,2,7,3,6,16,0,0,1,1,0,0,1,1,2,3,2,7
1600,164188,2021,France,Iran,1,0,9,10,21/06/2021,0,0,2,2,9,5,5,19,0,3,0,3,0,0,0,0,1,0,0,1
1601,164188,2021,Iran,Slovenia,1,3,7,11,17/06/2021,0,0,1,1,14,3,12,29,1,5,0,6,0,0,0,0,5,3,0,8
1602,164188,2021,Iran,Brazil,1,6,7,14,16/06/2021,0,0,0,0,9,4,15,28,0,3,0,3,0,0,0,0,3,0,0,3
1603,164188,2021,Iran,Australia,0,1,5,6,15/06/2021,0,0,1,1,9,5,9,23,2,1,1,4,0,0,1,1,1,1,0,2
1604,164188,2021,Iran,Germany,2,6,9,17,11/06/2021,0,0,1,1,23,3,12,38,2,2,1,5,0,0,0,0,5,3,0,8
1605,164188,2021,Serbia,Iran,0,0,2,2,10/06/2021,0,0,0,0,4,0,2,6,0,2,1,3,0,0,0,0,0,0,1,1
1606,164188,2021,Iran,USA,5,3,10,18,09/06/2021,0,0,1,1,12,4,11,27,2,2,4,8,0,0,1,1,7,1,2,10
1607,164188,2021,Bulgaria,Iran,0,0,2,2,05/06/2021,0,0,1,1,2,1,5,8,0,0,0,0,0,0,0,0,0,0,0,0
1608,164188,2021,Iran,Italy,3,4,11,18,04/06/2021,0,0,0,0,20,4,29,53,1,6,0,7,0,0,1,1,4,4,0,8
1609,164188,2021,Iran,Canada,0,4,10,14,03/06/2021,0,0,1,1,15,6,11,32,2,2,1,5,0,1,0,1,7,2,1,10
1610,164188,2021,Netherlands,Iran,1,6,10,17,30/05/2021,0,0,0,0,10,5,10,25,0,1,0,1,0,0,1,1,3,1,2,6
1611,164188,2021,Iran,Russia,0,4,12,16,29/05/2021,0,0,0,0,18,4,14,36,0,2,2,4,0,0,0,0,3,1,2,6
1612,164188,2021,Japan,Iran,0,1,1,2,28/05/2021,0,0,0,0,0,0,0,0,0,0,0,0,0,0,0,0,0,0,0,0
1613,152742,2021,Iran,Argentina,0,1,1,2,23/06/2021,0,0,1,1,1,0,4,5,0,2,0,2,0,0,2,2,0,0,0,0
1614,152742,2021,Iran,Poland,0,2,7,9,22/06/2021,0,1,0,1,10,3,10,23,1,1,1,3,5,5,21,31,8,0,0,8
1615,152742,2021,France,Iran,0,0,0,0,21/06/2021,0,0,0,0,0,0,0,0,0,0,0,0,0,0,0,0,0,0,0,0
1616,152742,2021,Iran,Slovenia,0,0,0,0,17/06/2021,0,0,0,0,0,0,0,0,0,0,0,0,0,0,0,0,0,0,0,0
1617,152742,2021,Iran,Brazil,0,0,0,0,16/06/2021,0,0,0,0,0,0,0,0,0,0,0,0,0,0,0,0,0,0,0,0
1618,152742,2021,Iran,Germany,0,0,0,0,11/06/2021,0,0,0,0,0,0,0,0,0,0,0,0,0,0,0,0,0,0,0,0
1619,152742,2021,Serbia,Iran,3,4,11,18,10/06/2021,0,0,1,1,10,5,7,22,1,4,3,8,7,2,27,36,6,1,2,9
1620,152742,2021,Iran,USA,0,0,0,0,09/06/2021,0,0,0,0,0,0,0,0,0,0,0,0,0,0,0,0,0,0,0,0
1621,152742,2021,Bulgaria,Iran,0,0,0,0,05/06/2021,0,0,0,0,0,0,0,0,0,0,0,0,0,0,0,0,0,0,0,0
1622,152742,2021,Netherlands,Iran,0,0,0,0,30/05/2021,0,0,0,0,0,0,0,0,0,0,0,0,0,0,0,0,0,0,0,0
1623,152742,2021,Iran,Russia,0,0,0,0,29/05/2021,0,0,0,0,0,0,0,0,0,0,0,0,0,0,0,0,0,0,0,0
1624,152743,2021,Iran,Poland,0,2,5,7,22/06/2021,0,0,3,3,3,0,3,6,1,5,1,7,0,0,2,2,2,0,0,2
1625,152743,2021,France,Iran,0,2,7,9,21/06/2021,0,0,0,0,1,3,1,5,1,2,3,6,0,0,0,0,1,1,0,2
1626,152743,2021,Iran,Slovenia,0,0,0,0,17/06/2021,0,0,0,0,0,0,0,0,0,0,0,0,0,0,0,0,0,0,0,0
1627,152743,2021,Iran,Brazil,0,1,5,6,16/06/2021,0,0,0,0,4,0,1,5,1,2,0,3,0,0,0,0,1,0,0,1
1628,152743,2021,Iran,Australia,0,2,4,6,15/06/2021,0,0,0,0,2,1,2,5,2,0,0,2,0,1,1,2,0,0,0,0
1629,152743,2021,Bulgaria,Iran,0,0,0,0,05/06/2021,0,0,0,0,0,0,0,0,0,0,0,0,0,0,0,0,0,0,0,0
1630,152743,2021,Iran,Italy,0,0,16,16,04/06/2021,0,0,1,1,5,1,2,8,5,4,3,12,0,0,1,1,1,1,0,2
1631,152743,2021,Iran,Canada,0,0,0,0,03/06/2021,0,0,0,0,0,0,0,0,0,0,0,0,0,0,0,0,0,0,0,0
1632,152743,2021,Netherlands,Iran,1,5,7,13,30/05/2021,0,0,0,0,3,0,2,5,4,5,3,12,0,0,1,1,1,0,1,2
1633,152743,2021,Iran,Russia,0,1,0,1,29/05/2021,0,0,0,0,1,0,0,1,0,3,0,3,0,0,0,0,0,0,0,0
1634,152743,2021,Japan,Iran,0,2,4,6,28/05/2021,0,0,0,0,6,0,3,9,2,0,0,2,0,0,0,0,0,0,0,0
1635,162557,2021,Iran,Argentina,0,2,17,19,23/06/2021,0,1,0,1,13,8,7,28,0,4,2,6,9,2,22,33,5,4,2,11
1636,162557,2021,Iran,Poland,0,0,0,0,22/06/2021,0,0,0,0,0,0,0,0,0,0,0,0,0,0,0,0,0,0,0,0
1637,162557,2021,France,Iran,0,2,8,10,21/06/2021,0,0,3,3,12,1,9,22,0,2,1,3,8,2,5,15,2,0,0,2
1638,162557,2021,Iran,Slovenia,0,3,13,16,17/06/2021,0,0,0,0,15,4,6,25,2,2,0,4,10,1,17,28,5,4,0,9
1639,162557,2021,Iran,Brazil,2,3,8,13,16/06/2021,0,0,1,1,12,4,10,26,1,2,0,3,8,0,13,21,3,0,0,3
1640,162557,2021,Iran,Australia,1,6,15,22,15/06/2021,0,0,1,1,9,3,8,20,2,4,1,7,4,2,11,17,5,2,0,7
1641,162557,2021,Iran,Germany,0,5,9,14,11/06/2021,0,0,1,1,12,6,3,21,3,3,1,7,6,1,16,23,3,2,0,5
1642,162557,2021,Serbia,Iran,0,0,0,0,10/06/2021,0,0,0,0,0,0,0,0,0,0,0,0,0,0,0,0,0,0,0,0
1643,162557,2021,Iran,USA,0,3,6,9,09/06/2021,0,0,3,3,13,5,1,19,1,1,1,3,5,0,12,17,3,0,1,4
1644,162557,2021,Bulgaria,Iran,0,3,11,14,05/06/2021,0,0,1,1,9,1,3,13,0,1,3,4,3,1,10,14,6,0,1,7
1645,162557,2021,Iran,Italy,0,0,7,7,04/06/2021,0,0,1,1,9,1,5,15,0,2,0,2,6,0,11,17,1,2,0,3
1646,162557,2021,Iran,Canada,4,5,10,19,03/06/2021,0,0,1,1,9,2,5,16,1,2,2,5,10,1,23,34,3,1,0,4
1647,162557,2021,Netherlands,Iran,1,1,10,12,30/05/2021,0,0,0,0,8,1,3,12,3,2,0,5,2,2,10,14,4,1,1,6
1648,162557,2021,Iran,Russia,0,4,8,12,29/05/2021,0,0,0,0,11,6,6,23,1,2,2,5,5,0,15,20,6,0,0,6
1649,162557,2021,Japan,Iran,0,2,3,5,28/05/2021,0,0,0,0,6,2,2,10,0,0,0,0,1,0,3,4,0,0,0,0
1650,119750,2021,Iran,Germany,0,0,1,1,11/06/2021,1,0,3,4,0,0,0,0,0,0,0,0,0,0,0,0,0,0,0,0
1651,119750,2021,Serbia,Iran,0,2,12,14,10/06/2021,23,1,56,80,0,0,3,3,1,2,1,4,0,0,0,0,6,5,0,11
1652,119750,2021,Iran,USA,0,0,0,0,09/06/2021,0,0,0,0,0,0,0,0,0,0,0,0,0,0,0,0,0,0,0,0
1653,119750,2021,Bulgaria,Iran,0,0,10,10,05/06/2021,12,0,41,53,1,0,0,1,0,2,1,3,0,0,0,0,1,1,1,3
1654,119750,2021,Iran,Italy,0,0,0,0,04/06/2021,0,0,2,2,0,0,0,0,0,0,0,0,0,0,0,0,0,0,0,0
1655,119750,2021,Iran,Canada,0,0,0,0,03/06/2021,0,0,0,0,0,0,0,0,0,0,0,0,0,0,0,0,0,0,0,0
1656,119750,2021,Netherlands,Iran,1,0,9,10,30/05/2021,15,0,47,62,1,0,1,2,0,0,0,0,0,0,0,0,7,5,0,12
1657,119750,2021,Iran,Russia,0,2,7,9,29/05/2021,29,0,0,29,1,0,1,2,0,1,1,2,0,0,1,1,9,1,1,11
1658,119750,2021,Japan,Iran,1,2,8,11,28/05/2021,8,1,66,75,0,0,0,0,2,0,0,2,0,0,0,0,0,0,0,0
1659,181182,2021,Iran,Argentina,0,0,0,0,23/06/2021,0,0,3,3,0,0,0,0,0,0,0,0,5,0,10,15,2,4,1,7
1660,181182,2021,Iran,Poland,0,0,0,0,22/06/2021,0,1,11,12,0,0,0,0,0,0,0,0,5,0,11,16,8,2,1,11
1661,181182,2021,France,Iran,0,0,0,0,21/06/2021,0,0,4,4,0,0,0,0,0,0,0,0,14,0,9,23,7,1,1,9
1662,181182,2021,Iran,Slovenia,0,0,0,0,17/06/2021,0,0,6,6,0,0,0,0,0,0,0,0,11,0,10,21,5,5,0,10
1663,181182,2021,Iran,Brazil,0,0,0,0,16/06/2021,0,0,7,7,0,0,0,0,0,0,0,0,13,1,14,28,18,4,0,22
1664,181182,2021,Iran,Australia,0,0,0,0,15/06/2021,0,0,3,3,0,0,0,0,0,0,0,0,5,1,7,13,5,4,0,9
1665,181182,2021,Iran,Germany,0,0,0,0,11/06/2021,0,0,7,7,0,0,0,0,0,0,0,0,9,2,13,24,11,5,0,16
1666,181182,2021,Serbia,Iran,0,0,0,0,10/06/2021,0,0,0,0,0,0,0,0,0,0,0,0,0,0,0,0,0,0,0,0
1667,181182,2021,Iran,USA,0,0,0,0,09/06/2021,0,0,5,5,0,0,0,0,0,0,0,0,8,0,6,14,13,2,1,16
1668,181182,2021,Bulgaria,Iran,0,0,0,0,05/06/2021,0,0,0,0,0,0,0,0,0,0,0,0,0,0,0,0,0,0,0,0
1669,181182,2021,Iran,Italy,0,0,0,0,04/06/2021,0,0,7,7,0,0,0,0,0,0,0,0,8,2,8,18,11,6,1,18
1670,181182,2021,Iran,Canada,0,0,0,0,03/06/2021,0,0,0,0,0,0,0,0,0,0,0,0,0,0,0,0,0,0,0,0
1671,181182,2021,Netherlands,Iran,0,0,0,0,30/05/2021,0,0,4,4,0,0,0,0,0,0,0,0,10,0,10,20,5,4,1,10
1672,181182,2021,Iran,Russia,0,0,0,0,29/05/2021,0,0,0,0,0,0,0,0,0,0,0,0,13,1,16,30,12,2,0,14
1673,181182,2021,Japan,Iran,0,0,0,0,28/05/2021,0,0,0,0,0,0,0,0,0,0,0,0,0,0,0,0,0,0,0,0
1674,152752,2021,Iran,Poland,0,4,6,10,22/06/2021,0,0,0,0,6,7,7,20,1,2,1,4,1,1,14,16,5,1,1,7
1675,152752,2021,France,Iran,0,1,6,7,21/06/2021,0,0,0,0,1,0,1,2,0,0,0,0,0,2,1,3,0,0,0,0
1676,152752,2021,Iran,Slovenia,0,0,1,1,17/06/2021,0,0,0,0,0,0,0,0,0,0,0,0,0,0,0,0,0,0,0,0
1677,152752,2021,Iran,Brazil,1,2,9,12,16/06/2021,0,0,0,0,1,1,3,5,0,1,0,1,0,0,1,1,0,1,0,1
1678,152752,2021,Iran,Australia,0,0,1,1,15/06/2021,0,0,0,0,0,0,0,0,0,0,0,0,0,0,0,0,0,1,0,1
1679,152752,2021,Iran,Germany,2,2,3,7,11/06/2021,0,0,0,0,2,0,0,2,0,0,0,0,0,0,2,2,1,0,0,1
1680,152752,2021,Serbia,Iran,2,5,7,14,10/06/2021,0,0,1,1,14,3,8,25,1,2,2,5,15,5,7,27,4,3,1,8
1681,152752,2021,Iran,USA,0,0,0,0,09/06/2021,0,0,0,0,0,0,0,0,0,0,0,0,0,0,0,0,0,0,0,0
1682,152752,2021,Bulgaria,Iran,1,2,10,13,05/06/2021,0,0,0,0,9,4,8,21,1,3,5,9,3,1,16,20,2,1,0,3
1683,152752,2021,Iran,Italy,0,3,1,4,04/06/2021,0,0,1,1,5,1,6,12,1,2,1,4,3,2,10,15,2,2,0,4
1684,152752,2021,Iran,Canada,1,2,5,8,03/06/2021,0,0,1,1,0,0,0,0,0,0,0,0,0,0,0,0,0,0,0,0
1685,152752,2021,Netherlands,Iran,3,3,9,15,30/05/2021,0,0,0,0,10,2,2,14,1,1,1,3,7,3,11,21,3,1,1,5
1686,152752,2021,Iran,Russia,2,2,11,15,29/05/2021,0,1,0,1,12,3,10,25,0,6,3,9,6,2,10,18,1,2,0,3
1687,152752,2021,Japan,Iran,0,1,3,4,28/05/2021,0,0,0,0,0,0,0,0,0,0,0,0,0,0,0,0,0,0,0,0
1688,168551,2021,Iran,Argentina,0,0,0,0,23/06/2021,0,0,1,1,0,0,0,0,0,0,1,1,0,0,0,0,0,0,0,0
1689,168551,2021,Iran,Poland,2,3,6,11,22/06/2021,0,0,0,0,6,7,8,21,0,2,1,3,0,0,0,0,2,0,0,2
1690,168551,2021,France,Iran,0,0,0,0,21/06/2021,0,0,0,0,0,0,0,0,0,0,0,0,0,0,0,0,0,0,0,0
1691,168551,2021,Iran,Slovenia,0,1,1,2,17/06/2021,0,0,0,0,2,2,0,4,0,1,0,1,0,0,0,0,0,0,0,0
1692,168551,2021,Iran,Brazil,0,1,2,3,16/06/2021,0,0,1,1,8,3,4,15,0,0,0,0,0,0,0,0,2,0,0,2
1693,168551,2021,Iran,Australia,1,2,10,13,15/06/2021,0,0,0,0,14,5,8,27,1,2,1,4,0,0,0,0,0,1,0,1
1694,168551,2021,Iran,Germany,0,0,0,0,11/06/2021,0,0,0,0,0,0,0,0,0,0,1,1,0,0,0,0,0,0,0,0
1695,168551,2021,Serbia,Iran,1,2,11,14,10/06/2021,0,0,0,0,15,7,13,35,0,6,2,8,0,0,0,0,2,1,0,3
1696,168551,2021,Iran,USA,0,0,0,0,09/06/2021,0,0,0,0,0,0,1,1,0,0,0,0,0,0,0,0,0,0,0,0
1697,168551,2021,Bulgaria,Iran,1,5,3,9,05/06/2021,0,0,2,2,15,3,3,21,1,4,0,5,0,0,0,0,1,0,1,2
1698,168551,2021,Iran,Italy,0,0,1,1,04/06/2021,0,0,0,0,2,0,1,3,0,0,0,0,0,0,0,0,0,0,0,0
1699,168551,2021,Iran,Canada,0,0,0,0,03/06/2021,0,0,0,0,2,0,0,2,0,0,0,0,0,0,0,0,0,0,0,0
1700,168551,2021,Netherlands,Iran,0,1,1,2,30/05/2021,0,0,0,0,3,1,1,5,0,0,1,1,0,0,0,0,1,0,0,1
1701,168551,2021,Iran,Russia,0,0,0,0,29/05/2021,0,0,0,0,1,0,0,1,0,1,1,2,0,0,0,0,0,0,0,0
1702,152755,2021,Iran,Argentina,1,2,4,7,23/06/2021,13,0,29,42,1,0,1,2,1,0,0,1,0,0,1,1,2,0,0,2
1703,152755,2021,Iran,Poland,1,2,3,6,22/06/2021,9,0,42,51,0,0,1,1,1,0,2,3,0,0,0,0,6,1,1,8
1704,152755,2021,France,Iran,1,1,5,7,21/06/2021,7,2,31,40,0,0,0,0,1,1,0,2,0,0,0,0,1,1,0,2
1705,152755,2021,Iran,Slovenia,0,0,1,1,17/06/2021,0,0,2,2,0,0,0,0,0,0,0,0,0,0,0,0,0,1,0,1
1706,152755,2021,Iran,Brazil,0,1,3,4,16/06/2021,8,0,29,37,0,1,1,2,1,0,0,1,0,0,0,0,0,1,0,1
1707,152755,2021,Iran,Australia,0,0,0,0,15/06/2021,0,0,1,1,0,0,0,0,0,0,0,0,0,0,0,0,0,0,0,0
1708,152422,2021,Russia,Italy,0,0,0,0,22/06/2021,0,0,0,0,0,0,0,0,0,0,0,0,0,0,0,0,0,0,0,0
1709,152422,2021,Brazil,Italy,0,0,0,0,21/06/2021,0,0,0,0,0,0,0,0,0,0,0,0,0,0,0,0,0,0,0,0
1710,152422,2021,France,Italy,0,0,0,0,17/06/2021,0,0,0,0,0,0,0,0,0,0,0,0,0,0,0,0,0,0,0,0
1711,152422,2021,Netherlands,Italy,0,0,0,0,16/06/2021,0,0,0,0,0,0,0,0,0,0,0,0,0,0,0,0,0,0,0,0
1712,152422,2021,Italy,USA,0,2,3,5,15/06/2021,0,0,0,0,5,1,5,11,0,0,1,1,1,2,7,10,2,2,0,4
1713,152422,2021,Australia,Italy,0,0,0,0,11/06/2021,0,0,0,0,0,0,0,0,0,0,0,0,0,0,0,0,0,0,0,0
1714,152422,2021,Japan,Italy,0,0,1,1,10/06/2021,0,0,1,1,0,0,3,3,0,0,0,0,0,1,1,2,1,0,0,1
1715,152422,2021,Argentina,Italy,0,0,0,0,09/06/2021,0,0,0,0,0,0,0,0,0,0,0,0,0,0,0,0,0,0,0,0
1716,152422,2021,Canada,Italy,0,0,0,0,05/06/2021,0,0,0,0,0,0,0,0,0,0,0,0,0,0,0,0,0,0,0,0
1717,152422,2021,Iran,Italy,0,0,0,0,04/06/2021,0,0,0,0,0,0,0,0,0,0,0,0,0,0,0,0,0,0,0,0
1718,152422,2021,Serbia,Italy,0,0,0,0,30/05/2021,0,0,0,0,0,0,0,0,0,0,0,0,0,1,0,1,0,0,0,0
1719,152422,2021,Italy,Slovenia,0,0,0,0,29/05/2021,0,0,0,0,0,0,0,0,0,0,0,0,0,0,0,0,0,0,0,0
1720,150436,2021,Italy,Germany,0,0,0,0,23/06/2021,0,0,12,12,0,0,0,0,0,0,0,0,5,3,15,23,12,4,1,17
1721,150436,2021,Russia,Italy,0,0,0,0,22/06/2021,0,0,11,11,0,0,0,0,0,0,0,0,6,3,12,21,10,3,2,15
1722,150436,2021,Brazil,Italy,0,0,0,0,21/06/2021,0,0,6,6,0,0,0,0,0,0,0,0,6,1,24,31,13,6,4,23
1723,150436,2021,France,Italy,0,0,0,0,17/06/2021,0,0,7,7,0,0,0,0,0,0,0,0,14,0,8,22,10,2,0,12
1724,150436,2021,Netherlands,Italy,0,0,0,0,16/06/2021,0,0,9,9,0,0,0,0,0,0,0,0,6,1,17,24,7,3,4,14
1725,150436,2021,Italy,USA,0,0,0,0,15/06/2021,0,0,9,9,0,0,0,0,0,0,0,0,4,2,8,14,6,2,2,10
1726,150436,2021,Australia,Italy,0,0,0,0,11/06/2021,0,0,4,4,0,0,0,0,0,0,0,0,7,0,7,14,13,3,0,16
1727,150436,2021,Japan,Italy,0,0,0,0,10/06/2021,0,0,7,7,0,0,0,0,0,0,0,0,7,2,14,23,18,2,4,24
1728,150436,2021,Argentina,Italy,0,0,0,0,09/06/2021,0,0,9,9,0,0,0,0,0,0,0,0,10,1,9,20,8,5,1,14
1729,150436,2021,Canada,Italy,0,0,0,0,05/06/2021,0,0,5,5,0,0,0,0,0,0,0,0,0,3,10,13,1,1,2,4
1730,150436,2021,Iran,Italy,0,0,0,0,04/06/2021,0,0,8,8,0,0,0,0,0,0,0,0,11,1,6,18,16,6,0,22
1731,150436,2021,Italy,Bulgaria,0,0,0,0,03/06/2021,0,0,9,9,0,0,0,0,0,0,0,0,8,1,13,22,20,4,1,25
1732,150436,2021,Serbia,Italy,0,0,0,0,30/05/2021,0,0,8,8,0,0,0,0,0,0,0,0,8,1,15,24,14,5,2,21
1733,150436,2021,Italy,Slovenia,0,0,0,0,29/05/2021,0,0,7,7,0,0,0,0,0,0,0,0,7,4,6,17,6,0,1,7
1734,150436,2021,Poland,Italy,0,0,0,0,28/05/2021,0,0,0,0,0,0,0,0,0,0,0,0,6,4,15,25,7,2,1,10
1735,152370,2021,Italy,Germany,0,2,10,12,23/06/2021,21,2,44,67,1,0,2,3,1,3,8,12,0,0,0,0,8,1,1,10
1736,152370,2021,Russia,Italy,0,0,1,1,22/06/2021,3,0,6,9,0,0,0,0,0,0,0,0,0,0,0,0,1,1,0,2
1737,152370,2021,Brazil,Italy,0,2,9,11,21/06/2021,23,2,65,90,0,0,0,0,1,2,3,6,0,0,0,0,5,5,1,11
1738,152370,2021,France,Italy,0,0,0,0,17/06/2021,0,0,0,0,0,0,0,0,0,0,0,0,0,0,0,0,0,0,0,0
1739,152370,2021,Netherlands,Italy,0,2,10,12,16/06/2021,14,1,60,75,1,0,1,2,1,3,2,6,0,0,0,0,6,1,2,9
1740,152370,2021,Italy,USA,0,1,4,5,15/06/2021,15,0,34,49,0,1,0,1,0,2,0,2,0,0,1,1,5,4,1,10
1741,152370,2021,Australia,Italy,0,2,8,10,11/06/2021,25,0,45,70,1,0,0,1,0,4,2,6,0,0,0,0,2,0,0,2
1742,152370,2021,Japan,Italy,0,0,0,0,10/06/2021,3,0,10,13,0,0,0,0,0,1,1,2,0,0,0,0,0,0,0,0
1743,152370,2021,Argentina,Italy,0,1,13,14,09/06/2021,14,0,64,78,2,0,0,2,1,5,2,8,0,0,0,0,2,2,2,6
1744,152370,2021,Canada,Italy,0,0,0,0,05/06/2021,1,0,2,3,0,0,0,0,0,0,0,0,0,0,0,0,1,1,0,2
1745,152370,2021,Iran,Italy,2,3,12,17,04/06/2021,24,2,81,107,0,1,3,4,0,3,2,5,0,0,1,1,8,3,1,12
1746,152370,2021,Italy,Bulgaria,1,2,15,18,03/06/2021,25,0,74,99,0,0,2,2,0,1,2,3,0,0,0,0,6,2,1,9
1747,152370,2021,Serbia,Italy,0,3,7,10,30/05/2021,15,0,93,108,0,0,0,0,1,2,1,4,0,0,0,0,8,3,1,12
1748,152370,2021,Italy,Slovenia,2,0,10,12,29/05/2021,23,0,42,65,1,0,0,1,0,1,0,1,0,0,1,1,0,0,0,0
1749,152370,2021,Poland,Italy,0,1,7,8,28/05/2021,22,0,1,23,1,1,0,2,1,1,2,4,0,0,1,1,5,1,3,9
1750,171191,2021,Italy,Germany,2,4,15,21,23/06/2021,0,0,4,4,17,5,13,35,3,2,2,7,5,0,15,20,13,2,1,16
1751,171191,2021,Russia,Italy,0,1,1,2,22/06/2021,0,0,1,1,4,0,1,5,0,0,1,1,2,0,6,8,4,0,0,4
1752,171191,2021,Brazil,Italy,0,2,11,13,21/06/2021,0,0,2,2,18,2,12,32,2,2,4,8,4,2,14,20,5,1,1,7
1753,171191,2021,France,Italy,0,2,18,20,17/06/2021,0,0,4,4,14,1,10,25,1,2,0,3,10,1,13,24,6,2,0,8
1754,171191,2021,Netherlands,Italy,5,2,18,25,16/06/2021,0,0,2,2,14,3,11,28,1,3,3,7,8,2,22,32,9,2,0,11
1755,171191,2021,Italy,USA,0,0,0,0,15/06/2021,0,0,0,0,0,0,0,0,0,0,0,0,2,0,0,2,2,0,0,2
1756,171191,2021,Australia,Italy,2,3,9,14,11/06/2021,0,0,1,1,9,4,7,20,2,0,2,4,6,0,7,13,7,1,0,8
1757,171191,2021,Japan,Italy,0,1,2,3,10/06/2021,0,0,1,1,7,1,3,11,1,0,0,1,1,1,14,16,2,2,1,5
1758,171191,2021,Argentina,Italy,0,3,5,8,09/06/2021,0,0,2,2,14,0,11,25,4,1,1,6,8,0,17,25,2,1,0,3
1759,171191,2021,Canada,Italy,0,0,1,1,05/06/2021,0,0,0,0,2,0,2,4,0,0,0,0,0,0,2,2,0,1,0,1
1760,171191,2021,Iran,Italy,1,3,6,10,04/06/2021,0,0,2,2,13,4,7,24,0,0,0,0,4,3,13,20,4,0,0,4
1761,171191,2021,Italy,Bulgaria,0,2,19,21,03/06/2021,0,0,1,1,18,0,14,32,3,5,0,8,6,0,23,29,9,4,1,14
1762,171191,2021,Serbia,Italy,0,3,15,18,30/05/2021,0,0,0,0,9,4,17,30,2,0,4,6,5,1,14,20,6,2,1,9
1763,171191,2021,Italy,Slovenia,0,3,4,7,29/05/2021,0,0,2,2,6,2,4,12,0,0,0,0,4,2,10,16,1,0,0,1
1764,171191,2021,Poland,Italy,0,2,9,11,28/05/2021,0,0,0,0,7,1,13,21,0,0,1,1,2,3,15,20,2,0,1,3
1765,137823,2021,Italy,Germany,0,5,5,10,23/06/2021,0,0,3,3,10,3,11,24,2,5,5,12,0,0,0,0,13,1,2,16
1766,137823,2021,Russia,Italy,1,3,3,7,22/06/2021,0,0,1,1,5,2,7,14,1,3,1,5,0,0,0,0,1,2,0,3
1767,137823,2021,Brazil,Italy,1,1,7,9,21/06/2021,0,0,1,1,4,4,5,13,0,4,3,7,0,0,0,0,2,2,0,4
1768,137823,2021,France,Italy,1,3,12,16,17/06/2021,0,1,2,3,19,5,7,31,1,2,5,8,0,0,0,0,1,6,0,7
1769,137823,2021,Netherlands,Italy,0,0,0,0,16/06/2021,0,0,0,0,0,0,0,0,0,0,0,0,0,0,0,0,0,0,0,0
1770,137823,2021,Japan,Italy,1,3,12,16,10/06/2021,0,0,3,3,15,4,12,31,0,2,3,5,1,0,0,1,7,1,2,10
1771,137823,2021,Argentina,Italy,2,3,5,10,09/06/2021,0,0,0,0,6,5,8,19,0,4,1,5,0,0,0,0,5,2,0,7
1772,137823,2021,Canada,Italy,2,5,13,20,05/06/2021,0,0,4,4,17,3,13,33,0,2,2,4,0,0,0,0,6,3,1,10
1773,137823,2021,Iran,Italy,3,6,7,16,04/06/2021,0,0,4,4,16,5,15,36,1,2,1,4,0,0,0,0,3,4,1,8
1774,137823,2021,Italy,Bulgaria,0,0,2,2,03/06/2021,0,0,1,1,0,0,0,0,0,0,0,0,0,0,0,0,0,0,0,0
1775,137823,2021,Serbia,Italy,0,1,0,1,30/05/2021,0,0,0,0,0,1,1,2,0,0,2,2,0,0,0,0,0,0,0,0
1776,137823,2021,Italy,Slovenia,1,2,7,10,29/05/2021,0,1,1,2,6,1,9,16,0,0,1,1,0,0,0,0,1,0,0,1
1777,137823,2021,Poland,Italy,0,5,4,9,28/05/2021,0,0,0,0,10,5,8,23,0,1,1,2,0,0,0,0,7,3,5,15
1778,143692,2021,Italy,Germany,0,0,4,4,23/06/2021,9,0,25,34,0,0,1,1,0,0,2,2,0,0,0,0,2,0,0,2
1779,143692,2021,Russia,Italy,1,1,12,14,22/06/2021,18,2,64,84,0,2,2,4,1,0,1,2,0,0,1,1,3,3,1,7
1780,143692,2021,Brazil,Italy,0,0,2,2,21/06/2021,5,0,14,19,1,0,0,1,0,1,0,1,0,0,0,0,0,0,0,0
1781,143692,2021,France,Italy,1,2,12,15,17/06/2021,20,0,85,105,1,0,0,1,4,1,3,8,0,0,0,0,4,3,0,7
1782,143692,2021,Netherlands,Italy,0,0,3,3,16/06/2021,3,0,10,13,1,0,0,1,0,0,0,0,0,0,0,0,0,0,0,0
1783,143692,2021,Italy,USA,0,0,3,3,15/06/2021,2,0,10,12,0,0,1,1,0,0,2,2,0,0,0,0,0,0,0,0
1784,143692,2021,Australia,Italy,0,0,0,0,11/06/2021,0,0,0,0,0,0,0,0,0,0,0,0,0,0,0,0,0,0,0,0
1785,143692,2021,Japan,Italy,0,0,12,12,10/06/2021,29,1,74,104,2,0,1,3,2,1,3,6,0,0,0,0,7,2,2,11
1786,143692,2021,Argentina,Italy,0,0,0,0,09/06/2021,0,0,0,0,0,1,0,1,0,0,0,0,0,0,0,0,0,0,0,0
1787,143692,2021,Canada,Italy,0,1,10,11,05/06/2021,10,1,75,86,0,1,3,4,3,1,4,8,0,0,0,0,11,3,0,14
1788,143692,2021,Iran,Italy,0,0,2,2,04/06/2021,3,0,5,8,0,0,0,0,0,0,0,0,0,0,0,0,0,0,0,0
1789,143692,2021,Italy,Bulgaria,0,0,0,0,03/06/2021,1,0,4,5,0,0,0,0,0,0,0,0,0,0,0,0,0,0,0,0
1790,143692,2021,Serbia,Italy,0,0,1,1,30/05/2021,2,0,2,4,0,0,0,0,0,1,1,2,0,0,0,0,1,1,0,2
1791,143692,2021,Italy,Slovenia,0,0,0,0,29/05/2021,1,0,1,2,0,0,0,0,0,0,0,0,0,0,0,0,0,0,0,0
1792,143692,2021,Poland,Italy,0,0,0,0,28/05/2021,1,0,0,1,0,0,0,0,0,0,0,0,0,0,0,0,1,1,0,2
1793,162518,2021,Italy,Germany,1,3,2,6,23/06/2021,0,0,0,0,2,3,4,9,1,0,0,1,0,0,0,0,2,0,0,2
1794,162518,2021,Russia,Italy,2,2,5,9,22/06/2021,0,0,1,1,8,2,1,11,0,0,0,0,0,0,0,0,0,4,0,4
1795,162518,2021,Brazil,Italy,1,3,5,9,21/06/2021,0,0,2,2,11,1,5,17,0,4,1,5,0,0,0,0,5,1,0,6
1796,162518,2021,France,Italy,0,0,1,1,17/06/2021,0,0,0,0,0,0,0,0,0,0,0,0,0,0,0,0,1,0,0,1
1797,162518,2021,Netherlands,Italy,1,3,8,12,16/06/2021,0,0,0,0,13,4,7,24,3,9,6,18,0,0,0,0,4,0,0,4
1798,162518,2021,Italy,USA,2,3,5,10,15/06/2021,0,0,0,0,5,3,9,17,0,2,7,9,0,1,1,2,5,1,0,6
1799,162518,2021,Australia,Italy,1,2,11,14,11/06/2021,0,0,0,0,11,1,6,18,1,3,2,6,0,0,0,0,4,4,2,10
1800,162518,2021,Japan,Italy,0,1,3,4,10/06/2021,0,0,0,0,0,1,4,5,0,4,1,5,0,0,0,0,0,1,0,1
1801,162518,2021,Argentina,Italy,0,1,2,3,09/06/2021,0,0,0,0,2,0,2,4,0,0,0,0,0,0,0,0,0,0,0,0
1802,162518,2021,Canada,Italy,0,0,0,0,05/06/2021,0,0,0,0,0,0,0,0,0,0,0,0,0,0,0,0,0,0,0,0
1803,162518,2021,Iran,Italy,0,0,1,1,04/06/2021,0,0,0,0,1,1,3,5,0,1,0,1,0,0,0,0,0,1,0,1
1804,162518,2021,Italy,Bulgaria,0,2,12,14,03/06/2021,0,0,2,2,18,3,9,30,0,3,1,4,0,0,1,1,6,4,0,10
1805,162518,2021,Serbia,Italy,1,3,12,16,30/05/2021,0,0,0,0,21,4,14,39,0,5,1,6,0,0,0,0,3,5,0,8
1806,162518,2021,Italy,Slovenia,0,1,0,1,29/05/2021,0,0,0,0,0,0,0,0,0,0,0,0,0,0,0,0,0,0,0,0
1807,162518,2021,Poland,Italy,0,0,0,0,28/05/2021,0,0,0,0,0,0,1,1,0,0,0,0,0,0,0,0,0,0,0,0
1808,152492,2021,Italy,Germany,1,1,1,3,23/06/2021,0,0,0,0,3,0,2,5,0,0,1,1,3,0,7,10,0,1,0,1
1809,152492,2021,Russia,Italy,0,0,2,2,22/06/2021,0,0,1,1,6,0,2,8,0,2,1,3,0,0,8,8,1,0,0,1
1810,152492,2021,Brazil,Italy,0,0,0,0,21/06/2021,0,0,0,0,0,0,0,0,0,0,0,0,0,0,0,0,0,0,0,0
1811,152492,2021,France,Italy,0,0,0,0,17/06/2021,0,0,0,0,0,0,0,0,0,0,0,0,0,0,0,0,0,0,0,0
1812,152492,2021,Netherlands,Italy,0,0,0,0,16/06/2021,0,0,0,0,0,0,0,0,0,0,0,0,0,0,0,0,0,0,0,0
1813,152492,2021,Italy,USA,0,0,3,3,15/06/2021,0,0,1,1,4,3,1,8,1,0,0,1,3,2,4,9,1,0,0,1
1814,152492,2021,Australia,Italy,0,4,7,11,11/06/2021,0,0,2,2,6,1,8,15,0,1,1,2,1,0,18,19,5,3,0,8
1815,152492,2021,Japan,Italy,0,1,0,1,10/06/2021,0,0,0,0,0,0,0,0,0,0,0,0,0,0,0,0,0,0,0,0
1816,152492,2021,Argentina,Italy,0,0,0,0,09/06/2021,0,0,0,0,0,0,0,0,0,0,0,0,0,0,0,0,0,0,0,0
1817,152492,2021,Canada,Italy,0,0,0,0,05/06/2021,0,0,0,0,0,0,0,0,0,0,0,0,0,0,0,0,0,0,0,0
1818,152492,2021,Iran,Italy,0,1,12,13,04/06/2021,0,1,1,2,10,5,14,29,0,5,1,6,11,2,14,27,7,5,0,12
1819,152492,2021,Italy,Bulgaria,1,2,10,13,03/06/2021,0,0,0,0,15,7,7,29,1,1,2,4,5,1,17,23,0,2,1,3
1820,152492,2021,Serbia,Italy,0,0,0,0,30/05/2021,0,0,0,0,0,0,0,0,0,0,0,0,0,0,0,0,0,0,0,0
1821,152492,2021,Italy,Slovenia,0,0,2,2,29/05/2021,0,0,0,0,1,2,1,4,0,0,0,0,0,0,1,1,0,0,0,0
1822,152492,2021,Poland,Italy,0,0,0,0,28/05/2021,0,0,0,0,0,0,0,0,0,0,0,0,0,0,0,0,0,0,0,0
1823,150435,2021,Italy,Germany,0,2,8,10,23/06/2021,0,0,0,0,1,0,0,1,0,0,0,0,0,0,0,0,0,0,0,0
1824,150435,2021,Russia,Italy,0,1,4,5,22/06/2021,0,0,0,0,2,0,0,2,0,1,2,3,0,0,0,0,1,0,0,1
1825,150435,2021,Brazil,Italy,0,1,12,13,21/06/2021,0,0,0,0,2,0,3,5,2,5,3,10,0,0,1,1,3,1,1,5
1826,150435,2021,France,Italy,0,3,6,9,17/06/2021,0,0,1,1,2,1,0,3,0,0,1,1,1,0,1,2,1,1,0,2
1827,150435,2021,Italy,USA,0,2,1,3,15/06/2021,0,0,0,0,0,0,0,0,0,0,0,0,0,0,0,0,0,1,0,1
1828,150435,2021,Australia,Italy,0,1,1,2,11/06/2021,0,0,0,0,0,0,0,0,0,0,0,0,0,0,0,0,0,0,0,0
1829,150435,2021,Japan,Italy,0,2,14,16,10/06/2021,0,0,3,3,5,0,7,12,2,7,8,17,0,0,1,1,5,1,3,9
1830,150435,2021,Argentina,Italy,2,4,7,13,09/06/2021,0,0,0,0,1,1,4,6,4,0,1,5,0,0,0,0,1,2,0,3
1831,150435,2021,Italy,Bulgaria,1,2,3,6,03/06/2021,0,0,0,0,0,1,1,2,0,0,0,0,0,0,0,0,0,0,0,0
1832,150435,2021,Serbia,Italy,0,0,0,0,30/05/2021,0,0,0,0,0,0,0,0,0,0,0,0,0,0,0,0,0,0,0,0
1833,150435,2021,Italy,Slovenia,0,2,1,3,29/05/2021,0,0,0,0,2,0,1,3,0,0,0,0,0,0,0,0,0,0,0,0
1834,163028,2021,Italy,Germany,0,0,21,21,23/06/2021,0,0,3,3,3,0,1,4,3,5,2,10,0,0,0,0,0,2,0,2
1835,163028,2021,Russia,Italy,0,0,14,14,22/06/2021,0,0,1,1,6,1,2,9,6,4,3,13,0,0,0,0,8,2,0,10
1836,163028,2021,Brazil,Italy,0,1,3,4,21/06/2021,0,0,0,0,1,0,2,3,0,2,4,6,0,0,0,0,2,1,0,3
1837,163028,2021,France,Italy,1,1,19,21,17/06/2021,0,0,0,0,8,0,2,10,4,6,0,10,0,0,0,0,2,0,0,2
1838,163028,2021,Netherlands,Italy,2,1,18,21,16/06/2021,0,0,1,1,4,0,3,7,0,5,3,8,1,0,0,1,4,0,0,4
1839,163028,2021,Italy,USA,1,1,10,12,15/06/2021,0,0,1,1,5,0,5,10,0,5,1,6,0,0,1,1,4,1,0,5
1840,163028,2021,Australia,Italy,0,0,0,0,11/06/2021,0,0,0,0,0,0,0,0,0,0,0,0,0,0,0,0,0,0,0,0
1841,163028,2021,Japan,Italy,0,1,7,8,10/06/2021,0,0,1,1,2,1,4,7,3,4,2,9,0,0,0,0,2,0,2,4
1842,163028,2021,Argentina,Italy,1,1,11,13,09/06/2021,0,0,0,0,2,0,4,6,4,1,3,8,0,0,0,0,1,0,0,1
1843,163028,2021,Canada,Italy,1,1,24,26,05/06/2021,0,0,0,0,1,0,2,3,5,5,6,16,0,0,1,1,2,0,0,2
1844,163028,2021,Iran,Italy,1,1,12,14,04/06/2021,0,0,0,0,8,1,3,12,0,3,2,5,0,0,0,0,1,3,0,4
1845,163028,2021,Italy,Bulgaria,2,2,8,12,03/06/2021,0,0,0,0,7,1,1,9,2,7,6,15,0,0,0,0,0,1,0,1
1846,163028,2021,Italy,Slovenia,0,1,3,4,29/05/2021,0,0,0,0,1,2,2,5,0,0,0,0,0,0,1,1,0,0,0,0
1847,163028,2021,Poland,Italy,0,1,7,8,28/05/2021,0,0,0,0,1,0,1,2,1,2,4,7,0,0,0,0,0,0,0,0
1848,181128,2021,Italy,Germany,0,0,0,0,23/06/2021,0,0,0,0,0,0,0,0,0,0,0,0,0,0,0,0,0,0,0,0
1849,181128,2021,Italy,USA,0,0,0,0,15/06/2021,0,0,0,0,0,0,0,0,0,0,0,0,0,0,0,0,0,0,0,0
1850,181128,2021,Poland,Italy,0,0,0,0,28/05/2021,0,0,0,0,0,0,0,0,0,0,0,0,0,0,0,0,0,0,0,0
1851,163033,2021,Italy,Germany,0,0,0,0,23/06/2021,0,0,0,0,0,0,0,0,0,0,0,0,0,1,0,1,0,0,0,0
1852,163033,2021,Russia,Italy,0,2,5,7,22/06/2021,0,0,1,1,10,6,9,25,1,1,0,2,6,0,21,27,6,0,0,6
1853,163033,2021,Brazil,Italy,0,2,9,11,21/06/2021,0,0,1,1,16,5,17,38,1,5,2,8,5,2,23,30,6,0,1,7
1854,163033,2021,France,Italy,1,2,7,10,17/06/2021,0,0,0,0,11,6,12,29,0,1,0,1,14,0,9,23,2,3,0,5
1855,163033,2021,Netherlands,Italy,0,3,9,12,16/06/2021,0,0,3,3,16,4,11,31,4,1,0,5,5,2,9,16,5,2,0,7
1856,163033,2021,Italy,USA,0,1,4,5,15/06/2021,0,0,2,2,1,3,6,10,0,2,0,2,1,1,7,9,1,0,0,1
1857,163033,2021,Australia,Italy,0,0,0,0,11/06/2021,0,0,0,0,0,0,0,0,0,0,0,0,0,0,0,0,0,0,0,0
1858,163033,2021,Japan,Italy,0,1,11,12,10/06/2021,0,0,1,1,16,2,16,34,0,4,3,7,5,0,19,24,4,1,2,7
1859,163033,2021,Argentina,Italy,1,2,12,15,09/06/2021,0,0,0,0,11,4,13,28,2,1,0,3,4,0,6,10,5,4,2,11
1860,163033,2021,Canada,Italy,0,2,12,14,05/06/2021,0,0,2,2,16,4,12,32,3,2,3,8,15,2,21,38,5,5,4,14
1861,163033,2021,Iran,Italy,0,1,9,10,04/06/2021,0,0,1,1,8,2,4,14,1,2,0,3,11,1,8,20,4,1,0,5
1862,163033,2021,Italy,Bulgaria,1,0,4,5,03/06/2021,0,0,1,1,0,1,1,2,0,0,0,0,3,0,4,7,1,3,0,4
1863,163033,2021,Serbia,Italy,0,2,13,15,30/05/2021,0,0,0,0,9,5,18,32,1,2,4,7,9,1,18,28,8,3,0,11
1864,163033,2021,Italy,Slovenia,0,1,1,2,29/05/2021,0,0,0,0,2,1,3,6,0,0,0,0,1,1,4,6,0,0,0,0
1865,163033,2021,Poland,Italy,0,1,2,3,28/05/2021,0,0,0,0,1,0,0,1,0,1,0,1,1,0,4,5,1,0,1,2
1866,163447,2021,Italy,Germany,1,4,6,11,23/06/2021,0,0,0,0,12,5,13,30,1,1,1,3,4,1,15,20,4,1,0,5
1867,163447,2021,Russia,Italy,4,5,23,32,22/06/2021,0,0,3,3,10,7,12,29,0,2,0,2,5,2,10,17,6,2,0,8
1868,163447,2021,Brazil,Italy,1,2,1,4,21/06/2021,0,0,0,0,2,0,2,4,0,0,0,0,1,0,1,2,0,0,0,0
1869,163447,2021,France,Italy,1,2,3,6,17/06/2021,0,0,0,0,7,1,6,14,0,0,1,1,1,2,7,10,1,0,0,1
1870,163447,2021,Netherlands,Italy,0,0,0,0,16/06/2021,0,0,0,0,0,0,0,0,0,0,0,0,0,0,0,0,0,0,0,0
1871,163447,2021,Italy,USA,0,1,3,4,15/06/2021,0,0,0,0,5,3,7,15,0,0,0,0,4,0,6,10,2,1,0,3
1872,163447,2021,Australia,Italy,0,0,0,0,11/06/2021,0,0,0,0,0,0,0,0,0,0,0,0,0,0,0,0,0,0,0,0
1873,163447,2021,Japan,Italy,2,3,10,15,10/06/2021,0,0,0,0,9,4,10,23,4,6,3,13,2,2,23,27,3,3,3,9
1874,163447,2021,Argentina,Italy,0,0,0,0,09/06/2021,0,0,0,0,0,0,0,0,0,0,0,0,0,0,0,0,0,0,0,0
1875,163447,2021,Canada,Italy,2,4,17,23,05/06/2021,0,0,3,3,10,7,11,28,2,3,4,9,4,2,13,19,5,2,1,8
1876,163447,2021,Iran,Italy,0,1,0,1,04/06/2021,0,0,0,0,0,0,0,0,0,0,0,0,0,0,0,0,0,0,0,0
1877,163447,2021,Italy,Bulgaria,0,0,0,0,03/06/2021,0,0,0,0,0,0,0,0,0,0,0,0,0,0,0,0,0,0,0,0
1878,163447,2021,Serbia,Italy,0,0,0,0,30/05/2021,0,0,0,0,0,0,0,0,0,0,0,0,0,0,0,0,0,0,0,0
1879,163447,2021,Italy,Slovenia,0,1,5,6,29/05/2021,0,0,1,1,4,4,12,20,1,0,0,1,9,1,7,17,0,0,0,0
1880,163447,2021,Poland,Italy,0,3,5,8,28/05/2021,0,0,0,0,9,5,13,27,2,2,4,8,2,1,4,7,3,1,0,4
1881,174074,2021,Italy,Germany,0,1,10,11,23/06/2021,0,0,0,0,9,1,3,13,4,6,4,14,0,0,4,4,2,0,0,2
1882,174074,2021,Russia,Italy,0,0,7,7,22/06/2021,0,0,0,0,6,0,0,6,1,1,1,3,0,0,1,1,1,0,0,1
1883,174074,2021,Brazil,Italy,0,1,18,19,21/06/2021,0,0,0,0,6,1,4,11,3,6,7,16,0,0,3,3,3,0,0,3
1884,174074,2021,France,Italy,1,0,8,9,17/06/2021,0,1,0,1,2,2,3,7,1,2,1,4,1,0,2,3,3,1,0,4
1885,174074,2021,Netherlands,Italy,0,1,10,11,16/06/2021,0,0,2,2,3,2,4,9,3,3,8,14,0,0,0,0,1,0,0,1
1886,174074,2021,Italy,USA,0,0,5,5,15/06/2021,0,0,0,0,4,1,1,6,0,1,1,2,0,1,0,1,1,0,0,1
1887,174074,2021,Australia,Italy,0,0,12,12,11/06/2021,0,0,0,0,5,1,2,8,1,0,3,4,0,0,0,0,0,1,0,1
1888,174074,2021,Japan,Italy,0,1,7,8,10/06/2021,0,0,0,0,3,1,2,6,0,3,4,7,0,0,0,0,0,0,1,1
1889,174074,2021,Argentina,Italy,0,0,3,3,09/06/2021,0,0,0,0,0,0,0,0,1,1,0,2,1,0,0,1,0,0,0,0
1890,174074,2021,Canada,Italy,0,1,12,13,05/06/2021,0,0,3,3,3,0,1,4,5,6,4,15,0,0,0,0,0,1,0,1
1891,174074,2021,Iran,Italy,0,0,2,2,04/06/2021,0,0,0,0,0,0,2,2,0,0,0,0,0,0,0,0,0,0,0,0
1892,174074,2021,Italy,Bulgaria,0,0,0,0,03/06/2021,0,0,0,0,0,0,0,0,0,0,0,0,0,0,0,0,0,0,0,0
1893,174074,2021,Serbia,Italy,0,0,13,13,30/05/2021,0,0,0,0,6,0,6,12,2,5,2,9,1,0,0,1,2,1,0,3
1894,174074,2021,Poland,Italy,0,0,1,1,28/05/2021,0,0,0,0,0,0,0,0,0,0,1,1,0,0,0,0,0,0,0,0
1895,163025,2021,Italy,Germany,0,0,0,0,23/06/2021,0,0,0,0,0,0,0,0,0,0,0,0,0,0,0,0,0,0,0,0
1896,163025,2021,Russia,Italy,0,0,0,0,22/06/2021,0,0,0,0,0,0,0,0,0,0,0,0,0,0,0,0,0,0,0,0
1897,163025,2021,Brazil,Italy,0,0,0,0,21/06/2021,0,0,0,0,0,0,0,0,0,0,0,0,0,0,0,0,0,0,0,0
1898,163025,2021,France,Italy,0,0,0,0,17/06/2021,0,0,0,0,0,0,0,0,0,0,0,0,0,0,0,0,0,0,0,0
1899,163025,2021,Netherlands,Italy,0,0,0,0,16/06/2021,0,0,0,0,0,0,0,0,0,0,0,0,0,0,0,0,0,0,0,0
1900,163025,2021,Italy,USA,0,0,0,0,15/06/2021,0,0,0,0,0,0,0,0,0,0,0,0,0,0,0,0,0,0,0,0
1901,163025,2021,Australia,Italy,0,0,0,0,11/06/2021,0,0,0,0,0,0,0,0,0,0,0,0,0,0,0,0,0,0,0,0
1902,163025,2021,Japan,Italy,0,0,0,0,10/06/2021,0,0,0,0,0,0,0,0,0,0,0,0,0,0,0,0,0,0,0,0
1903,163025,2021,Argentina,Italy,0,0,0,0,09/06/2021,0,0,0,0,0,0,0,0,0,0,0,0,0,0,0,0,0,0,0,0
1904,163025,2021,Canada,Italy,0,0,0,0,05/06/2021,0,0,4,4,0,0,0,0,0,0,0,0,4,1,8,13,5,4,1,10
1905,163025,2021,Iran,Italy,0,0,0,0,04/06/2021,0,0,0,0,0,0,0,0,0,0,0,0,0,0,0,0,0,0,0,0
1906,163025,2021,Italy,Bulgaria,0,0,0,0,03/06/2021,0,0,0,0,0,0,0,0,0,0,0,0,0,0,0,0,0,0,0,0
1907,163025,2021,Serbia,Italy,0,0,0,0,30/05/2021,0,0,0,0,0,0,0,0,0,0,0,0,0,0,0,0,0,0,0,0
1908,163025,2021,Italy,Slovenia,0,0,0,0,29/05/2021,0,0,0,0,0,0,0,0,0,0,0,0,0,0,0,0,0,0,0,0
1909,163025,2021,Poland,Italy,0,0,0,0,28/05/2021,0,0,0,0,0,0,0,0,0,0,0,0,0,1,1,2,0,0,0,0
1910,118511,2021,USA,Japan,0,1,0,1,23/06/2021,0,0,0,0,0,0,1,1,0,0,0,0,0,0,0,0,0,0,0,0
1911,118511,2021,Japan,Slovenia,0,1,9,10,22/06/2021,0,0,0,0,12,10,7,29,0,2,0,2,0,0,1,1,1,1,0,2
1912,118511,2021,Japan,Bulgaria,0,1,2,3,21/06/2021,0,0,0,0,1,0,1,2,0,0,0,0,0,0,1,1,0,0,0,0
1913,118511,2021,Japan,Canada,0,2,4,6,17/06/2021,0,0,0,0,10,2,12,24,1,2,2,5,0,0,1,1,5,0,0,5
1914,118511,2021,Japan,Germany,0,1,8,9,15/06/2021,0,0,0,0,11,3,7,21,0,0,2,2,0,0,0,0,1,1,1,3
1915,118511,2021,Japan,Argentina,0,0,3,3,11/06/2021,0,0,0,0,5,0,3,8,0,0,1,1,0,0,0,0,1,1,1,3
1916,118511,2021,Japan,Italy,1,0,2,3,10/06/2021,0,0,1,1,3,2,6,11,1,1,3,5,0,0,0,0,1,0,1,2
1917,118511,2021,Japan,Australia,1,1,16,18,09/06/2021,0,0,1,1,15,4,12,31,1,2,3,6,0,0,0,0,4,2,0,6
1918,118511,2021,France,Japan,1,2,12,15,05/06/2021,1,0,0,1,16,7,13,36,1,5,3,9,0,0,0,0,2,2,1,5
1919,118511,2021,Brazil,Japan,0,1,7,8,04/06/2021,0,0,0,0,8,4,2,14,0,1,0,1,0,0,1,1,1,1,0,2
1920,118511,2021,Japan,Serbia,0,0,7,7,03/06/2021,0,1,1,2,12,3,6,21,1,2,0,3,2,0,1,3,0,3,1,4
1921,118511,2021,Netherlands,Japan,0,0,9,9,29/05/2021,0,0,0,0,7,4,1,12,0,1,1,2,0,1,1,2,0,0,1,1
1922,118511,2021,Japan,Iran,0,0,9,9,28/05/2021,0,0,1,1,3,1,4,8,0,0,0,0,0,0,0,0,0,0,0,0
1923,142565,2021,USA,Japan,0,2,6,8,23/06/2021,0,0,0,0,2,1,6,9,1,3,1,5,1,0,0,1,1,1,0,2
1924,142565,2021,Japan,Slovenia,0,0,0,0,22/06/2021,0,0,0,0,0,0,0,0,0,0,0,0,0,0,0,0,0,0,0,0
1925,142565,2021,Japan,Bulgaria,0,0,6,6,21/06/2021,0,0,0,0,6,1,3,10,2,7,1,10,0,0,1,1,2,1,0,3
1926,142565,2021,Japan,Canada,0,0,9,9,17/06/2021,0,0,0,0,4,0,2,6,0,4,7,11,3,0,0,3,4,1,0,5
1927,142565,2021,Japan,Germany,0,2,7,9,15/06/2021,0,0,0,0,6,1,3,10,2,3,0,5,2,0,0,2,1,0,0,1
1928,142565,2021,Japan,Argentina,0,0,0,0,11/06/2021,0,0,0,0,0,0,0,0,0,0,0,0,0,0,0,0,0,0,0,0
1929,142565,2021,Japan,Italy,0,0,12,12,10/06/2021,0,0,2,2,2,1,4,7,1,4,0,5,2,0,1,3,2,2,0,4
1930,142565,2021,Japan,Australia,0,2,8,10,09/06/2021,0,0,0,0,7,3,6,16,2,4,4,10,0,0,2,2,1,2,0,3
1931,142565,2021,France,Japan,2,4,14,20,05/06/2021,0,0,0,0,8,0,5,13,2,2,0,4,0,0,1,1,1,4,1,6
1932,142565,2021,Japan,Serbia,0,2,12,14,03/06/2021,0,0,1,1,4,0,3,7,3,4,0,7,0,0,0,0,1,0,0,1
1933,142565,2021,Russia,Japan,0,1,0,1,30/05/2021,0,0,0,0,0,0,0,0,0,0,0,0,0,0,0,0,0,0,0,0
1934,142565,2021,Netherlands,Japan,2,1,17,20,29/05/2021,0,0,0,0,6,1,7,14,0,1,1,2,0,0,0,0,2,0,0,2
1935,142565,2021,Japan,Iran,0,1,10,11,28/05/2021,0,0,0,0,4,0,3,7,0,0,1,1,0,0,0,0,1,0,0,1
1936,162104,2021,USA,Japan,0,1,5,6,23/06/2021,9,0,40,49,0,0,0,0,0,0,0,0,0,0,0,0,2,2,0,4
1937,162104,2021,Japan,Argentina,0,0,0,0,11/06/2021,0,0,0,0,0,0,0,0,0,0,0,0,0,0,0,0,0,0,0,0
1938,162104,2021,Japan,Italy,0,1,15,16,10/06/2021,41,1,59,101,1,0,0,1,0,2,0,2,0,0,0,0,5,1,2,8
1939,162104,2021,Japan,Australia,0,2,18,20,09/06/2021,36,0,58,94,0,0,0,0,1,4,0,5,0,0,0,0,7,1,1,9
1940,162104,2021,France,Japan,0,1,10,11,05/06/2021,24,1,68,93,0,0,1,1,0,2,2,4,0,0,1,1,3,3,0,6
1941,162104,2021,Brazil,Japan,0,0,4,4,04/06/2021,16,0,25,41,0,0,0,0,0,0,0,0,0,0,0,0,4,2,1,7
1942,162104,2021,Japan,Serbia,1,0,9,10,03/06/2021,13,0,32,45,1,0,0,1,1,0,0,1,0,0,0,0,4,2,0,6
1943,162104,2021,Netherlands,Japan,0,0,3,3,29/05/2021,8,0,51,59,0,0,0,0,0,0,2,2,0,0,0,0,1,1,0,2
1944,162104,2021,Japan,Iran,0,0,10,10,28/05/2021,3,0,71,74,0,0,1,1,0,0,0,0,0,0,0,0,0,0,1,1
1945,142575,2021,Japan,Poland,0,2,1,3,16/06/2021,0,0,0,0,3,2,4,9,0,0,1,1,0,0,0,0,2,0,1,3
1946,142575,2021,Japan,Argentina,0,4,5,9,11/06/2021,0,0,2,2,15,2,15,32,0,2,3,5,0,0,0,0,8,3,2,13
1947,142575,2021,Japan,Australia,0,0,2,2,09/06/2021,0,0,1,1,2,2,5,9,0,1,4,5,0,0,0,0,2,0,1,3
1948,142575,2021,Brazil,Japan,0,0,0,0,04/06/2021,0,0,0,0,0,0,0,0,0,0,0,0,0,0,0,0,0,0,0,0
1949,142575,2021,Japan,Serbia,1,3,3,7,03/06/2021,0,1,0,1,8,6,5,19,0,2,2,4,0,0,0,0,1,1,1,3
1950,142575,2021,Russia,Japan,1,5,5,11,30/05/2021,0,0,0,0,21,2,6,29,3,0,2,5,0,0,0,0,3,5,2,10
1951,114415,2021,Japan,Slovenia,0,1,0,1,22/06/2021,0,0,0,0,2,1,1,4,0,1,0,1,3,0,5,8,1,0,0,1
1952,114415,2021,Japan,Bulgaria,0,0,0,0,21/06/2021,0,0,0,0,0,0,0,0,0,0,0,0,0,0,0,0,0,0,0,0
1953,114415,2021,Japan,Canada,0,0,0,0,17/06/2021,0,0,0,0,0,0,0,0,0,0,0,0,0,0,0,0,0,0,0,0
1954,114415,2021,Japan,Poland,0,2,0,2,16/06/2021,0,0,1,1,3,2,6,11,0,1,0,1,1,1,5,7,3,0,0,3
1955,114415,2021,Japan,Germany,0,0,0,0,15/06/2021,0,0,0,0,0,0,0,0,0,0,0,0,0,0,0,0,0,0,0,0
1956,114415,2021,Japan,Argentina,0,1,11,12,11/06/2021,0,0,4,4,12,10,10,32,0,2,2,4,6,2,17,25,7,1,0,8
1957,114415,2021,Japan,Italy,0,0,0,0,10/06/2021,0,0,0,0,0,0,0,0,0,0,0,0,0,0,0,0,0,0,0,0
1958,114415,2021,Japan,Australia,0,0,0,0,09/06/2021,0,0,0,0,0,0,0,0,0,0,0,0,0,0,0,0,0,0,0,0
1959,114415,2021,France,Japan,0,0,0,0,05/06/2021,0,0,0,0,0,0,0,0,0,0,0,0,0,0,0,0,0,0,0,0
1960,114415,2021,Brazil,Japan,0,1,2,3,04/06/2021,0,0,0,0,2,2,3,7,0,0,2,2,2,0,6,8,3,0,0,3
1961,114415,2021,Japan,Serbia,0,0,0,0,03/06/2021,0,0,0,0,0,0,0,0,0,0,0,0,0,0,0,0,0,0,0,0
1962,114415,2021,Russia,Japan,0,2,6,8,30/05/2021,0,0,0,0,14,5,9,28,0,2,0,2,6,1,12,19,5,0,2,7
1963,114415,2021,Netherlands,Japan,0,0,0,0,29/05/2021,0,0,0,0,0,0,0,0,0,0,0,0,0,0,0,0,0,0,0,0
1964,114415,2021,Japan,Iran,0,0,0,0,28/05/2021,0,0,0,0,0,0,0,0,0,0,0,0,0,0,0,0,0,0,0,0
1965,146409,2021,USA,Japan,0,0,9,9,23/06/2021,0,0,0,0,5,1,5,11,0,1,0,1,0,0,0,0,2,1,0,3
1966,146409,2021,Japan,Slovenia,0,0,7,7,22/06/2021,0,0,2,2,0,1,2,3,2,2,1,5,1,0,0,1,1,1,0,2
1967,146409,2021,Japan,Bulgaria,1,0,15,16,21/06/2021,0,0,0,0,5,1,2,8,0,3,1,4,0,0,0,0,3,2,0,5
1968,146409,2021,Japan,Canada,0,1,10,11,17/06/2021,0,0,0,0,5,1,2,8,0,6,3,9,1,0,3,4,3,0,0,3
1969,146409,2021,Japan,Poland,0,0,2,2,16/06/2021,0,0,1,1,2,0,2,4,0,1,3,4,0,0,1,1,2,1,0,3
1970,146409,2021,Japan,Germany,1,0,9,10,15/06/2021,0,0,2,2,2,1,2,5,1,0,0,1,0,0,0,0,0,1,0,1
1971,146409,2021,Japan,Argentina,0,1,10,11,11/06/2021,0,0,1,1,9,1,3,13,2,8,1,11,0,0,2,2,1,0,0,1
1972,146409,2021,Japan,Italy,0,0,8,8,10/06/2021,0,0,1,1,3,0,3,6,1,0,2,3,2,0,1,3,2,0,1,3
1973,146409,2021,Japan,Australia,0,0,0,0,09/06/2021,0,0,0,0,0,0,0,0,0,0,0,0,0,0,0,0,0,0,0,0
1974,146409,2021,France,Japan,0,2,9,11,05/06/2021,0,0,1,1,2,1,1,4,0,2,1,3,0,0,0,0,0,0,0,0
1975,146409,2021,Brazil,Japan,1,0,10,11,04/06/2021,0,0,2,2,4,0,4,8,2,3,1,6,0,0,3,3,0,0,1,1
1976,146409,2021,Japan,Serbia,0,2,8,10,03/06/2021,0,0,0,0,6,0,2,8,1,2,0,3,0,0,0,0,2,1,0,3
1977,146409,2021,Russia,Japan,0,0,0,0,30/05/2021,0,0,0,0,0,0,0,0,0,0,0,0,0,0,0,0,0,0,0,0
1978,146409,2021,Netherlands,Japan,0,0,2,2,29/05/2021,0,0,0,0,0,0,1,1,0,0,0,0,0,0,0,0,0,0,0,0
1979,146409,2021,Japan,Iran,0,0,11,11,28/05/2021,0,1,0,1,2,1,5,8,3,2,0,5,0,0,0,0,0,0,0,0
1980,163519,2021,USA,Japan,0,1,8,9,23/06/2021,0,0,0,0,9,5,10,24,1,0,1,2,0,0,0,0,1,0,0,1
1981,163519,2021,Japan,Slovenia,0,1,2,3,22/06/2021,0,0,1,1,5,0,4,9,1,1,1,3,0,0,0,0,0,1,0,1
1982,163519,2021,Japan,Bulgaria,0,3,5,8,21/06/2021,0,0,0,0,20,4,5,29,3,4,2,9,0,0,0,0,4,2,0,6
1983,163519,2021,Japan,Canada,0,1,2,3,17/06/2021,0,0,1,1,0,1,1,2,0,0,0,0,0,0,0,0,2,2,0,4
1984,163519,2021,Japan,Poland,0,2,1,3,16/06/2021,0,0,0,0,2,3,1,6,0,0,0,0,0,0,0,0,2,0,0,2
1985,133009,2021,USA,Japan,0,0,4,4,23/06/2021,3,0,23,26,0,0,0,0,0,0,0,0,0,0,0,0,1,2,0,3
1986,133009,2021,Japan,Slovenia,0,1,1,2,22/06/2021,6,0,25,31,1,0,0,1,0,0,1,1,0,0,0,0,1,2,0,3
1987,133009,2021,Japan,Bulgaria,1,0,6,7,21/06/2021,16,0,50,66,0,0,0,0,0,3,2,5,0,0,0,0,5,1,1,7
1988,133009,2021,Japan,Canada,1,2,11,14,17/06/2021,18,1,57,76,0,0,0,0,0,3,3,6,0,0,1,1,5,1,1,7
1989,133009,2021,Japan,Poland,0,0,2,2,16/06/2021,8,0,11,19,0,0,0,0,0,0,0,0,0,0,1,1,1,0,0,1
1990,133009,2021,Japan,Germany,0,1,15,16,15/06/2021,19,0,47,66,0,0,3,3,1,1,0,2,0,0,0,0,6,3,0,9
1991,133009,2021,Japan,Argentina,1,4,14,19,11/06/2021,37,1,78,116,0,1,0,1,0,3,1,4,0,0,2,2,14,5,1,20
1992,133009,2021,Japan,Italy,0,0,0,0,10/06/2021,5,0,16,21,0,0,0,0,0,0,0,0,0,0,0,0,4,0,0,4
1993,133009,2021,Japan,Australia,0,0,1,1,09/06/2021,5,0,8,13,0,0,0,0,0,0,0,0,0,0,0,0,2,2,0,4
1994,133009,2021,France,Japan,0,0,2,2,05/06/2021,3,0,14,17,0,0,0,0,0,1,0,1,0,0,1,1,0,1,0,1
1995,133009,2021,Japan,Serbia,0,0,5,5,03/06/2021,9,1,41,51,0,0,2,2,0,0,0,0,0,0,0,0,1,1,0,2
1996,133009,2021,Russia,Japan,1,0,11,12,30/05/2021,15,0,64,79,0,0,0,0,0,1,2,3,0,0,1,1,6,2,1,9
1997,133009,2021,Netherlands,Japan,0,3,10,13,29/05/2021,21,0,28,49,0,0,0,0,1,1,1,3,0,0,0,0,1,1,1,3
1998,133009,2021,Japan,Iran,0,1,2,3,28/05/2021,1,0,14,15,0,0,0,0,0,0,0,0,0,0,0,0,0,0,0,0
1999,142570,2021,USA,Japan,0,0,0,0,23/06/2021,0,0,0,0,0,0,0,0,0,0,0,0,0,0,0,0,0,0,0,0
2000,142570,2021,Japan,Slovenia,0,0,3,3,22/06/2021,14,2,32,48,0,0,0,0,0,1,0,1,0,0,0,0,3,1,0,4
2001,142570,2021,Japan,Bulgaria,0,0,0,0,21/06/2021,1,0,6,7,0,0,0,0,0,0,0,0,0,0,0,0,0,0,0,0
2002,142570,2021,Japan,Canada,0,0,0,0,17/06/2021,0,0,0,0,0,0,0,0,0,0,0,0,0,0,0,0,0,0,0,0
2003,142570,2021,Japan,Poland,0,2,5,7,16/06/2021,20,1,29,50,0,0,0,0,0,1,4,5,0,0,0,0,3,2,1,6
2004,142570,2021,Japan,Germany,0,0,0,0,15/06/2021,0,0,0,0,0,0,0,0,0,0,0,0,0,0,0,0,0,0,0,0
2005,142570,2021,Brazil,Japan,0,1,1,2,04/06/2021,8,0,14,22,0,0,0,0,0,1,0,1,0,0,0,0,2,1,0,3
2006,142570,2021,Russia,Japan,0,1,11,12,30/05/2021,17,0,37,54,0,1,0,1,0,2,1,3,0,0,0,0,2,1,1,4
2007,142568,2021,USA,Japan,1,4,8,13,23/06/2021,0,0,2,2,12,3,11,26,1,1,0,2,6,0,8,14,3,3,0,6
2008,142568,2021,Japan,Slovenia,0,0,3,3,22/06/2021,0,0,0,0,1,1,3,5,0,0,0,0,4,0,1,5,1,0,0,1
2009,142568,2021,Japan,Bulgaria,0,1,13,14,21/06/2021,0,0,8,8,11,2,5,18,1,2,6,9,8,0,10,18,10,0,1,11
2010,142568,2021,Japan,Canada,0,3,7,10,17/06/2021,0,0,6,6,11,3,12,26,1,4,2,7,5,1,13,19,5,4,2,11
2011,142568,2021,Japan,Poland,0,0,0,0,16/06/2021,0,0,0,0,0,0,0,0,0,0,0,0,0,0,0,0,0,0,0,0
2012,142568,2021,Japan,Germany,3,4,12,19,15/06/2021,0,0,3,3,17,1,5,23,0,2,0,2,8,1,9,18,5,5,0,10
2013,142568,2021,Japan,Argentina,0,0,0,0,11/06/2021,0,0,0,0,0,0,0,0,0,0,0,0,0,0,0,0,0,0,0,0
2014,142568,2021,Japan,Italy,0,4,12,16,10/06/2021,0,0,3,3,19,6,16,41,2,8,4,14,12,1,20,33,12,4,2,18
2015,142568,2021,Japan,Australia,2,3,15,20,09/06/2021,1,0,6,7,20,2,9,31,0,4,6,10,11,0,17,28,12,1,1,14
2016,142568,2021,France,Japan,2,4,14,20,05/06/2021,1,0,4,5,22,1,10,33,1,2,1,4,16,3,9,28,1,2,1,4
2017,142568,2021,Brazil,Japan,0,2,5,7,04/06/2021,0,0,3,3,6,0,5,11,1,3,1,5,5,0,13,18,4,1,0,5
2018,142568,2021,Russia,Japan,0,0,0,0,30/05/2021,0,0,0,0,0,0,0,0,0,0,0,0,0,0,0,0,0,0,0,0
2019,142568,2021,Netherlands,Japan,0,4,15,19,29/05/2021,0,0,0,0,15,2,8,25,2,4,1,7,12,0,13,25,4,1,0,5
2020,142568,2021,Japan,Iran,1,3,8,12,28/05/2021,0,0,0,0,15,7,9,31,2,0,0,2,8,1,4,13,0,0,0,0
2021,146410,2021,USA,Japan,0,0,2,2,23/06/2021,0,0,1,1,0,0,0,0,0,0,0,0,0,0,0,0,0,0,0,0
2022,146410,2021,Japan,Slovenia,1,0,11,12,22/06/2021,0,0,0,0,1,2,4,7,0,4,1,5,0,0,0,0,3,2,0,5
2023,146410,2021,Japan,Bulgaria,0,0,0,0,21/06/2021,0,0,0,0,0,0,0,0,0,0,0,0,0,0,0,0,0,0,0,0
2024,146410,2021,Japan,Canada,0,0,0,0,17/06/2021,0,0,0,0,0,0,0,0,0,0,0,0,0,0,0,0,0,0,0,0
2025,146410,2021,Japan,Poland,0,1,7,8,16/06/2021,0,0,1,1,3,0,2,5,0,1,3,4,0,1,0,1,1,2,0,3
2026,146410,2021,Japan,Germany,0,0,0,0,15/06/2021,0,0,0,0,0,0,0,0,0,0,0,0,0,0,0,0,0,0,0,0
2027,146410,2021,Japan,Argentina,0,2,15,17,11/06/2021,0,0,0,0,2,0,3,5,0,6,3,9,1,0,0,1,4,1,1,6
2028,146410,2021,Japan,Italy,1,2,16,19,10/06/2021,0,0,0,0,9,0,2,11,0,3,16,19,1,0,1,2,7,0,1,8
2029,146410,2021,Japan,Australia,1,2,12,15,09/06/2021,0,0,0,0,7,1,2,10,3,3,3,9,2,0,0,2,3,0,0,3
2030,146410,2021,France,Japan,0,0,1,1,05/06/2021,0,0,0,0,0,0,0,0,0,0,0,0,0,0,0,0,0,1,0,1
2031,146410,2021,Brazil,Japan,0,1,7,8,04/06/2021,0,0,0,0,0,1,5,6,3,1,7,11,0,0,1,1,1,1,0,2
2032,146410,2021,Japan,Serbia,0,0,0,0,03/06/2021,0,0,0,0,0,0,0,0,0,0,0,0,0,0,0,0,0,0,0,0
2033,146410,2021,Russia,Japan,1,1,17,19,30/05/2021,0,0,0,0,8,2,0,10,2,5,2,9,0,1,0,1,6,1,0,7
2034,146410,2021,Netherlands,Japan,0,0,0,0,29/05/2021,0,0,0,0,0,0,0,0,0,0,0,0,0,0,0,0,0,0,0,0
2035,146410,2021,Japan,Iran,0,0,0,0,28/05/2021,0,0,0,0,0,0,0,0,0,0,0,0,0,0,0,0,0,0,0,0
2036,142561,2021,Japan,Poland,0,4,0,4,16/06/2021,0,0,0,0,4,0,1,5,0,4,1,5,0,0,0,0,0,0,0,0
2037,142561,2021,Japan,Germany,0,0,0,0,15/06/2021,0,0,0,0,0,0,0,0,0,0,0,0,0,0,0,0,0,0,0,0
2038,142561,2021,Japan,Argentina,0,1,2,3,11/06/2021,0,0,1,1,1,1,3,5,0,0,0,0,0,0,0,0,0,0,0,0
2039,142561,2021,Japan,Italy,0,2,0,2,10/06/2021,0,0,0,0,2,0,1,3,0,2,1,3,0,0,0,0,0,0,1,1
2040,142561,2021,France,Japan,0,2,4,6,05/06/2021,0,0,2,2,3,1,2,6,2,3,0,5,0,0,0,0,0,1,0,1
2041,142561,2021,Brazil,Japan,0,0,0,0,04/06/2021,0,0,0,0,0,0,0,0,0,0,0,0,0,0,0,0,0,0,0,0
2042,142561,2021,Japan,Serbia,0,0,3,3,03/06/2021,0,0,0,0,1,0,2,3,0,1,0,1,0,0,1,1,0,1,0,1
2043,142561,2021,Russia,Japan,0,4,8,12,30/05/2021,0,0,0,0,8,2,4,14,2,0,2,4,0,0,1,1,1,1,0,2
2044,142561,2021,Netherlands,Japan,0,5,6,11,29/05/2021,0,0,0,0,6,0,1,7,2,1,0,3,0,0,0,0,0,0,0,0
2045,142561,2021,Japan,Iran,0,0,0,0,28/05/2021,0,0,0,0,0,0,0,0,0,0,0,0,0,0,0,0,0,0,0,0
2046,153365,2021,USA,Japan,0,0,0,0,23/06/2021,0,0,0,0,0,0,0,0,0,0,0,0,0,0,0,0,0,0,0,0
2047,153365,2021,Japan,Slovenia,1,1,7,9,22/06/2021,0,0,3,3,11,3,2,16,1,0,0,1,8,2,13,23,2,1,0,3
2048,153365,2021,Japan,Bulgaria,0,0,0,0,21/06/2021,0,0,0,0,0,0,0,0,0,1,0,1,0,0,1,1,0,0,0,0
2049,153365,2021,Japan,Canada,0,0,3,3,17/06/2021,0,0,2,2,4,1,3,8,0,2,0,2,0,2,5,7,0,2,0,2
2050,153365,2021,Japan,Poland,0,4,9,13,16/06/2021,0,0,4,4,10,3,3,16,0,0,0,0,3,2,16,21,4,2,1,7
2051,153365,2021,Japan,Germany,0,0,0,0,15/06/2021,0,0,0,0,0,1,0,1,1,0,0,1,0,0,0,0,0,0,0,0
2052,153365,2021,Japan,Italy,0,0,0,0,10/06/2021,0,0,0,0,0,1,0,1,0,0,0,0,1,0,0,1,0,0,0,0
2053,153365,2021,Japan,Australia,0,1,3,4,09/06/2021,0,0,1,1,2,1,3,6,0,1,1,2,3,0,2,5,3,2,0,5
2054,153365,2021,France,Japan,0,2,7,9,05/06/2021,0,0,0,0,8,4,4,16,0,0,2,2,6,1,13,20,0,2,0,2
2055,153365,2021,Brazil,Japan,0,4,6,10,04/06/2021,0,0,2,2,9,2,10,21,0,2,1,3,3,1,11,15,3,2,1,6
2056,153365,2021,Japan,Serbia,0,1,14,15,03/06/2021,0,0,4,4,12,6,8,26,0,1,0,1,14,0,7,21,5,4,0,9
2057,153365,2021,Russia,Japan,0,2,17,19,30/05/2021,0,0,0,0,17,4,13,34,0,1,1,2,10,4,19,33,8,12,0,20
2058,153365,2021,Netherlands,Japan,0,1,0,1,29/05/2021,0,0,0,0,0,0,1,1,0,0,1,1,0,0,0,0,0,0,0,0
2059,153365,2021,Japan,Iran,0,0,0,0,28/05/2021,0,0,0,0,0,0,0,0,0,0,0,0,0,0,0,0,0,0,0,0
2060,163516,2021,USA,Japan,0,0,0,0,23/06/2021,0,0,0,0,0,0,0,0,0,0,0,0,0,0,0,0,0,0,0,0
2061,163516,2021,Japan,Slovenia,0,2,7,9,22/06/2021,0,0,0,0,5,1,8,14,0,1,0,1,2,1,13,16,4,2,0,6
2062,163516,2021,Japan,Bulgaria,0,0,0,0,21/06/2021,0,0,0,0,0,0,0,0,0,0,0,0,0,0,0,0,0,0,0,0
2063,163516,2021,Japan,Canada,0,0,1,1,17/06/2021,0,0,0,0,2,0,0,2,0,0,0,0,0,0,0,0,1,0,0,1
2064,163516,2021,Japan,Poland,0,2,6,8,16/06/2021,0,0,0,0,7,4,12,23,0,2,1,3,1,0,7,8,1,1,0,2
2065,163516,2021,Japan,Germany,0,0,0,0,15/06/2021,0,0,0,0,0,0,0,0,0,0,0,0,0,0,0,0,0,0,0,0
2066,163516,2021,Japan,Argentina,0,2,12,14,11/06/2021,0,0,5,5,10,6,24,40,4,0,0,4,8,2,12,22,7,2,2,11
2067,163516,2021,Japan,Italy,1,3,9,13,10/06/2021,0,0,4,4,15,3,16,34,1,1,8,10,0,0,3,3,6,3,0,9
2068,163516,2021,Japan,Australia,0,0,0,0,09/06/2021,0,0,0,0,0,0,0,0,0,0,1,1,0,0,0,0,0,0,0,0
2069,163516,2021,France,Japan,0,0,2,2,05/06/2021,0,0,0,0,0,1,2,3,0,0,0,0,0,0,0,0,1,0,0,1
2070,163516,2021,Brazil,Japan,1,1,3,5,04/06/2021,0,0,0,0,2,0,5,7,0,0,0,0,0,0,2,2,0,1,0,1
2071,163516,2021,Japan,Serbia,0,0,4,4,03/06/2021,0,0,0,0,4,2,7,13,1,1,0,2,5,0,11,16,1,2,0,3
2072,163516,2021,Russia,Japan,0,2,11,13,30/05/2021,0,0,0,0,6,5,14,25,0,4,1,5,2,1,3,6,3,4,0,7
2073,163516,2021,Netherlands,Japan,0,2,6,8,29/05/2021,0,0,0,0,7,1,4,12,0,2,0,2,0,0,0,0,1,0,0,1
2074,163516,2021,Japan,Iran,0,0,5,5,28/05/2021,0,0,1,1,8,0,5,13,0,1,0,1,0,0,0,0,0,0,0,0
2075,172893,2021,USA,Japan,0,0,0,0,23/06/2021,0,0,3,3,0,0,0,0,0,0,0,0,8,1,11,20,11,5,0,16
2076,172893,2021,Japan,Slovenia,0,0,0,0,22/06/2021,0,0,2,2,0,0,0,0,0,0,0,0,0,1,2,3,0,2,0,2
2077,172893,2021,Japan,Bulgaria,0,0,0,0,21/06/2021,0,0,2,2,0,0,0,0,0,0,0,0,6,0,8,14,10,2,2,14
2078,172893,2021,Japan,Canada,0,0,0,0,17/06/2021,0,0,4,4,0,0,0,0,0,0,0,0,2,2,6,10,6,3,1,10
2079,172893,2021,Japan,Poland,0,0,0,0,16/06/2021,0,0,0,0,0,0,0,0,0,0,0,0,0,0,0,0,0,0,0,0
2080,172893,2021,Japan,Germany,0,0,0,0,15/06/2021,0,0,5,5,0,0,0,0,0,0,0,0,7,0,2,9,8,1,0,9
2081,172893,2021,Japan,Argentina,0,0,0,0,11/06/2021,0,0,0,0,0,0,0,0,0,0,0,0,1,0,0,1,0,0,0,0
2082,172893,2021,Japan,Italy,0,0,0,0,10/06/2021,0,0,8,8,0,0,0,0,0,0,0,0,5,1,11,17,15,6,1,22
2083,172893,2021,Japan,Australia,0,0,0,0,09/06/2021,0,0,2,2,0,0,0,0,0,0,0,0,16,0,12,28,15,5,3,23
2084,172893,2021,France,Japan,0,0,0,0,05/06/2021,0,0,2,2,0,0,0,0,0,0,0,0,12,2,8,22,8,3,0,11
2085,172893,2021,Brazil,Japan,0,0,0,0,04/06/2021,0,0,1,1,0,0,0,0,0,0,0,0,3,1,2,6,1,1,0,2
2086,172893,2021,Japan,Serbia,0,0,0,0,03/06/2021,0,0,3,3,0,0,0,0,0,0,0,0,7,1,8,16,11,5,0,16
2087,172893,2021,Russia,Japan,0,0,0,0,30/05/2021,0,0,0,0,0,0,0,0,0,0,0,0,0,0,0,0,0,0,0,0
2088,172893,2021,Netherlands,Japan,0,0,0,0,29/05/2021,0,0,0,0,0,0,0,0,0,0,0,0,13,3,10,26,7,3,2,12
2089,172893,2021,Japan,Iran,0,0,0,0,28/05/2021,0,0,2,2,0,0,0,0,0,0,0,0,9,0,9,18,8,0,0,8
2090,178762,2021,USA,Japan,1,4,9,14,23/06/2021,0,0,3,3,7,2,8,17,0,2,1,3,9,1,10,20,2,3,1,6
2091,178762,2021,Japan,Slovenia,0,0,0,0,22/06/2021,0,0,0,0,0,0,0,0,0,0,0,0,0,0,0,0,0,0,0,0
2092,178762,2021,Japan,Bulgaria,1,2,16,19,21/06/2021,0,0,1,1,7,4,7,18,0,0,1,1,1,2,10,13,4,2,0,6
2093,178762,2021,Japan,Canada,0,1,6,7,17/06/2021,0,0,1,1,6,4,2,12,0,3,0,3,1,2,15,18,6,0,0,6
2094,178762,2021,Japan,Poland,0,0,0,0,16/06/2021,0,0,0,0,0,0,0,0,0,0,0,0,0,0,0,0,0,0,0,0
2095,178762,2021,Japan,Germany,0,2,9,11,15/06/2021,0,0,1,1,10,2,8,20,0,1,1,2,8,1,6,15,8,5,0,13
2096,178762,2021,Japan,Argentina,0,0,0,0,11/06/2021,0,0,0,0,0,0,0,0,0,0,0,0,0,0,0,0,0,0,0,0
2097,178762,2021,Japan,Italy,3,2,14,19,10/06/2021,0,0,4,4,16,4,12,32,0,3,1,4,8,1,11,20,11,2,3,16
2098,178762,2021,Japan,Australia,1,2,6,9,09/06/2021,1,0,5,6,11,6,6,23,1,3,0,4,6,1,7,14,4,0,1,5
2099,178762,2021,France,Japan,0,2,7,9,05/06/2021,0,0,4,4,4,3,3,10,1,3,1,5,9,0,8,17,4,4,0,8
2100,178762,2021,Brazil,Japan,0,0,0,0,04/06/2021,0,0,0,0,0,0,0,0,0,0,0,0,0,0,0,0,0,0,0,0
2101,178762,2021,Japan,Serbia,0,3,6,9,03/06/2021,0,0,5,5,6,3,6,15,0,0,0,0,9,0,11,20,3,4,0,7
2102,178762,2021,Russia,Japan,0,3,4,7,30/05/2021,0,0,0,0,1,0,1,2,0,0,0,0,0,0,5,5,2,0,0,2
2103,178762,2021,Netherlands,Japan,0,6,17,23,29/05/2021,0,0,0,0,25,3,10,38,1,1,0,2,13,0,11,24,3,2,0,5
2104,178762,2021,Japan,Iran,1,2,11,14,28/05/2021,0,0,0,0,13,4,9,26,2,0,1,3,8,0,11,19,1,0,0,1
2105,180990,2021,USA,Japan,0,0,0,0,23/06/2021,0,0,0,0,0,0,0,0,0,0,0,0,0,0,0,0,0,0,0,0
2106,180990,2021,Japan,Slovenia,0,0,0,0,22/06/2021,0,0,3,3,0,0,0,0,0,0,0,0,6,1,4,11,4,1,0,5
2107,180990,2021,Japan,Bulgaria,0,0,0,0,21/06/2021,0,0,0,0,0,0,0,0,0,0,0,0,0,0,0,0,0,0,0,0
2108,180990,2021,Japan,Canada,0,0,0,0,17/06/2021,0,0,0,0,0,0,0,0,0,0,0,0,0,0,0,0,0,0,0,0
2109,180990,2021,Japan,Poland,0,0,0,0,16/06/2021,0,0,5,5,0,0,0,0,0,0,0,0,9,2,10,21,11,3,3,17
2110,180990,2021,Japan,Germany,0,0,0,0,15/06/2021,0,0,0,0,0,0,0,0,0,0,0,0,0,0,0,0,0,0,0,0
2111,180990,2021,Japan,Argentina,0,0,0,0,11/06/2021,0,0,8,8,0,0,0,0,0,0,0,0,9,2,26,37,12,7,1,20
2112,180990,2021,Japan,Italy,0,0,0,0,10/06/2021,0,0,0,0,0,0,0,0,0,0,0,0,0,0,0,0,0,0,0,0
2113,180990,2021,Japan,Australia,0,0,0,0,09/06/2021,0,0,0,0,0,0,0,0,0,0,0,0,0,0,0,0,0,0,0,0
2114,180990,2021,France,Japan,0,0,0,0,05/06/2021,0,0,0,0,0,0,0,0,0,0,0,0,0,0,0,0,0,0,0,0
2115,180990,2021,Brazil,Japan,0,0,0,0,04/06/2021,0,0,1,1,0,0,0,0,0,0,0,0,1,5,4,10,3,2,1,6
2116,180990,2021,Japan,Serbia,0,0,0,0,03/06/2021,0,0,0,0,0,0,0,0,0,0,0,0,0,0,0,0,0,0,0,0
2117,180990,2021,Russia,Japan,0,0,0,0,30/05/2021,0,0,4,4,0,0,0,0,0,0,0,0,9,0,22,31,16,7,1,24
2118,180990,2021,Netherlands,Japan,0,0,0,0,29/05/2021,0,0,0,0,0,0,0,0,0,0,0,0,0,0,0,0,0,0,0,0
2119,180990,2021,Japan,Iran,0,0,0,0,28/05/2021,0,0,0,0,0,0,0,0,0,0,0,0,0,0,0,0,0,0,0,0
2120,141546,2021,Australia,Netherlands,0,0,2,2,23/06/2021,0,0,2,2,0,0,0,0,0,0,0,0,0,0,0,0,0,2,0,2
2121,141546,2021,Serbia,Netherlands,0,1,13,14,22/06/2021,18,0,60,78,1,0,2,3,4,3,0,7,0,0,0,0,4,2,0,6
2122,141546,2021,Canada,Netherlands,0,0,2,2,21/06/2021,15,0,25,40,0,0,1,1,0,1,0,1,0,0,0,0,3,0,0,3
2123,141546,2021,Netherlands,USA,2,0,17,19,17/06/2021,21,0,73,94,1,0,0,1,0,2,3,5,0,0,0,0,11,1,1,13
2124,141546,2021,Netherlands,Italy,0,1,6,7,16/06/2021,14,0,38,52,0,0,0,0,0,1,1,2,0,0,0,0,5,2,2,9
2125,141546,2021,Netherlands,Bulgaria,0,0,0,0,11/06/2021,2,0,4,6,0,0,0,0,0,0,0,0,0,0,0,0,0,0,0,0
2126,141546,2021,Poland,Netherlands,0,1,1,2,10/06/2021,1,0,14,15,0,0,2,2,0,0,0,0,0,0,0,0,1,2,0,3
2127,141546,2021,Netherlands,Argentina,0,0,9,9,05/06/2021,13,0,59,72,1,0,0,1,0,1,1,2,0,0,0,0,1,3,0,4
2128,141546,2021,Netherlands,Germany,0,0,20,20,04/06/2021,28,0,82,110,0,0,1,1,0,4,1,5,0,0,0,0,8,1,1,10
2129,141546,2021,Netherlands,Slovenia,0,0,6,6,03/06/2021,7,0,45,52,0,0,1,1,1,3,0,4,0,1,1,2,4,1,0,5
2130,137345,2021,Australia,Netherlands,0,0,0,0,23/06/2021,0,0,0,0,0,0,0,0,0,0,0,0,0,0,0,0,0,0,0,0
2131,137345,2021,Serbia,Netherlands,2,4,13,19,22/06/2021,0,0,5,5,15,3,7,25,0,4,1,5,5,1,16,22,4,4,0,8
2132,137345,2021,Canada,Netherlands,0,2,5,7,21/06/2021,0,0,1,1,8,5,10,23,0,3,1,4,2,2,3,7,5,3,1,9
2133,137345,2021,Netherlands,USA,0,4,7,11,17/06/2021,0,0,1,1,17,7,16,40,1,4,1,6,11,4,23,38,8,5,0,13
2134,137345,2021,Netherlands,Italy,0,3,3,6,16/06/2021,0,0,4,4,11,2,11,24,1,2,3,6,1,2,10,13,0,1,0,1
2135,137345,2021,Netherlands,France,0,0,0,0,15/06/2021,0,0,0,0,0,1,1,2,0,0,0,0,0,0,3,3,0,0,0,0
2136,137345,2021,Netherlands,Brazil,0,0,0,0,09/06/2021,0,0,0,0,0,0,0,0,0,0,0,0,0,0,0,0,0,0,0,0
2137,137345,2021,Netherlands,Argentina,0,1,3,4,05/06/2021,0,0,0,0,4,1,4,9,0,1,0,1,4,0,5,9,0,0,0,0
2138,137345,2021,Netherlands,Germany,1,5,8,14,04/06/2021,0,0,2,2,24,4,8,36,1,3,0,4,5,2,12,19,5,1,0,6
2139,137345,2021,Netherlands,Japan,0,3,7,10,29/05/2021,0,0,0,0,17,3,6,26,1,1,1,3,8,1,14,23,2,3,0,5
2140,137345,2021,Netherlands,Russia,0,1,1,2,28/05/2021,0,0,0,0,3,0,1,4,1,0,1,2,0,0,3,3,1,0,1,2
2141,169921,2021,Australia,Netherlands,0,0,0,0,23/06/2021,0,0,0,0,0,0,0,0,0,0,0,0,0,0,0,0,0,0,0,0
2142,169921,2021,Serbia,Netherlands,1,1,10,12,22/06/2021,0,0,1,1,7,0,3,10,2,4,4,10,0,0,0,0,2,2,2,6
2143,169921,2021,Netherlands,USA,0,2,8,10,17/06/2021,0,0,1,1,2,0,4,6,0,4,5,9,0,1,0,1,2,0,0,2
2144,169921,2021,Netherlands,Italy,0,0,0,0,16/06/2021,0,0,0,0,0,0,0,0,0,0,0,0,0,0,0,0,0,0,0,0
2145,169921,2021,Netherlands,Bulgaria,0,1,6,7,11/06/2021,0,0,0,0,3,0,0,3,0,3,4,7,0,0,1,1,1,2,0,3
2146,169921,2021,Poland,Netherlands,0,0,0,0,10/06/2021,0,0,0,0,0,0,0,0,0,0,0,0,0,0,0,0,0,0,0,0
2147,169921,2021,Netherlands,Brazil,0,1,5,6,09/06/2021,0,0,0,0,4,0,2,6,2,3,3,8,0,0,0,0,1,0,1,2
2148,169921,2021,Netherlands,Germany,0,0,0,0,04/06/2021,0,0,0,0,0,0,0,0,0,0,0,0,0,0,0,0,0,0,0,0
2149,169921,2021,Netherlands,Slovenia,0,2,1,3,03/06/2021,0,0,0,0,1,0,2,3,0,3,0,3,0,0,0,0,0,0,0,0
2150,169921,2021,Netherlands,Japan,0,0,0,0,29/05/2021,0,0,0,0,0,0,0,0,0,0,0,0,0,0,0,0,0,0,0,0
2151,169921,2021,Netherlands,Russia,0,2,11,13,28/05/2021,0,0,0,0,1,0,3,4,2,9,6,17,0,0,0,0,3,1,0,4
2152,156591,2021,Australia,Netherlands,0,0,0,0,23/06/2021,0,0,5,5,0,0,0,0,0,0,0,0,8,0,5,13,6,1,0,7
2153,156591,2021,Serbia,Netherlands,0,0,0,0,22/06/2021,0,0,3,3,0,0,0,0,0,0,0,0,11,6,15,32,13,5,0,18
2154,156591,2021,Canada,Netherlands,0,0,0,0,21/06/2021,0,0,2,2,0,0,0,0,0,0,0,0,0,0,8,8,2,1,0,3
2155,156591,2021,Netherlands,USA,0,0,0,0,17/06/2021,0,0,0,0,0,0,0,0,0,0,0,0,0,0,0,0,0,0,0,0
2156,156591,2021,Netherlands,Italy,0,0,0,0,16/06/2021,0,0,10,10,0,0,0,0,0,0,0,0,9,2,12,23,13,7,3,23
2157,156591,2021,Netherlands,France,0,0,0,0,15/06/2021,0,0,0,0,0,0,0,0,0,0,0,0,0,0,0,0,0,0,0,0
2158,156591,2021,Netherlands,Bulgaria,0,0,0,0,11/06/2021,0,0,4,4,0,0,0,0,0,0,0,0,11,4,16,31,12,3,1,16
2159,156591,2021,Poland,Netherlands,0,0,0,0,10/06/2021,0,0,0,0,0,0,0,0,0,0,0,0,0,0,0,0,0,0,0,0
2160,156591,2021,Netherlands,Brazil,0,0,0,0,09/06/2021,0,0,6,6,0,0,0,0,0,0,0,0,4,1,12,17,9,2,0,11
2161,156591,2021,Netherlands,Argentina,0,0,0,0,05/06/2021,0,0,4,4,0,0,0,0,0,0,0,0,5,0,9,14,5,2,1,8
2162,156591,2021,Netherlands,Germany,0,0,0,0,04/06/2021,0,0,5,5,0,0,0,0,0,0,0,0,21,2,15,38,10,6,0,16
2163,156591,2021,Netherlands,Slovenia,0,0,0,0,03/06/2021,0,0,10,10,0,0,0,0,0,0,0,0,7,4,11,22,5,1,0,6
2164,156591,2021,Netherlands,Iran,0,0,0,0,30/05/2021,0,0,0,0,0,0,0,0,0,0,0,0,0,0,0,0,0,0,0,0
2165,156591,2021,Netherlands,Japan,0,0,0,0,29/05/2021,0,0,3,3,0,0,0,0,0,0,0,0,10,0,19,29,6,4,0,10
2166,156591,2021,Netherlands,Russia,0,0,0,0,28/05/2021,0,0,3,3,0,0,0,0,0,0,0,0,8,5,21,34,9,4,0,13
2167,131980,2021,Netherlands,Argentina,0,1,5,6,05/06/2021,0,0,0,0,0,2,4,6,0,0,1,1,5,1,6,12,1,5,0,6
2168,131980,2021,Netherlands,Germany,0,1,5,6,04/06/2021,0,0,0,0,0,0,0,0,0,0,0,0,1,0,0,1,1,0,0,1
2169,131980,2021,Netherlands,Slovenia,0,0,1,1,03/06/2021,0,0,0,0,0,1,1,2,0,0,0,0,0,0,2,2,0,0,0,0
2170,131980,2021,Netherlands,Iran,0,2,7,9,30/05/2021,0,0,0,0,2,2,7,11,0,2,2,4,4,3,15,22,5,4,0,9
2171,131980,2021,Netherlands,Japan,0,1,6,7,29/05/2021,0,0,0,0,1,0,1,2,0,0,0,0,3,0,5,8,2,1,0,3
2172,131980,2021,Netherlands,Russia,0,0,1,1,28/05/2021,0,0,0,0,0,0,0,0,0,0,0,0,0,0,0,0,0,2,0,2
2173,156678,2021,Australia,Netherlands,0,0,1,1,23/06/2021,0,0,0,0,2,1,1,4,0,1,0,1,0,0,0,0,0,0,0,0
2174,156678,2021,Serbia,Netherlands,1,0,4,5,22/06/2021,0,0,1,1,1,0,1,2,0,1,1,2,0,0,0,0,2,1,0,3
2175,156678,2021,Canada,Netherlands,0,0,9,9,21/06/2021,0,0,0,0,1,1,1,3,0,4,2,6,0,0,1,1,3,1,0,4
2176,156678,2021,Netherlands,USA,0,0,1,1,17/06/2021,0,0,0,0,0,0,0,0,0,0,0,0,0,0,0,0,0,0,0,0
2177,156678,2021,Netherlands,Italy,0,0,16,16,16/06/2021,0,0,2,2,11,2,3,16,3,5,4,12,0,0,1,1,3,2,0,5
2178,156678,2021,Netherlands,France,0,0,0,0,15/06/2021,0,0,0,0,0,0,0,0,0,1,0,1,0,0,0,0,0,0,0,0
2179,156678,2021,Netherlands,Bulgaria,0,2,11,13,11/06/2021,0,0,0,0,12,0,1,13,1,6,1,8,0,0,1,1,3,0,0,3
2180,156678,2021,Poland,Netherlands,0,2,4,6,10/06/2021,0,0,0,0,1,2,2,5,1,2,0,3,0,0,0,0,1,0,0,1
2181,156678,2021,Netherlands,Brazil,0,0,1,1,09/06/2021,0,0,0,0,0,0,0,0,0,0,0,0,0,0,1,1,0,0,0,0
2182,156678,2021,Netherlands,Argentina,0,3,6,9,05/06/2021,0,0,0,0,5,2,5,12,2,3,0,5,0,0,0,0,2,0,0,2
2183,156678,2021,Netherlands,Slovenia,0,3,4,7,03/06/2021,0,0,1,1,2,0,6,8,0,2,4,6,0,0,1,1,2,0,0,2
2184,156678,2021,Netherlands,Iran,0,0,0,0,30/05/2021,0,0,0,0,0,0,0,0,0,0,0,0,0,0,0,0,0,0,0,0
2185,156678,2021,Netherlands,Japan,1,2,16,19,29/05/2021,0,0,0,0,11,2,3,16,2,3,1,6,1,0,1,2,2,2,0,4
2186,176493,2021,Serbia,Netherlands,0,0,0,0,22/06/2021,0,0,0,0,1,0,0,1,0,0,0,0,0,0,0,0,0,0,0,0
2187,176493,2021,Canada,Netherlands,0,1,2,3,21/06/2021,0,0,0,0,0,0,0,0,0,0,0,0,1,0,1,2,1,0,0,1
2188,176493,2021,Netherlands,USA,0,0,0,0,17/06/2021,0,0,0,0,0,0,0,0,0,0,0,0,0,0,0,0,0,0,0,0
2189,176493,2021,Netherlands,France,0,2,17,19,15/06/2021,0,0,0,0,3,1,3,7,0,2,6,8,0,0,3,3,0,1,2,3
2190,176493,2021,Netherlands,Bulgaria,0,0,0,0,11/06/2021,0,0,0,0,0,0,0,0,0,0,0,0,0,0,0,0,0,0,0,0
2191,176493,2021,Poland,Netherlands,1,1,1,3,10/06/2021,0,0,1,1,0,0,1,1,1,1,1,3,0,0,0,0,1,0,0,1
2192,176493,2021,Netherlands,Brazil,0,0,0,0,09/06/2021,0,0,0,0,0,0,0,0,0,0,0,0,0,0,0,0,0,0,0,0
2193,176493,2021,Netherlands,Argentina,0,0,6,6,05/06/2021,0,0,0,0,3,0,4,7,3,0,3,6,0,0,0,0,0,0,0,0
2194,176493,2021,Netherlands,Germany,0,0,0,0,04/06/2021,0,0,0,0,0,0,0,0,0,0,0,0,0,0,0,0,0,0,0,0
2195,176493,2021,Netherlands,Slovenia,0,0,0,0,03/06/2021,0,0,0,0,0,0,0,0,0,0,0,0,0,0,0,0,0,0,0,0
2196,176493,2021,Netherlands,Iran,0,3,8,11,30/05/2021,0,0,0,0,5,1,4,10,0,2,3,5,0,0,0,0,1,0,0,1
2197,176493,2021,Netherlands,Russia,0,1,0,1,28/05/2021,0,0,0,0,0,0,0,0,0,0,0,0,0,0,0,0,0,0,0,0
2198,170436,2021,Australia,Netherlands,3,3,15,21,23/06/2021,0,0,2,2,12,2,4,18,0,2,0,2,10,1,8,19,3,2,0,5
2199,170436,2021,Serbia,Netherlands,0,2,8,10,22/06/2021,0,1,1,2,8,3,8,19,1,1,0,2,9,2,11,22,2,2,1,5
2200,170436,2021,Canada,Netherlands,0,2,8,10,21/06/2021,0,0,3,3,7,6,14,27,0,2,0,2,8,1,12,21,2,1,1,4
2201,170436,2021,Netherlands,Italy,2,3,14,19,16/06/2021,0,0,2,2,8,4,10,22,1,1,2,4,11,3,18,32,5,4,1,10
2202,170436,2021,Netherlands,France,0,1,16,17,15/06/2021,0,1,5,6,13,5,17,35,1,2,6,9,3,3,30,36,7,0,2,9
2203,170436,2021,Netherlands,Bulgaria,1,6,10,17,11/06/2021,0,0,5,5,12,4,9,25,0,2,1,3,4,1,25,30,4,3,1,8
2204,170436,2021,Poland,Netherlands,0,3,3,6,10/06/2021,0,0,3,3,3,2,11,16,0,1,2,3,4,2,17,23,4,2,1,7
2205,170436,2021,Netherlands,Brazil,0,3,9,12,09/06/2021,0,0,1,1,12,4,12,28,1,3,0,4,4,2,17,23,4,2,1,7
2206,170436,2021,Netherlands,Argentina,2,2,4,8,05/06/2021,0,0,1,1,5,2,12,19,1,0,0,1,10,1,10,21,4,2,0,6
2207,170436,2021,Netherlands,Germany,1,3,15,19,04/06/2021,0,0,3,3,12,6,10,28,0,3,1,4,7,1,10,18,7,0,0,7
2208,170436,2021,Netherlands,Slovenia,0,3,4,7,03/06/2021,0,0,0,0,4,1,4,9,0,1,0,1,2,0,11,13,0,1,0,1
2209,170436,2021,Netherlands,Iran,2,3,14,19,30/05/2021,0,0,0,0,8,5,9,22,0,5,1,6,3,0,12,15,3,2,0,5
2210,170436,2021,Netherlands,Japan,0,1,0,1,29/05/2021,0,0,0,0,2,1,2,5,0,0,0,0,0,0,0,0,0,0,0,0
2211,170436,2021,Netherlands,Russia,0,2,12,14,28/05/2021,0,0,1,1,12,1,10,23,1,4,0,5,4,2,14,20,2,1,1,4
2212,176460,2021,Australia,Netherlands,0,0,0,0,23/06/2021,0,0,0,0,0,0,0,0,0,0,0,0,0,0,0,0,0,0,0,0
2213,176460,2021,Serbia,Netherlands,0,0,0,0,22/06/2021,0,0,0,0,0,0,0,0,0,0,0,0,0,0,0,0,0,0,0,0
2214,176460,2021,Canada,Netherlands,0,0,0,0,21/06/2021,0,0,1,1,0,0,0,0,0,0,0,0,1,2,4,7,2,5,0,7
2215,176460,2021,Netherlands,USA,0,0,0,0,17/06/2021,0,0,6,6,0,0,0,0,0,0,0,0,5,4,21,30,5,5,0,10
2216,176460,2021,Netherlands,Italy,0,0,0,0,16/06/2021,0,0,0,0,0,0,0,0,0,0,0,0,0,0,0,0,0,0,0,0
2217,176460,2021,Netherlands,France,0,0,0,0,15/06/2021,0,0,4,4,0,0,0,0,0,0,0,0,3,1,14,18,11,2,2,15
2218,176460,2021,Netherlands,Bulgaria,0,0,0,0,11/06/2021,0,0,0,0,0,0,0,0,0,0,0,0,0,0,0,0,0,0,0,0
2219,176460,2021,Poland,Netherlands,0,0,0,0,10/06/2021,0,0,5,5,0,0,0,0,0,0,0,0,3,3,10,16,9,4,1,14
2220,176460,2021,Netherlands,Brazil,0,0,0,0,09/06/2021,0,0,0,0,0,0,0,0,0,0,0,0,0,0,0,0,0,0,0,0
2221,176460,2021,Netherlands,Argentina,0,0,0,0,05/06/2021,0,0,0,0,0,0,0,0,0,0,0,0,0,0,0,0,0,0,0,0
2222,176460,2021,Netherlands,Germany,0,0,0,0,04/06/2021,0,0,0,0,0,0,0,0,0,0,0,0,0,0,0,0,0,0,0,0
2223,176460,2021,Netherlands,Slovenia,0,0,0,0,03/06/2021,0,0,0,0,0,0,0,0,0,0,0,0,0,0,0,0,0,0,0,0
2224,176460,2021,Netherlands,Iran,0,0,0,0,30/05/2021,0,0,1,1,0,0,0,0,0,0,0,0,5,3,10,18,14,2,0,16
2225,176460,2021,Netherlands,Japan,0,0,0,0,29/05/2021,0,0,0,0,0,0,0,0,0,0,0,0,0,0,0,0,0,0,0,0
2226,176460,2021,Netherlands,Russia,0,0,0,0,28/05/2021,0,0,0,0,0,0,0,0,0,0,0,0,0,0,0,0,1,0,0,1
2227,137498,2021,Australia,Netherlands,4,4,4,12,23/06/2021,0,0,1,1,12,5,11,28,1,1,0,2,0,0,0,0,0,1,0,1
2228,137498,2021,Netherlands,Italy,2,5,10,17,16/06/2021,0,0,0,0,20,10,11,41,2,4,5,11,2,0,0,2,9,2,0,11
2229,137498,2021,Netherlands,France,4,6,12,22,15/06/2021,0,0,1,1,37,8,12,57,2,10,4,16,0,0,0,0,8,5,1,14
2230,137498,2021,Netherlands,Bulgaria,4,7,11,22,11/06/2021,0,0,3,3,25,7,6,38,0,1,3,4,0,1,0,1,4,2,1,7
2231,137498,2021,Poland,Netherlands,0,1,2,3,10/06/2021,0,0,0,0,5,1,5,11,0,0,0,0,0,0,0,0,1,0,0,1
2232,137498,2021,Netherlands,Brazil,3,5,7,15,09/06/2021,0,0,2,2,15,8,8,31,2,2,0,4,1,0,0,1,3,3,0,6
2233,137498,2021,Netherlands,Argentina,4,3,8,15,05/06/2021,0,0,1,1,17,6,7,30,1,3,1,5,0,0,0,0,3,4,0,7
2234,137498,2021,Netherlands,Germany,5,8,10,23,04/06/2021,0,1,3,4,18,4,20,42,1,3,4,8,0,0,0,0,14,3,0,17
2235,137498,2021,Netherlands,Slovenia,1,3,7,11,03/06/2021,0,0,1,1,14,7,9,30,0,2,1,3,0,0,0,0,5,1,0,6
2236,137498,2021,Netherlands,Iran,1,1,4,6,30/05/2021,0,0,0,0,9,4,4,17,1,3,0,4,0,0,0,0,3,0,0,3
2237,137498,2021,Netherlands,Japan,2,7,7,16,29/05/2021,0,0,0,0,23,9,14,46,0,3,2,5,0,0,0,0,1,0,0,1
2238,137498,2021,Netherlands,Russia,6,5,12,23,28/05/2021,0,0,1,1,23,8,6,37,0,1,1,2,0,1,1,2,6,0,1,7
2239,164837,2021,Serbia,Netherlands,0,0,0,0,22/06/2021,0,0,0,0,0,0,0,0,0,0,0,0,0,0,0,0,0,0,0,0
2240,164837,2021,Canada,Netherlands,0,0,0,0,21/06/2021,0,0,0,0,0,0,0,0,0,0,0,0,0,0,0,0,0,0,0,0
2241,164837,2021,Netherlands,USA,0,0,1,1,17/06/2021,0,0,4,4,0,0,0,0,0,0,0,0,0,1,0,1,0,0,0,0
2242,164837,2021,Netherlands,France,0,0,0,0,15/06/2021,2,0,4,6,0,0,0,0,0,0,0,0,0,0,0,0,0,0,0,0
2243,164837,2021,Poland,Netherlands,0,0,5,5,10/06/2021,8,1,36,45,1,0,0,1,0,2,0,2,0,0,1,1,3,1,1,5
2244,164837,2021,Netherlands,Brazil,0,0,0,0,09/06/2021,1,0,1,2,0,0,0,0,0,0,0,0,0,0,0,0,0,0,0,0
2245,164837,2021,Netherlands,Argentina,0,0,0,0,05/06/2021,2,0,12,14,0,0,0,0,0,1,0,1,0,0,1,1,0,0,0,0
2246,164837,2021,Netherlands,Germany,0,0,0,0,04/06/2021,0,0,0,0,0,0,0,0,0,0,0,0,0,0,0,0,0,0,0,0
2247,164837,2021,Netherlands,Slovenia,0,0,1,1,03/06/2021,0,1,7,8,0,0,0,0,0,0,0,0,0,0,0,0,1,0,0,1
2248,164837,2021,Netherlands,Iran,0,1,4,5,30/05/2021,15,0,62,77,0,1,0,1,1,0,1,2,0,0,0,0,2,2,0,4
2249,164837,2021,Netherlands,Japan,0,0,0,0,29/05/2021,2,0,2,4,0,0,0,0,0,1,0,1,0,0,0,0,0,0,0,0
2250,164837,2021,Netherlands,Russia,0,0,0,0,28/05/2021,1,0,3,4,0,0,0,0,0,0,0,0,0,0,0,0,0,0,0,0
2251,137337,2021,Australia,Netherlands,1,2,8,11,23/06/2021,0,0,0,0,5,1,1,7,4,3,1,8,0,0,0,0,2,0,2,4
2252,137337,2021,Canada,Netherlands,0,0,4,4,21/06/2021,0,0,0,0,5,2,1,8,1,1,1,3,0,0,1,1,1,0,0,1
2253,137337,2021,Netherlands,USA,0,1,8,9,17/06/2021,0,0,0,0,6,0,3,9,1,3,1,5,0,1,0,1,3,0,0,3
2254,137337,2021,Netherlands,Italy,0,0,0,0,16/06/2021,0,0,0,0,0,0,0,0,0,0,0,0,0,0,0,0,0,0,0,0
2255,137337,2021,Netherlands,France,0,0,9,9,15/06/2021,0,0,1,1,5,0,4,9,0,6,4,10,0,0,0,0,1,2,2,5
2256,137337,2021,Netherlands,Bulgaria,0,1,3,4,11/06/2021,0,0,0,0,1,0,1,2,0,1,1,2,0,0,0,0,1,0,0,1
2257,137337,2021,Poland,Netherlands,0,0,0,0,10/06/2021,0,0,0,0,0,0,0,0,0,0,0,0,0,0,0,0,0,0,0,0
2258,137337,2021,Netherlands,Brazil,0,0,11,11,09/06/2021,0,0,0,0,4,0,2,6,2,5,2,9,0,0,1,1,2,0,0,2
2259,137337,2021,Netherlands,Argentina,0,0,1,1,05/06/2021,0,0,0,0,0,0,0,0,0,0,0,0,0,0,0,0,0,0,0,0
2260,137337,2021,Netherlands,Germany,1,2,9,12,04/06/2021,0,0,0,0,11,1,1,13,4,9,8,21,1,0,5,6,1,0,0,1
2261,137337,2021,Netherlands,Iran,0,1,6,7,30/05/2021,0,0,0,0,4,1,1,6,1,4,0,5,1,1,0,2,1,2,0,3
2262,137337,2021,Netherlands,Japan,0,1,1,2,29/05/2021,0,0,0,0,2,0,1,3,1,0,0,1,1,0,1,2,0,0,0,0
2263,137337,2021,Netherlands,Russia,0,1,8,9,28/05/2021,0,0,0,0,6,0,1,7,2,5,4,11,0,0,0,0,1,0,0,1
2264,121992,2021,Australia,Netherlands,0,2,6,8,23/06/2021,0,0,2,2,8,2,2,12,1,0,0,1,10,0,7,17,2,1,0,3
2265,121992,2021,Serbia,Netherlands,1,4,3,8,22/06/2021,0,0,2,2,3,2,2,7,1,2,0,3,2,1,7,10,0,0,0,0
2266,121992,2021,Canada,Netherlands,0,2,2,4,21/06/2021,0,0,1,1,4,0,5,9,1,0,0,1,7,0,10,17,4,1,1,6
2267,121992,2021,Netherlands,USA,1,6,8,15,17/06/2021,0,0,9,9,10,2,13,25,1,1,1,3,1,0,9,10,11,0,0,11
2268,121992,2021,Netherlands,Italy,0,2,3,5,16/06/2021,0,0,2,2,2,1,5,8,0,1,3,4,3,1,8,12,4,0,0,4
2269,121992,2021,Netherlands,France,1,5,10,16,15/06/2021,0,0,4,4,6,3,7,16,2,3,3,8,13,1,16,30,13,4,1,18
2270,121992,2021,Netherlands,Bulgaria,4,5,10,19,11/06/2021,0,0,1,1,11,4,9,24,2,2,2,6,4,1,13,18,6,1,1,8
2271,121992,2021,Poland,Netherlands,0,4,1,5,10/06/2021,0,0,3,3,5,1,3,9,0,1,0,1,4,1,4,9,3,1,0,4
2272,121992,2021,Netherlands,Brazil,0,3,5,8,09/06/2021,0,0,3,3,4,2,6,12,0,4,3,7,16,0,12,28,4,1,1,6
2273,121992,2021,Netherlands,Argentina,0,1,4,5,05/06/2021,0,0,1,1,0,3,7,10,0,0,0,0,5,0,3,8,1,0,0,1
2274,121992,2021,Netherlands,Germany,0,0,0,0,04/06/2021,0,0,0,0,0,0,0,0,0,0,0,0,0,0,0,0,2,0,0,2
2275,121992,2021,Netherlands,Slovenia,2,2,5,9,03/06/2021,0,0,4,4,4,3,3,10,1,1,3,5,9,0,7,16,2,0,0,2
2276,121992,2021,Netherlands,Iran,0,0,0,0,30/05/2021,0,0,0,0,0,0,0,0,0,0,0,0,0,0,0,0,0,0,0,0
2277,121992,2021,Netherlands,Japan,0,2,12,14,29/05/2021,0,0,0,0,1,2,6,9,1,3,1,5,9,0,12,21,4,0,0,4
2278,162642,2021,Australia,Netherlands,0,1,6,7,23/06/2021,18,0,43,61,0,0,0,0,2,3,2,7,0,0,2,2,3,1,1,5
2279,162642,2021,Serbia,Netherlands,0,0,1,1,22/06/2021,6,0,6,12,0,0,0,0,0,0,1,1,0,0,0,0,0,0,0,0
2280,162642,2021,Canada,Netherlands,0,0,2,2,21/06/2021,8,1,24,33,0,1,0,1,0,1,0,1,0,0,0,0,2,0,0,2
2281,162642,2021,Netherlands,USA,0,0,0,0,17/06/2021,0,0,0,0,0,0,0,0,0,0,0,0,0,0,0,0,0,0,0,0
2282,162642,2021,Netherlands,Italy,0,2,2,4,16/06/2021,10,0,38,48,0,0,0,0,0,1,0,1,0,0,0,0,3,2,0,5
2283,162642,2021,Netherlands,France,0,1,12,13,15/06/2021,39,1,70,110,0,0,1,1,1,2,3,6,0,1,2,3,4,1,1,6
2284,162642,2021,Netherlands,Bulgaria,0,2,10,12,11/06/2021,27,0,62,89,0,0,1,1,1,4,2,7,0,0,2,2,4,6,0,10
2285,162642,2021,Netherlands,Brazil,1,1,10,12,09/06/2021,18,0,52,70,2,0,0,2,0,0,1,1,0,0,0,0,3,3,0,6
2286,162642,2021,Netherlands,Iran,0,0,2,2,30/05/2021,6,0,0,6,0,0,0,0,0,0,0,0,0,0,0,0,0,0,0,0
2287,162642,2021,Netherlands,Japan,0,3,12,15,29/05/2021,28,3,76,107,0,0,2,2,0,2,0,2,0,0,0,0,7,3,1,11
2288,162642,2021,Netherlands,Russia,0,3,10,13,28/05/2021,26,0,53,79,0,0,0,0,0,1,2,3,0,0,0,0,2,0,2,4
2289,162095,2021,Australia,Netherlands,0,0,0,0,23/06/2021,0,0,0,0,0,0,0,0,0,0,0,0,0,0,0,0,0,0,0,0
2290,162095,2021,Serbia,Netherlands,0,0,0,0,22/06/2021,0,0,0,0,1,0,0,1,1,0,0,1,0,0,0,0,0,0,0,0
2291,162095,2021,Canada,Netherlands,0,1,0,1,21/06/2021,0,0,0,0,0,0,0,0,0,0,0,0,0,0,0,0,0,0,0,0
2292,162095,2021,Netherlands,USA,0,0,0,0,17/06/2021,0,0,0,0,0,0,1,1,0,2,0,2,0,0,1,1,0,0,0,0
2293,162095,2021,Netherlands,Italy,0,0,0,0,16/06/2021,0,0,0,0,0,0,0,0,0,0,0,0,0,0,0,0,0,0,0,0
2294,162095,2021,Netherlands,France,0,0,0,0,15/06/2021,0,0,0,0,0,0,0,0,0,0,0,0,0,0,0,0,0,0,0,0
2295,162095,2021,Netherlands,Bulgaria,0,0,0,0,11/06/2021,0,0,0,0,0,0,0,0,0,0,0,0,0,0,0,0,0,0,0,0
2296,162095,2021,Poland,Netherlands,0,1,1,2,10/06/2021,0,0,0,0,2,4,6,12,0,0,0,0,0,2,8,10,3,0,0,3
2297,162095,2021,Netherlands,Brazil,0,0,0,0,09/06/2021,0,0,0,0,0,0,0,0,0,0,0,0,0,0,0,0,0,0,0,0
2298,162095,2021,Netherlands,Slovenia,0,0,2,2,03/06/2021,0,0,0,0,2,2,3,7,1,0,1,2,1,1,3,5,1,1,0,2
2299,162095,2021,Netherlands,Iran,0,0,0,0,30/05/2021,0,0,0,0,0,0,0,0,0,0,0,0,0,0,0,0,0,0,0,0
2300,162095,2021,Netherlands,Russia,0,3,8,11,28/05/2021,0,0,0,0,4,5,4,13,0,1,1,2,3,2,10,15,8,1,0,9
2301,150703,2021,Australia,Netherlands,0,3,7,10,23/06/2021,0,0,0,0,3,0,1,4,0,0,2,2,0,0,2,2,1,0,1,2
2302,150703,2021,Serbia,Netherlands,1,3,18,22,22/06/2021,0,0,0,0,3,1,2,6,1,6,5,12,1,1,0,2,1,0,0,1
2303,150703,2021,Canada,Netherlands,0,1,3,4,21/06/2021,0,0,0,0,1,0,0,1,0,0,0,0,0,0,0,0,0,0,0,0
2304,150703,2021,Netherlands,USA,0,2,5,7,17/06/2021,0,0,0,0,0,0,0,0,0,0,1,1,0,0,1,1,1,2,0,3
2305,150703,2021,Netherlands,Italy,1,0,11,12,16/06/2021,0,0,0,0,3,1,3,7,0,7,3,10,0,0,0,0,1,2,2,5
2306,150703,2021,Netherlands,France,2,0,10,12,15/06/2021,0,0,0,0,0,0,0,0,0,0,1,1,0,0,0,0,0,0,0,0
2307,150703,2021,Netherlands,Bulgaria,1,0,8,9,11/06/2021,0,0,0,0,0,0,2,2,1,1,3,5,0,0,0,0,0,0,0,0
2308,150703,2021,Poland,Netherlands,0,1,8,9,10/06/2021,0,0,2,2,2,1,1,4,1,1,0,2,0,0,0,0,3,0,0,3
2309,150703,2021,Netherlands,Argentina,0,0,0,0,05/06/2021,0,0,0,0,0,0,0,0,0,0,0,0,0,0,0,0,0,0,0,0
2310,150703,2021,Netherlands,Germany,1,2,12,15,04/06/2021,0,0,2,2,1,1,2,4,1,5,4,10,0,0,1,1,2,0,0,2
2311,150703,2021,Netherlands,Slovenia,0,0,3,3,03/06/2021,0,0,0,0,1,1,1,3,1,2,1,4,0,0,2,2,1,0,0,1
2312,150703,2021,Netherlands,Iran,0,0,2,2,30/05/2021,0,0,0,0,0,0,0,0,0,0,0,0,0,0,0,0,1,0,0,1
2313,150703,2021,Netherlands,Japan,1,1,10,12,29/05/2021,0,0,0,0,2,0,1,3,1,0,0,1,1,1,0,2,0,0,0,0
2314,150703,2021,Netherlands,Russia,0,0,0,0,28/05/2021,0,0,0,0,0,0,0,0,0,0,0,0,0,0,0,0,0,0,0,0
2315,169923,2021,Australia,Netherlands,0,1,0,1,23/06/2021,0,0,0,0,0,0,0,0,0,0,0,0,0,0,0,0,0,0,0,0
2316,169923,2021,Serbia,Netherlands,0,3,11,14,22/06/2021,0,0,2,2,20,5,7,32,1,4,4,9,0,1,1,2,4,3,4,11
2317,169923,2021,Canada,Netherlands,0,0,5,5,21/06/2021,0,0,2,2,3,2,7,12,1,0,0,1,0,0,1,1,1,0,0,1
2318,169923,2021,Netherlands,USA,4,1,17,22,17/06/2021,0,0,2,2,15,4,17,36,0,4,2,6,1,1,2,4,4,2,0,6
2319,169923,2021,Netherlands,Italy,0,0,3,3,16/06/2021,0,0,0,0,0,0,1,1,0,0,0,0,0,0,1,1,0,0,0,0
2320,169923,2021,Netherlands,France,0,0,0,0,15/06/2021,0,0,0,0,0,2,0,2,0,1,0,1,0,0,0,0,0,0,0,0
2321,169923,2021,Netherlands,Bulgaria,0,0,1,1,11/06/2021,0,0,0,0,2,1,0,3,0,0,0,0,0,0,0,0,0,1,0,1
2322,169923,2021,Poland,Netherlands,1,2,5,8,10/06/2021,0,0,1,1,3,4,7,14,0,3,1,4,0,0,0,0,1,0,0,1
2323,169923,2021,Netherlands,Brazil,0,1,1,2,09/06/2021,0,0,0,0,0,0,1,1,0,0,1,1,0,0,0,0,0,0,0,0
2324,169923,2021,Netherlands,Argentina,0,0,0,0,05/06/2021,0,0,0,0,0,1,0,1,0,0,0,0,0,0,0,0,0,0,0,0
2325,169923,2021,Netherlands,Germany,0,1,0,1,04/06/2021,0,0,0,0,0,0,0,0,0,0,0,0,0,0,0,0,0,0,0,0
2326,169923,2021,Netherlands,Slovenia,0,0,2,2,03/06/2021,0,0,1,1,0,1,1,2,0,1,0,1,0,0,0,0,0,0,0,0
2327,169923,2021,Netherlands,Iran,2,2,6,10,30/05/2021,0,0,0,0,7,1,8,16,0,2,0,2,0,0,1,1,1,0,0,1
2328,169923,2021,Netherlands,Japan,0,0,2,2,29/05/2021,0,0,0,0,1,1,2,4,0,2,0,2,0,0,0,0,0,0,0,0
2329,169923,2021,Netherlands,Russia,0,0,0,0,28/05/2021,0,0,0,0,0,0,1,1,0,0,0,0,0,0,0,0,0,0,0,0
2330,120245,2021,Brazil,Poland,0,1,8,9,27/06/2021,0,0,0,0,2,0,1,3,1,5,1,7,0,0,0,0,0,1,0,1
2331,120245,2021,Poland,Slovenia,1,1,7,9,26/06/2021,0,0,1,1,3,0,0,3,3,2,2,7,0,0,0,0,0,0,0,0
2332,120245,2021,France,Poland,0,2,17,19,23/06/2021,0,0,0,0,5,1,1,7,4,5,4,13,0,0,1,1,3,0,0,3
2333,120245,2021,Iran,Poland,2,1,7,10,22/06/2021,0,0,0,0,4,1,3,8,2,5,7,14,0,0,0,0,1,0,0,1
2334,120245,2021,Poland,Argentina,0,0,0,0,21/06/2021,0,0,0,0,0,0,0,0,0,0,0,0,0,0,0,0,0,0,0,0
2335,120245,2021,Germany,Poland,0,2,6,8,17/06/2021,0,0,0,0,5,0,3,8,2,5,3,10,0,0,0,0,5,0,0,5
2336,120245,2021,Canada,Poland,0,1,9,10,15/06/2021,0,0,0,0,7,0,1,8,1,3,7,11,0,0,0,0,1,0,1,2
2337,120245,2021,Poland,Brazil,0,2,1,3,11/06/2021,0,0,0,0,1,0,2,3,3,2,0,5,0,0,0,0,0,0,0,0
2338,120245,2021,Poland,Netherlands,0,0,0,0,10/06/2021,0,0,0,0,0,0,0,0,0,0,0,0,0,0,0,0,0,0,0,0
2339,120245,2021,Poland,Bulgaria,0,0,0,0,09/06/2021,0,0,0,0,0,0,0,0,0,0,0,0,0,0,0,0,0,0,0,0
2340,120245,2021,Russia,Poland,0,0,3,3,05/06/2021,0,0,0,0,3,1,1,5,3,6,4,13,0,0,0,0,1,0,0,1
2341,120245,2021,Australia,Poland,0,2,5,7,03/06/2021,0,0,0,0,2,0,1,3,2,1,1,4,0,0,0,0,1,0,0,1
2342,156531,2021,France,Poland,0,0,0,0,23/06/2021,0,0,0,0,0,0,0,0,0,2,0,2,0,0,0,0,1,0,0,1
2343,156531,2021,Iran,Poland,0,0,3,3,22/06/2021,0,0,1,1,1,3,2,6,2,2,2,6,0,0,0,0,2,0,0,2
2344,156531,2021,Japan,Poland,2,4,6,12,16/06/2021,0,0,0,0,10,0,6,16,2,3,3,8,0,0,0,0,1,0,1,2
2345,156531,2021,Canada,Poland,0,0,0,0,15/06/2021,0,0,0,0,0,0,0,0,0,0,0,0,0,0,0,0,0,0,0,0
2346,156531,2021,Poland,Brazil,0,1,1,2,11/06/2021,0,0,0,0,1,1,1,3,0,0,0,0,0,0,1,1,0,0,0,0
2347,156531,2021,Poland,Netherlands,3,2,7,12,10/06/2021,0,0,1,1,5,5,9,19,1,2,6,9,0,0,0,0,4,0,0,4
2348,156531,2021,Poland,Bulgaria,0,0,0,0,09/06/2021,0,0,0,0,0,0,0,0,0,0,0,0,0,0,0,0,0,0,0,0
2349,156531,2021,Russia,Poland,1,4,8,13,05/06/2021,0,0,4,4,9,2,8,19,2,4,5,11,0,1,0,1,3,0,0,3
2350,156531,2021,Poland,USA,0,0,0,0,04/06/2021,0,0,0,0,0,0,0,0,0,0,1,1,0,0,0,0,0,0,0,0
2351,156531,2021,Poland,Slovenia,0,0,1,1,30/05/2021,0,0,1,1,0,1,2,3,0,3,0,3,0,0,0,0,0,0,0,0
2352,156531,2021,Poland,Italy,3,3,14,20,28/05/2021,0,0,0,0,11,1,13,25,0,2,3,5,0,0,0,0,5,0,1,6
2353,153389,2021,Iran,Poland,0,0,0,0,22/06/2021,0,0,0,0,0,0,0,0,0,0,0,0,0,0,0,0,0,0,0,0
2354,153389,2021,Japan,Poland,0,0,1,1,16/06/2021,4,0,3,7,1,0,0,1,0,0,0,0,0,0,0,0,0,0,0,0
2355,153389,2021,Canada,Poland,0,0,0,0,15/06/2021,0,0,0,0,0,0,0,0,0,0,0,0,0,0,0,0,0,0,0,0
2356,162105,2021,Brazil,Poland,0,0,1,1,27/06/2021,0,0,0,0,0,0,1,1,0,0,0,0,0,0,0,0,0,0,0,0
2357,162105,2021,Poland,Slovenia,0,1,1,2,26/06/2021,0,0,1,1,0,0,0,0,0,0,1,1,0,0,0,0,0,0,1,1
2358,162105,2021,Iran,Poland,0,0,7,7,22/06/2021,0,0,0,0,5,3,2,10,1,1,3,5,0,0,0,0,2,0,2,4
2359,162105,2021,Poland,Argentina,0,0,1,1,21/06/2021,0,0,0,0,1,0,0,1,1,0,0,1,0,0,0,0,0,0,0,0
2360,162105,2021,Germany,Poland,0,0,0,0,17/06/2021,0,0,0,0,0,0,0,0,0,0,0,0,0,0,0,0,0,0,0,0
2361,162105,2021,Japan,Poland,0,0,0,0,16/06/2021,0,0,0,0,0,0,0,0,0,0,0,0,0,0,0,0,0,0,0,0
2362,162105,2021,Poland,Brazil,0,3,7,10,11/06/2021,0,0,0,0,7,1,10,18,2,0,1,3,1,0,1,2,0,1,0,1
2363,162105,2021,Poland,Bulgaria,1,1,10,12,09/06/2021,0,0,0,0,10,2,11,23,1,3,0,4,0,0,0,0,1,1,0,2
2364,162105,2021,Russia,Poland,0,0,1,1,05/06/2021,0,0,0,0,0,0,0,0,0,1,0,1,0,0,0,0,0,0,0,0
2365,162105,2021,Australia,Poland,1,0,8,9,03/06/2021,0,0,0,0,10,2,6,18,6,3,1,10,0,0,0,0,3,1,0,4
2366,162105,2021,Poland,Slovenia,0,4,10,14,30/05/2021,0,0,0,0,15,8,12,35,2,5,2,9,0,0,0,0,4,1,0,5
2367,162105,2021,Poland,Serbia,0,0,1,1,29/05/2021,0,0,0,0,0,0,0,0,0,1,0,1,0,0,0,0,0,0,0,0
2368,115806,2021,Brazil,Poland,0,4,6,10,27/06/2021,0,0,5,5,15,3,8,26,2,1,2,5,0,0,0,0,5,1,0,6
2369,115806,2021,Poland,Slovenia,0,2,8,10,26/06/2021,0,0,1,1,14,3,6,23,3,3,0,6,0,0,0,0,4,1,1,6
2370,115806,2021,France,Poland,0,7,7,14,23/06/2021,0,0,5,5,14,7,8,29,1,6,3,10,0,0,0,0,6,3,1,10
2371,115806,2021,Poland,Argentina,2,4,7,13,21/06/2021,0,0,2,2,9,1,10,20,1,1,5,7,0,0,0,0,3,4,1,8
2372,115806,2021,Germany,Poland,0,1,10,11,17/06/2021,0,0,0,0,14,3,9,26,2,2,2,6,0,0,1,1,4,0,1,5
2373,115806,2021,Canada,Poland,0,4,5,9,15/06/2021,0,0,1,1,13,2,9,24,2,1,5,8,1,0,0,1,3,1,1,5
2374,115806,2021,Poland,Netherlands,0,0,0,0,10/06/2021,0,0,0,0,0,0,0,0,0,0,0,0,0,0,0,0,0,0,0,0
2375,115806,2021,Poland,USA,0,3,8,11,04/06/2021,0,0,0,0,8,5,6,19,0,2,4,6,1,0,1,2,8,1,1,10
2376,115806,2021,Australia,Poland,0,0,0,0,03/06/2021,0,0,0,0,0,0,0,0,0,0,0,0,0,0,0,0,0,0,0,0
2377,115806,2021,Poland,Serbia,0,3,8,11,29/05/2021,0,0,0,0,10,3,11,24,2,5,2,9,0,0,2,2,4,1,1,6
2378,115806,2021,Poland,Italy,0,0,0,0,28/05/2021,0,0,0,0,0,0,0,0,0,0,0,0,0,0,0,0,0,0,0,0
2379,119646,2021,Brazil,Poland,1,3,8,12,27/06/2021,0,0,1,1,5,4,15,24,2,1,1,4,5,2,15,22,5,3,0,8
2380,119646,2021,Poland,Slovenia,2,2,13,17,26/06/2021,0,0,1,1,11,3,7,21,0,2,1,3,6,2,14,22,3,2,1,6
2381,119646,2021,France,Poland,3,7,9,19,23/06/2021,0,0,2,2,12,3,11,26,3,2,0,5,12,1,15,28,3,2,1,6
2382,119646,2021,Iran,Poland,0,0,0,0,22/06/2021,0,0,0,0,0,0,0,0,0,0,0,0,0,0,0,0,0,0,0,0
2383,119646,2021,Germany,Poland,1,6,5,12,17/06/2021,0,0,2,2,11,1,9,21,1,2,2,5,4,1,12,17,2,1,0,3
2384,119646,2021,Japan,Poland,0,0,0,0,16/06/2021,0,0,0,0,0,0,0,0,0,0,0,0,0,0,0,0,0,0,0,0
2385,119646,2021,Canada,Poland,3,2,9,14,15/06/2021,0,0,1,1,11,1,10,22,1,3,0,4,2,2,10,14,5,4,2,11
2386,119646,2021,Poland,Brazil,0,0,0,0,11/06/2021,0,0,0,0,0,1,0,1,0,1,0,1,0,0,0,0,0,0,0,0
2387,119646,2021,Poland,Bulgaria,2,6,6,14,09/06/2021,0,0,3,3,7,0,6,13,0,0,1,1,3,0,8,11,4,2,0,6
2388,119646,2021,Russia,Poland,7,5,6,18,05/06/2021,0,0,3,3,16,3,13,32,2,3,1,6,4,1,14,19,4,1,0,5
2389,119646,2021,Poland,USA,0,0,1,1,04/06/2021,0,0,0,0,0,0,0,0,0,0,0,0,0,0,0,0,0,0,0,0
2390,119646,2021,Poland,Serbia,13,5,12,30,29/05/2021,0,0,0,0,13,2,2,17,0,1,0,1,10,2,21,33,7,1,0,8
2391,119646,2021,Poland,Italy,0,0,0,0,28/05/2021,0,0,0,0,0,0,0,0,0,0,0,0,0,0,0,0,0,0,0,0
2392,135322,2021,Brazil,Poland,0,0,0,0,27/06/2021,0,0,0,0,0,0,0,0,0,0,0,0,0,0,0,0,0,0,0,0
2393,135322,2021,Poland,Slovenia,0,0,0,0,26/06/2021,0,0,0,0,0,0,0,0,0,0,0,0,0,0,0,0,0,0,0,0
2394,135322,2021,France,Poland,0,0,0,0,23/06/2021,0,0,7,7,0,0,0,0,0,0,0,0,6,2,12,20,9,4,0,13
2395,135322,2021,Iran,Poland,0,0,0,0,22/06/2021,0,0,2,2,0,0,0,0,0,0,0,0,5,0,10,15,7,1,2,10
2396,135322,2021,Poland,Argentina,0,0,0,0,21/06/2021,0,0,0,0,0,0,0,0,0,0,0,0,0,0,0,0,0,0,0,0
2397,135322,2021,Poland,Brazil,0,0,0,0,11/06/2021,0,0,0,0,0,0,0,0,0,0,0,0,9,1,12,22,6,5,1,12
2398,135322,2021,Poland,Netherlands,0,0,0,0,10/06/2021,0,0,0,0,0,0,0,0,0,0,0,0,0,0,0,0,0,0,0,0
2399,135322,2021,Poland,Bulgaria,0,0,0,0,09/06/2021,0,0,3,3,0,0,0,0,0,0,0,0,2,1,9,12,6,1,0,7
2400,135322,2021,Russia,Poland,0,0,0,0,05/06/2021,0,0,0,0,0,0,0,0,0,0,0,0,0,0,0,0,0,0,0,0
2401,135322,2021,Poland,USA,0,0,0,0,04/06/2021,0,0,2,2,0,0,0,0,0,0,0,0,5,0,9,14,6,5,1,12
2402,135322,2021,Australia,Poland,0,0,0,0,03/06/2021,0,0,0,0,0,0,0,0,0,0,0,0,0,0,0,0,0,0,0,0
2403,135322,2021,Poland,Slovenia,0,0,0,0,30/05/2021,0,1,3,4,0,0,0,0,0,0,0,0,11,1,11,23,9,3,1,13
2404,135322,2021,Poland,Serbia,0,0,0,0,29/05/2021,0,0,0,0,0,0,0,0,0,0,0,0,1,1,2,4,2,0,0,2
2405,135322,2021,Poland,Italy,0,0,0,0,28/05/2021,0,0,0,0,0,0,0,0,0,0,0,0,4,0,5,9,6,1,1,8
2406,118612,2021,Brazil,Poland,1,3,12,16,27/06/2021,24,0,59,83,0,0,0,0,0,2,0,2,0,0,1,1,2,2,3,7
2407,118612,2021,Poland,Slovenia,2,1,9,12,26/06/2021,16,0,45,61,0,0,0,0,4,3,1,8,0,0,0,0,4,1,1,6
2408,118612,2021,France,Poland,0,3,14,17,23/06/2021,29,1,67,97,0,1,1,2,1,2,4,7,0,0,1,1,7,0,3,10
2409,118612,2021,Iran,Poland,0,0,0,0,22/06/2021,0,0,0,0,0,0,0,0,0,0,0,0,0,0,0,0,0,0,0,0
2410,118612,2021,Poland,Argentina,2,0,9,11,21/06/2021,25,0,39,64,1,0,0,1,0,1,2,3,0,0,0,0,5,1,0,6
2411,118612,2021,Germany,Poland,0,0,11,11,17/06/2021,28,0,42,70,1,0,0,1,1,0,2,3,0,0,0,0,5,2,1,8
2412,118612,2021,Japan,Poland,0,0,0,0,16/06/2021,0,0,0,0,0,0,0,0,0,0,0,0,0,0,0,0,0,0,0,0
2413,118612,2021,Canada,Poland,1,2,11,14,15/06/2021,18,0,50,68,0,0,0,0,0,2,2,4,0,0,0,0,7,1,2,10
2414,118612,2021,Poland,Brazil,1,3,5,9,11/06/2021,14,0,68,82,0,0,1,1,0,1,1,2,0,0,0,0,1,1,0,2
2415,118612,2021,Poland,Netherlands,0,0,0,0,10/06/2021,0,0,0,0,0,0,0,0,0,0,0,0,0,0,0,0,0,0,0,0
2416,118612,2021,Poland,Bulgaria,1,5,9,15,09/06/2021,18,0,40,58,0,0,0,0,0,2,1,3,0,0,1,1,3,0,0,3
2417,118612,2021,Russia,Poland,0,3,8,11,05/06/2021,26,0,40,66,0,0,0,0,0,2,1,3,0,0,0,0,6,2,0,8
2418,118612,2021,Poland,USA,0,0,0,0,04/06/2021,0,0,0,0,0,0,0,0,0,0,0,0,0,0,0,0,0,0,0,0
2419,118612,2021,Australia,Poland,3,3,12,18,03/06/2021,10,0,36,46,0,0,0,0,2,0,0,2,0,0,0,0,4,0,0,4
2420,118612,2021,Poland,Slovenia,0,0,0,0,30/05/2021,3,0,6,9,0,0,0,0,0,0,0,0,0,0,0,0,0,0,0,0
2421,118612,2021,Poland,Serbia,1,4,12,17,29/05/2021,25,0,64,89,0,0,2,2,0,0,1,1,0,0,0,0,3,2,0,5
2422,118612,2021,Poland,Italy,0,0,0,0,28/05/2021,0,0,0,0,0,0,0,0,0,0,0,0,0,0,0,0,0,0,0,0
2423,115794,2021,Brazil,Poland,0,0,1,1,27/06/2021,0,0,2,2,0,0,0,0,0,0,0,0,0,0,0,0,0,0,0,0
2424,115794,2021,Poland,Slovenia,0,0,0,0,26/06/2021,0,0,0,0,0,0,0,0,0,0,0,0,0,0,0,0,0,0,0,0
2425,115794,2021,France,Poland,0,0,0,0,23/06/2021,0,0,0,0,0,0,0,0,0,0,0,0,0,0,0,0,0,0,0,0
2426,115794,2021,Iran,Poland,0,1,10,11,22/06/2021,18,1,41,60,0,0,0,0,1,2,5,8,0,1,0,1,4,0,1,5
2427,115794,2021,Poland,Argentina,0,0,0,0,21/06/2021,1,0,2,3,0,0,0,0,0,0,0,0,0,0,0,0,0,0,0,0
2428,115794,2021,Germany,Poland,0,0,0,0,17/06/2021,0,0,0,0,0,0,0,0,0,0,0,0,0,0,0,0,0,0,0,0
2429,115794,2021,Japan,Poland,0,0,8,8,16/06/2021,13,0,29,42,0,0,0,0,0,1,1,2,0,0,0,0,4,0,3,7
2430,115794,2021,Canada,Poland,0,0,0,0,15/06/2021,0,0,0,0,0,0,0,0,0,0,0,0,0,0,0,0,0,0,0,0
2431,115794,2021,Poland,Brazil,0,0,0,0,11/06/2021,0,0,1,1,0,0,0,0,0,0,0,0,0,0,0,0,0,0,0,0
2432,115794,2021,Poland,Netherlands,0,1,14,15,10/06/2021,15,0,35,50,1,0,0,1,2,1,2,5,0,0,0,0,4,0,2,6
2433,115794,2021,Poland,Bulgaria,0,0,0,0,09/06/2021,0,0,0,0,0,0,0,0,0,0,0,0,0,0,0,0,0,0,0,0
2434,115794,2021,Russia,Poland,0,0,0,0,05/06/2021,2,0,1,3,0,0,0,0,0,0,0,0,0,0,0,0,0,0,0,0
2435,115794,2021,Poland,USA,0,0,16,16,04/06/2021,31,1,35,67,0,0,0,0,0,2,1,3,0,0,0,0,5,1,2,8
2436,115794,2021,Australia,Poland,0,0,0,0,03/06/2021,0,0,0,0,0,0,0,0,0,0,0,0,0,0,0,0,0,0,0,0
2437,115794,2021,Poland,Slovenia,1,0,10,11,30/05/2021,27,0,62,89,0,0,0,0,0,2,1,3,0,0,0,0,3,2,0,5
2438,115794,2021,Poland,Serbia,0,0,0,0,29/05/2021,0,0,0,0,0,0,0,0,0,0,0,0,0,0,0,0,0,0,0,0
2439,115794,2021,Poland,Italy,0,1,6,7,28/05/2021,30,0,0,30,1,0,0,1,0,1,0,1,0,0,0,0,4,0,1,5
2440,115845,2021,Brazil,Poland,0,3,14,17,27/06/2021,0,1,4,5,14,5,5,24,1,1,2,4,8,1,15,24,8,1,1,10
2441,115845,2021,Poland,Slovenia,0,2,6,8,26/06/2021,0,0,2,2,4,4,7,15,2,3,1,6,3,3,8,14,3,2,0,5
2442,115845,2021,France,Poland,0,3,17,20,23/06/2021,0,0,4,4,10,4,11,25,2,2,4,8,16,1,13,30,2,3,0,5
2443,115845,2021,Poland,Argentina,1,3,10,14,21/06/2021,0,0,3,3,9,1,5,15,0,6,1,7,3,1,12,16,8,1,1,10
2444,115845,2021,Germany,Poland,1,3,13,17,17/06/2021,0,0,4,4,10,1,6,17,0,2,1,3,3,0,17,20,6,5,1,12
2445,115845,2021,Canada,Poland,0,1,13,14,15/06/2021,0,0,6,6,8,4,9,21,0,1,2,3,3,2,16,21,10,1,0,11
2446,115845,2021,Poland,Brazil,0,2,7,9,11/06/2021,0,0,2,2,7,1,6,14,0,4,0,4,7,1,11,19,4,4,0,8
2447,115845,2021,Poland,Netherlands,0,0,0,0,10/06/2021,0,0,0,0,0,0,0,0,0,0,0,0,0,0,0,0,0,0,0,0
2448,115845,2021,Russia,Poland,1,1,9,11,05/06/2021,0,0,3,3,8,2,9,19,2,1,0,3,1,2,11,14,5,1,2,8
2449,115845,2021,Poland,USA,0,0,0,0,04/06/2021,0,0,0,0,0,0,0,0,0,0,0,0,0,0,0,0,0,0,0,0
2450,115845,2021,Poland,Slovenia,0,2,13,15,30/05/2021,0,0,8,8,8,4,17,29,0,1,1,2,10,2,13,25,4,6,1,11
2451,115845,2021,Poland,Serbia,0,0,0,0,29/05/2021,0,0,0,0,0,0,0,0,0,0,0,0,0,0,0,0,0,0,0,0
2452,142679,2021,Brazil,Poland,0,0,0,0,27/06/2021,0,0,0,0,0,0,0,0,0,0,0,0,1,1,2,4,0,0,0,0
2453,142679,2021,Poland,Slovenia,0,0,1,1,26/06/2021,0,0,1,1,1,1,1,3,0,1,0,1,0,0,1,1,0,0,0,0
2454,142679,2021,France,Poland,0,0,0,0,23/06/2021,0,0,0,0,0,0,0,0,0,0,0,0,1,0,1,2,3,0,0,3
2455,142679,2021,Iran,Poland,1,2,19,22,22/06/2021,0,0,1,1,8,1,9,18,1,1,2,4,5,1,6,12,4,2,0,6
2456,142679,2021,Poland,Argentina,0,0,0,0,21/06/2021,0,0,0,0,0,0,0,0,0,0,0,0,0,0,0,0,0,0,0,0
2457,142679,2021,Germany,Poland,0,0,0,0,17/06/2021,0,0,0,0,0,0,0,0,0,0,0,0,0,0,0,0,0,0,0,0
2458,142679,2021,Japan,Poland,0,0,0,0,16/06/2021,0,0,0,0,0,0,0,0,0,0,0,0,0,0,0,0,0,0,0,0
2459,142679,2021,Canada,Poland,0,0,0,0,15/06/2021,0,0,0,0,0,0,0,0,0,0,0,0,0,0,0,0,0,0,0,0
2460,142679,2021,Poland,Brazil,0,0,0,0,11/06/2021,0,0,0,0,0,0,0,0,0,0,0,0,0,0,0,0,0,0,0,0
2461,142679,2021,Poland,Netherlands,0,3,12,15,10/06/2021,0,0,1,1,11,0,5,16,0,1,2,3,4,2,8,14,5,0,0,5
2462,142679,2021,Poland,Bulgaria,0,0,0,0,09/06/2021,0,0,0,0,0,0,0,0,0,0,0,0,0,0,0,0,0,0,0,0
2463,142679,2021,Poland,USA,0,3,16,19,04/06/2021,0,0,1,1,8,2,4,14,1,1,2,4,4,0,10,14,5,0,0,5
2464,142679,2021,Australia,Poland,0,0,0,0,03/06/2021,0,0,0,0,0,0,0,0,0,0,0,0,0,0,0,0,0,0,0,0
2465,142679,2021,Poland,Slovenia,0,1,15,16,30/05/2021,0,0,4,4,13,4,19,36,0,2,0,2,13,2,15,30,3,2,0,5
2466,142679,2021,Poland,Serbia,1,0,3,4,29/05/2021,0,0,0,0,0,0,0,0,0,0,0,0,0,0,0,0,0,0,0,0
2467,152870,2021,Poland,Slovenia,0,0,3,3,26/06/2021,0,0,0,0,2,0,0,2,0,1,2,3,0,0,0,0,1,0,0,1
2468,152870,2021,France,Poland,0,0,0,0,23/06/2021,0,0,0,0,0,0,0,0,0,0,0,0,0,0,0,0,0,0,0,0
2469,152870,2021,Iran,Poland,2,2,8,12,22/06/2021,0,0,1,1,9,0,3,12,1,5,3,9,0,0,3,3,3,0,0,3
2470,152870,2021,Germany,Poland,0,4,10,14,17/06/2021,0,0,1,1,5,3,3,11,1,2,4,7,0,0,1,1,2,0,0,2
2471,152870,2021,Japan,Poland,0,0,0,0,16/06/2021,0,0,0,0,0,0,0,0,0,0,0,0,0,0,0,0,0,0,0,0
2472,152870,2021,Canada,Poland,0,3,10,13,15/06/2021,0,0,0,0,5,0,3,8,0,6,4,10,0,0,0,0,1,0,0,1
2473,152870,2021,Poland,Brazil,0,0,11,11,11/06/2021,0,0,0,0,4,1,6,11,1,3,0,4,0,0,0,0,1,3,0,4
2474,152870,2021,Poland,Bulgaria,1,2,12,15,09/06/2021,0,0,0,0,4,0,0,4,3,2,1,6,0,0,0,0,4,1,0,5
2475,152870,2021,Poland,USA,0,1,6,7,04/06/2021,0,0,0,0,9,3,1,13,1,2,3,6,0,0,0,0,3,0,2,5
2476,152870,2021,Australia,Poland,0,0,2,2,03/06/2021,0,0,0,0,0,0,0,0,1,0,1,2,0,0,0,0,0,1,0,1
2477,152870,2021,Poland,Serbia,1,1,14,16,29/05/2021,0,0,0,0,7,2,3,12,4,8,1,13,0,0,0,0,3,0,0,3
2478,152870,2021,Poland,Italy,0,0,0,0,28/05/2021,0,0,0,0,0,0,0,0,0,0,0,0,0,0,0,0,0,0,0,0
2479,153395,2021,Brazil,Poland,0,0,1,1,27/06/2021,0,0,1,1,1,5,1,7,0,2,1,3,1,0,1,2,0,0,0,0
2480,153395,2021,Poland,Slovenia,0,0,0,0,26/06/2021,0,0,0,0,0,0,0,0,0,0,0,0,0,0,0,0,0,0,0,0
2481,153395,2021,France,Poland,0,0,0,0,23/06/2021,0,0,0,0,2,1,1,4,0,0,0,0,1,1,3,5,0,0,0,0
2482,153395,2021,Poland,Argentina,0,4,8,12,21/06/2021,0,0,3,3,13,3,9,25,0,2,1,3,2,0,14,16,5,1,3,9
2483,153395,2021,Germany,Poland,0,0,0,0,17/06/2021,0,0,0,0,0,0,0,0,0,0,0,0,0,0,0,0,0,0,0,0
2484,153395,2021,Japan,Poland,0,3,9,12,16/06/2021,0,0,6,6,3,0,4,7,2,2,3,7,5,0,13,18,4,0,0,4
2485,153395,2021,Poland,Brazil,0,2,9,11,11/06/2021,0,0,1,1,15,3,12,30,1,3,0,4,12,0,9,21,4,3,0,7
2486,153395,2021,Poland,Netherlands,0,0,0,0,10/06/2021,0,0,0,0,0,0,0,0,0,0,0,0,0,0,0,0,0,0,0,0
2487,153395,2021,Russia,Poland,0,0,0,0,05/06/2021,0,0,0,0,0,0,0,0,0,0,0,0,0,0,0,0,0,0,0,0
2488,153395,2021,Poland,USA,0,1,3,4,04/06/2021,0,0,0,0,5,0,1,6,1,0,1,2,3,0,3,6,5,0,1,6
2489,153395,2021,Australia,Poland,1,2,13,16,03/06/2021,0,0,1,1,11,1,3,15,1,1,0,2,2,0,6,8,1,3,0,4
2490,153395,2021,Poland,Serbia,0,4,4,8,29/05/2021,0,0,0,0,11,1,16,28,6,2,3,11,6,0,6,12,4,1,1,6
2491,153395,2021,Poland,Italy,0,0,0,0,28/05/2021,0,0,0,0,0,0,0,0,0,0,0,0,0,0,0,0,0,0,0,0
2492,118614,2021,Brazil,Poland,0,0,0,0,27/06/2021,0,0,5,5,0,0,0,0,0,0,0,0,6,2,17,25,9,5,2,16
2493,118614,2021,Poland,Slovenia,0,0,0,0,26/06/2021,0,0,3,3,0,0,0,0,0,0,0,0,7,0,8,15,7,2,1,10
2494,118614,2021,France,Poland,0,0,0,0,23/06/2021,0,0,0,0,0,0,0,0,0,0,0,0,0,0,0,0,0,0,0,0
2495,118614,2021,Iran,Poland,0,0,0,0,22/06/2021,0,0,0,0,0,0,0,0,0,0,0,0,0,0,0,0,0,0,0,0
2496,118614,2021,Poland,Argentina,0,0,0,0,21/06/2021,0,0,3,3,0,0,0,0,0,0,0,0,6,0,8,14,6,1,1,8
2497,118614,2021,Germany,Poland,0,0,0,0,17/06/2021,0,0,5,5,0,0,0,0,0,0,0,0,4,1,7,12,12,2,1,15
2498,118614,2021,Japan,Poland,0,0,0,0,16/06/2021,0,0,4,4,0,0,0,0,0,0,0,0,3,0,5,8,5,2,2,9
2499,118614,2021,Canada,Poland,0,0,0,0,15/06/2021,0,0,1,1,0,0,0,0,0,0,0,0,3,1,11,15,4,3,1,8
2500,118614,2021,Poland,Brazil,0,0,0,0,11/06/2021,0,0,0,0,0,0,0,0,0,0,0,0,0,0,0,0,0,0,0,0
2501,118614,2021,Poland,Netherlands,0,0,0,0,10/06/2021,0,0,6,6,0,0,0,0,0,0,0,0,2,0,3,5,9,4,0,13
2502,118614,2021,Poland,Bulgaria,0,0,0,0,09/06/2021,0,0,0,0,0,0,0,0,0,0,0,0,0,0,0,0,0,0,0,0
2503,118614,2021,Russia,Poland,0,0,0,0,05/06/2021,0,0,3,3,0,0,0,0,0,0,0,0,7,2,15,24,8,3,3,14
2504,118614,2021,Poland,USA,0,0,0,0,04/06/2021,0,0,0,0,0,0,0,0,0,0,0,0,0,0,0,0,0,0,0,0
2505,118614,2021,Australia,Poland,0,0,0,0,03/06/2021,0,0,4,4,0,0,0,0,0,0,0,0,4,1,3,8,8,1,0,9
2506,118614,2021,Poland,Slovenia,0,0,0,0,30/05/2021,0,0,0,0,0,0,0,0,0,0,0,0,0,0,0,0,0,0,0,0
2507,118614,2021,Poland,Serbia,0,0,0,0,29/05/2021,0,0,3,3,0,0,0,0,0,0,0,0,8,2,7,17,6,2,0,8
2508,118614,2021,Poland,Italy,0,0,0,0,28/05/2021,0,0,0,0,0,0,0,0,0,0,0,0,0,0,0,0,0,0,0,0
2509,150734,2021,Brazil,Poland,1,3,8,12,27/06/2021,0,0,0,0,7,1,8,16,1,7,7,15,0,0,1,1,2,0,0,2
2510,150734,2021,Poland,Slovenia,1,2,9,12,26/06/2021,0,0,1,1,2,1,3,6,2,1,5,8,1,0,0,1,2,0,0,2
2511,150734,2021,France,Poland,0,3,12,15,23/06/2021,0,0,1,1,9,2,5,16,4,4,7,15,0,0,0,0,2,0,1,3
2512,150734,2021,Poland,Argentina,2,4,8,14,21/06/2021,0,0,0,0,5,0,5,10,0,6,6,12,0,0,0,0,2,0,0,2
2513,150734,2021,Germany,Poland,0,0,0,0,17/06/2021,0,0,0,0,0,0,0,0,0,0,0,0,0,0,0,0,0,0,0,0
2514,150734,2021,Japan,Poland,3,4,10,17,16/06/2021,0,0,0,0,5,0,5,10,1,3,3,7,0,0,0,0,2,3,1,6
2515,150734,2021,Poland,Brazil,1,1,6,8,11/06/2021,0,0,0,0,2,0,3,5,0,0,0,0,0,0,0,0,1,1,0,2
2516,150734,2021,Poland,Netherlands,3,5,5,13,10/06/2021,0,0,0,0,11,2,2,15,2,1,6,9,0,0,0,0,0,0,0,0
2517,150734,2021,Russia,Poland,2,3,13,18,05/06/2021,0,0,0,0,2,0,0,2,0,0,2,2,0,0,0,0,3,1,0,4
2518,150734,2021,Poland,USA,0,2,8,10,04/06/2021,0,0,3,3,7,0,3,10,5,1,1,7,0,0,0,0,1,0,0,1
2519,150734,2021,Australia,Poland,0,0,0,0,03/06/2021,0,0,0,0,0,0,0,0,0,0,0,0,0,0,0,0,0,0,0,0
2520,150734,2021,Poland,Slovenia,2,1,17,20,30/05/2021,0,0,0,0,9,1,7,17,5,5,2,12,0,0,1,1,2,1,0,3
2521,150734,2021,Poland,Italy,2,2,10,14,28/05/2021,0,0,0,0,8,1,2,11,2,2,7,11,1,0,0,1,3,1,1,5
2522,152866,2021,Brazil,Poland,0,0,0,0,27/06/2021,0,0,0,0,0,0,0,0,0,0,0,0,0,0,0,0,0,0,0,0
2523,152866,2021,Poland,Slovenia,0,0,0,0,26/06/2021,0,0,0,0,0,0,0,0,0,0,0,0,0,0,0,0,0,0,0,0
2524,152866,2021,Iran,Poland,0,0,0,0,22/06/2021,0,0,0,0,0,0,0,0,0,0,0,0,0,0,0,0,0,0,0,0
2525,152866,2021,Poland,Argentina,0,0,0,0,21/06/2021,0,0,0,0,0,0,0,0,0,0,0,0,0,0,0,0,0,0,0,0
2526,152866,2021,Japan,Poland,1,2,9,12,16/06/2021,0,0,1,1,15,2,8,25,0,1,3,4,2,0,5,7,10,1,1,12
2527,152866,2021,Canada,Poland,0,0,0,0,15/06/2021,0,0,0,0,0,0,0,0,0,0,0,0,0,0,0,0,0,0,0,0
2528,152866,2021,Poland,Netherlands,2,1,6,9,10/06/2021,0,0,2,2,5,0,2,7,2,2,0,4,6,0,8,14,9,2,1,12
2529,152866,2021,Poland,Bulgaria,0,0,0,0,09/06/2021,0,0,0,0,0,0,0,0,0,0,0,0,0,0,0,0,0,0,0,0
2530,152866,2021,Russia,Poland,0,0,0,0,05/06/2021,0,0,0,0,0,0,0,0,0,0,0,0,0,0,0,0,0,0,0,0
2531,152866,2021,Australia,Poland,4,3,6,13,03/06/2021,0,0,1,1,6,2,5,13,0,1,1,2,5,0,7,12,2,1,0,3
2532,152866,2021,Poland,Slovenia,0,1,2,3,30/05/2021,0,0,0,0,0,0,0,0,0,0,0,0,0,0,0,0,0,1,0,1
2533,152866,2021,Poland,Italy,1,2,8,11,28/05/2021,0,0,0,0,9,2,4,15,0,2,0,2,12,0,8,20,9,2,0,11
2534,150742,2021,Iran,Poland,1,1,6,8,22/06/2021,0,0,3,3,4,7,3,14,3,1,1,5,3,1,8,12,6,1,0,7
2535,150742,2021,Poland,Argentina,0,0,0,0,21/06/2021,0,0,0,0,0,0,0,0,0,0,0,0,0,0,0,0,0,0,0,0
2536,150742,2021,Germany,Poland,0,0,0,0,17/06/2021,0,0,0,0,0,0,0,0,0,0,0,0,0,0,0,0,0,0,0,0
2537,150742,2021,Poland,Brazil,0,0,0,0,11/06/2021,0,0,0,0,0,0,0,0,0,0,0,0,0,0,0,0,0,0,0,0
2538,150742,2021,Poland,Bulgaria,2,1,8,11,09/06/2021,0,0,3,3,11,1,5,17,1,2,0,3,9,0,1,10,1,1,0,2
2539,150742,2021,Poland,USA,2,2,5,9,04/06/2021,0,0,2,2,3,2,7,12,2,1,0,3,2,2,3,7,3,1,0,4
2540,150742,2021,Australia,Poland,0,0,0,0,03/06/2021,0,0,0,0,0,0,0,0,0,0,0,0,0,0,0,0,0,0,0,0
2541,150742,2021,Poland,Slovenia,0,0,0,0,30/05/2021,0,0,0,0,0,0,0,0,0,0,0,0,0,0,0,0,0,0,0,0
2542,150742,2021,Poland,Italy,3,4,5,12,28/05/2021,0,0,0,0,3,5,10,18,1,2,1,4,8,0,6,14,3,1,1,5
2543,118618,2021,France,Poland,0,0,0,0,23/06/2021,0,0,0,0,0,0,0,0,0,0,0,0,0,0,0,0,0,0,0,0
2544,118618,2021,Poland,Argentina,0,0,8,8,21/06/2021,0,0,0,0,6,1,1,8,1,4,2,7,0,0,0,0,2,0,1,3
2545,118618,2021,Japan,Poland,0,1,11,12,16/06/2021,0,0,0,0,1,1,2,4,1,4,4,9,0,0,0,0,3,1,0,4
2546,118618,2021,Canada,Poland,0,0,0,0,15/06/2021,0,0,0,0,0,0,0,0,0,0,0,0,0,0,0,0,0,0,0,0
2547,118618,2021,Poland,Netherlands,0,2,7,9,10/06/2021,0,0,0,0,2,1,1,4,2,1,1,4,0,0,0,0,0,1,0,1
2548,118618,2021,Poland,Bulgaria,0,0,0,0,09/06/2021,0,0,0,0,0,0,0,0,0,0,0,0,0,0,0,0,0,0,0,0
2549,118618,2021,Russia,Poland,1,1,18,20,05/06/2021,0,0,0,0,4,1,1,6,3,6,4,13,0,0,0,0,4,0,0,4
2550,118618,2021,Poland,USA,0,0,0,0,04/06/2021,0,0,0,0,0,0,0,0,0,0,0,0,0,0,0,0,0,0,0,0
2551,118618,2021,Poland,Slovenia,0,2,8,10,30/05/2021,0,0,2,2,6,0,2,8,1,4,2,7,0,0,2,2,0,1,0,1
2552,118618,2021,Poland,Serbia,0,0,0,0,29/05/2021,0,0,0,0,0,0,0,0,0,0,0,0,0,0,0,0,0,0,0,0
2553,118618,2021,Poland,Italy,0,1,8,9,28/05/2021,0,0,0,0,7,1,1,9,5,2,13,20,0,0,0,0,2,1,1,4
2554,152869,2021,Brazil,Poland,0,0,0,0,27/06/2021,0,0,0,0,0,0,0,0,0,0,0,0,0,0,0,0,0,0,0,0
2555,152869,2021,Iran,Poland,0,0,0,0,22/06/2021,0,0,0,0,0,0,0,0,0,0,0,0,0,0,0,0,0,0,0,0
2556,152869,2021,Germany,Poland,0,0,0,0,17/06/2021,0,0,0,0,0,0,0,0,0,0,0,0,0,0,0,0,0,0,0,0
2557,152869,2021,Japan,Poland,0,0,0,0,16/06/2021,0,0,0,0,0,0,0,0,0,0,0,0,0,0,0,0,0,0,0,0
2558,152869,2021,Canada,Poland,0,0,0,0,15/06/2021,0,0,0,0,0,0,0,0,0,0,0,0,0,0,0,0,0,0,0,0
2559,152869,2021,Poland,Netherlands,0,0,0,0,10/06/2021,0,0,0,0,0,0,0,0,0,0,0,0,0,0,0,0,0,0,0,0
2560,152869,2021,Poland,Bulgaria,1,0,6,7,09/06/2021,0,0,0,0,7,0,2,9,3,3,2,8,0,0,0,0,2,2,0,4
2561,152869,2021,Russia,Poland,0,0,0,0,05/06/2021,0,0,0,0,0,0,0,0,0,0,0,0,0,0,0,0,0,0,0,0
2562,152869,2021,Australia,Poland,2,2,5,9,03/06/2021,0,0,0,0,2,0,2,4,1,3,1,5,1,0,0,1,0,0,0,0
2563,152869,2021,Poland,Slovenia,0,0,0,0,30/05/2021,0,0,0,0,0,0,0,0,0,0,0,0,0,0,0,0,0,0,0,0
2564,152869,2021,Poland,Serbia,1,3,5,9,29/05/2021,0,0,0,0,5,2,2,9,1,7,2,10,0,1,0,1,0,0,0,0
2565,152869,2021,Poland,Italy,0,0,0,0,28/05/2021,0,0,0,0,0,0,0,0,0,0,0,0,0,0,0,0,0,0,0,0
2566,168238,2021,Brazil,Russia,0,3,11,14,23/06/2021,0,0,1,1,10,4,11,25,2,1,0,3,1,2,12,15,3,2,2,7
2567,168238,2021,Russia,Italy,0,0,5,5,22/06/2021,0,0,0,0,0,0,0,0,0,0,0,0,0,0,0,0,0,0,0,0
2568,168238,2021,Germany,Russia,1,2,5,8,21/06/2021,0,0,0,0,0,0,0,0,0,0,0,0,0,0,0,0,0,0,0,0
2569,168238,2021,Bulgaria,Russia,0,0,3,3,17/06/2021,0,0,0,0,0,0,0,0,0,0,0,0,0,0,0,0,0,0,0,0
2570,168238,2021,Argentina,Russia,3,0,13,16,16/06/2021,0,0,6,6,7,3,8,18,2,4,2,8,6,3,13,22,8,1,1,10
2571,168238,2021,Russia,Serbia,0,3,6,9,15/06/2021,0,0,1,1,9,1,4,14,1,2,2,5,3,0,9,12,3,1,0,4
2572,168238,2021,Slovenia,Russia,0,0,0,0,11/06/2021,0,0,0,0,0,0,0,0,0,0,0,0,0,0,0,0,0,0,0,0
2573,168238,2021,Russia,Canada,0,2,4,6,10/06/2021,0,0,0,0,2,2,4,8,0,1,0,1,4,0,9,13,4,1,0,5
2574,168238,2021,France,Russia,1,0,2,3,09/06/2021,0,0,0,0,0,0,0,0,0,0,0,0,0,0,0,0,0,0,0,0
2575,168238,2021,Russia,Australia,2,1,3,6,04/06/2021,0,0,2,2,5,3,8,16,0,1,0,1,8,1,8,17,1,1,0,2
2576,168238,2021,Russia,USA,0,0,0,0,03/06/2021,0,0,0,0,0,0,0,0,0,0,0,0,0,0,0,0,0,0,0,0
2577,168238,2021,Russia,Japan,0,6,17,23,30/05/2021,0,0,0,0,16,5,7,28,1,3,3,7,14,1,21,36,5,0,2,7
2578,168238,2021,Iran,Russia,0,0,0,0,29/05/2021,0,0,0,0,0,0,0,0,0,0,0,0,0,0,0,0,0,0,0,0
2579,168238,2021,Netherlands,Russia,0,3,7,10,28/05/2021,0,0,1,1,5,0,7,12,0,2,4,6,5,2,13,20,4,1,1,6
2580,142651,2021,Brazil,Russia,1,2,4,7,23/06/2021,0,0,0,0,3,0,0,3,3,6,3,12,0,0,0,0,1,0,0,1
2581,142651,2021,Russia,Italy,0,0,0,0,22/06/2021,0,0,0,0,0,0,0,0,0,0,0,0,0,0,0,0,0,0,0,0
2582,142651,2021,Germany,Russia,1,4,4,9,21/06/2021,0,0,2,2,8,0,2,10,1,7,3,11,0,0,1,1,1,0,0,1
2583,142651,2021,Bulgaria,Russia,0,3,1,4,17/06/2021,0,0,0,0,6,0,1,7,2,2,2,6,0,0,2,2,1,0,0,1
2584,142651,2021,Argentina,Russia,0,0,0,0,16/06/2021,0,0,0,0,0,0,0,0,0,0,0,0,0,0,0,0,0,0,0,0
2585,142651,2021,Russia,Serbia,0,0,0,0,15/06/2021,0,0,0,0,0,0,0,0,0,0,0,0,0,0,0,0,0,0,0,0
2586,142651,2021,Slovenia,Russia,0,1,5,6,11/06/2021,0,0,0,0,1,1,5,7,2,5,2,9,0,0,0,0,2,0,1,3
2587,142651,2021,Russia,Canada,0,2,9,11,10/06/2021,0,0,1,1,4,0,6,10,6,4,2,12,0,0,0,0,0,1,0,1
2588,142651,2021,France,Russia,0,4,4,8,09/06/2021,0,0,0,0,6,2,3,11,2,9,8,19,0,0,2,2,2,0,1,3
2589,142651,2021,Russia,Poland,0,0,0,0,05/06/2021,0,0,0,0,0,0,0,0,0,0,0,0,0,0,0,0,0,0,0,0
2590,142651,2021,Russia,Australia,0,0,0,0,04/06/2021,0,0,0,0,0,0,0,0,0,0,0,0,0,0,0,0,0,0,0,0
2591,142651,2021,Russia,USA,0,3,6,9,03/06/2021,0,0,0,0,11,0,5,16,1,4,3,8,0,0,2,2,0,0,0,0
2592,142651,2021,Russia,Japan,0,0,0,0,30/05/2021,0,0,0,0,0,0,0,0,0,0,0,0,0,0,0,0,0,0,0,0
2593,142651,2021,Iran,Russia,0,2,5,7,29/05/2021,0,0,0,0,6,0,4,10,4,12,3,19,0,0,0,0,1,0,0,1
2594,142651,2021,Netherlands,Russia,0,2,6,8,28/05/2021,0,0,0,0,5,1,4,10,6,4,4,14,0,0,1,1,0,0,0,0
2595,119817,2021,Brazil,Russia,1,1,9,11,23/06/2021,0,0,0,0,3,0,3,6,2,0,2,4,1,0,0,1,0,0,1,1
2596,119817,2021,Russia,Italy,0,0,14,14,22/06/2021,0,0,0,0,5,1,2,8,0,1,3,4,0,0,0,0,0,0,0,0
2597,119817,2021,Germany,Russia,0,0,0,0,21/06/2021,0,0,0,0,0,0,0,0,0,0,0,0,0,0,0,0,0,0,0,0
2598,119817,2021,Bulgaria,Russia,0,2,2,4,17/06/2021,0,0,1,1,1,0,1,2,1,1,1,3,0,0,0,0,1,0,0,1
2599,119817,2021,Argentina,Russia,0,2,13,15,16/06/2021,0,0,1,1,7,2,1,10,2,7,6,15,0,0,1,1,0,0,1,1
2600,119817,2021,Russia,Serbia,0,0,12,12,15/06/2021,0,0,2,2,5,1,3,9,3,2,4,9,1,1,1,3,2,0,0,2
2601,119817,2021,Slovenia,Russia,0,1,13,14,11/06/2021,0,1,0,1,5,1,0,6,4,6,5,15,0,0,1,1,1,0,0,1
2602,119817,2021,Russia,Canada,1,3,15,19,10/06/2021,0,0,0,0,8,0,2,10,4,1,1,6,0,1,0,1,1,0,0,1
2603,119817,2021,France,Russia,0,0,0,0,09/06/2021,0,0,0,0,0,0,0,0,0,0,0,0,0,0,0,0,0,0,0,0
2604,119817,2021,Russia,Poland,0,1,8,9,05/06/2021,0,0,0,0,4,1,3,8,2,6,3,11,1,0,2,3,2,0,0,2
2605,119817,2021,Russia,Australia,0,1,14,15,04/06/2021,0,0,1,1,5,3,1,9,3,2,0,5,0,0,0,0,0,1,0,1
2606,119817,2021,Russia,USA,0,0,0,0,03/06/2021,0,0,0,0,0,0,0,0,0,0,0,0,0,0,0,0,0,0,0,0
2607,119817,2021,Russia,Japan,0,0,11,11,30/05/2021,0,0,0,0,7,1,3,11,4,7,5,16,0,0,1,1,1,0,1,2
2608,119817,2021,Iran,Russia,0,2,16,18,29/05/2021,0,0,0,0,7,0,1,8,3,4,6,13,0,0,0,0,1,0,0,1
2609,119817,2021,Netherlands,Russia,3,0,12,15,28/05/2021,0,0,0,0,10,1,1,12,0,9,2,11,0,0,0,0,1,1,0,2
2610,148521,2021,Brazil,Russia,0,0,0,0,23/06/2021,0,0,0,0,0,0,0,0,0,0,0,0,0,0,0,0,0,0,0,0
2611,148521,2021,Russia,Italy,0,0,0,0,22/06/2021,0,0,0,0,0,0,0,0,0,0,0,0,0,0,0,0,0,0,0,0
2612,148521,2021,Germany,Russia,0,0,0,0,21/06/2021,0,0,0,0,0,0,0,0,0,0,0,0,0,0,0,0,0,0,0,0
2613,148521,2021,Bulgaria,Russia,0,0,0,0,17/06/2021,0,0,0,0,0,0,0,0,0,0,0,0,0,0,0,0,0,0,1,1
2614,148521,2021,Argentina,Russia,0,0,0,0,16/06/2021,0,0,0,0,0,0,0,0,0,0,0,0,0,0,0,0,0,0,0,0
2615,148521,2021,Russia,Serbia,0,0,0,0,15/06/2021,0,0,0,0,0,0,0,0,0,0,0,0,0,0,0,0,0,0,0,0
2616,148521,2021,Slovenia,Russia,0,0,0,0,11/06/2021,0,0,3,3,0,0,0,0,0,0,0,0,7,2,13,22,7,1,0,8
2617,148521,2021,Russia,Canada,0,0,0,0,10/06/2021,0,0,1,1,0,0,0,0,0,0,0,0,6,1,13,20,7,6,0,13
2618,148521,2021,France,Russia,0,0,0,0,09/06/2021,0,0,2,2,0,0,0,0,0,0,0,0,3,2,18,23,8,1,2,11
2619,148521,2021,Russia,Poland,0,0,0,0,05/06/2021,0,0,0,0,0,0,0,0,0,0,0,0,0,0,0,0,0,0,0,0
2620,148521,2021,Russia,Australia,0,0,0,0,04/06/2021,0,0,1,1,0,0,0,0,0,0,0,0,6,1,2,9,2,1,0,3
2621,148521,2021,Russia,USA,0,0,0,0,03/06/2021,0,0,0,0,0,0,0,0,0,0,0,0,0,0,0,0,0,0,0,0
2622,148521,2021,Russia,Japan,0,0,0,0,30/05/2021,0,0,8,8,0,0,0,0,0,0,0,0,9,1,9,19,9,7,0,16
2623,148521,2021,Iran,Russia,0,0,0,0,29/05/2021,0,0,0,0,0,0,0,0,0,0,0,0,0,0,1,1,0,0,0,0
2624,148521,2021,Netherlands,Russia,0,0,0,0,28/05/2021,0,0,0,0,0,0,0,0,0,0,0,0,0,0,0,0,0,0,0,0
2625,142648,2021,Brazil,Russia,0,1,2,3,23/06/2021,0,0,0,0,0,0,0,0,0,0,0,0,0,0,0,0,0,0,0,0
2626,142648,2021,Russia,Italy,1,2,11,14,22/06/2021,0,0,2,2,13,7,10,30,2,4,1,7,4,1,23,28,6,4,1,11
2627,142648,2021,Germany,Russia,2,4,13,19,21/06/2021,0,0,1,1,11,2,4,17,1,3,3,7,6,0,17,23,6,2,0,8
2628,142648,2021,Bulgaria,Russia,1,3,5,9,17/06/2021,0,0,3,3,12,1,3,16,1,1,2,4,5,1,8,14,2,1,1,4
2629,142648,2021,Argentina,Russia,0,0,2,2,16/06/2021,0,0,0,0,0,0,0,0,0,0,0,0,0,0,0,0,0,0,1,1
2630,142648,2021,Russia,Serbia,0,1,3,4,15/06/2021,0,0,1,1,2,2,6,10,1,0,1,2,4,0,6,10,4,0,0,4
2631,142648,2021,Slovenia,Russia,2,4,14,20,11/06/2021,0,1,4,5,14,6,8,28,0,1,1,2,3,2,16,21,9,2,1,12
2632,142648,2021,Russia,Canada,2,4,15,21,10/06/2021,0,0,3,3,14,3,9,26,2,2,1,5,8,2,13,23,3,2,0,5
2633,142648,2021,France,Russia,0,1,6,7,09/06/2021,0,0,2,2,6,3,6,15,0,1,1,2,3,1,6,10,3,2,0,5
2634,142648,2021,Russia,Poland,1,5,8,14,05/06/2021,0,0,4,4,12,3,10,25,1,1,3,5,5,3,11,19,12,2,1,15
2635,142648,2021,Russia,Australia,2,4,8,14,04/06/2021,0,0,0,0,9,1,8,18,2,2,0,4,13,0,4,17,4,0,0,4
2636,142648,2021,Russia,Japan,0,0,0,0,30/05/2021,0,0,0,0,0,0,0,0,0,0,0,0,0,0,0,0,0,0,0,0
2637,142648,2021,Iran,Russia,0,0,0,0,29/05/2021,0,0,0,0,0,0,0,0,0,0,0,0,0,0,0,0,0,0,0,0
2638,142648,2021,Netherlands,Russia,0,0,0,0,28/05/2021,0,0,0,0,0,0,0,0,0,0,0,0,0,0,0,0,0,0,0,0
2639,142657,2021,Brazil,Russia,0,0,0,0,23/06/2021,0,0,0,0,0,0,0,0,0,0,0,0,0,0,0,0,0,0,0,0
2640,142657,2021,Germany,Russia,0,0,0,0,21/06/2021,0,0,0,0,0,0,0,0,0,0,0,0,0,0,0,0,0,0,0,0
2641,153362,2021,Brazil,Russia,0,2,0,2,23/06/2021,0,0,0,0,0,0,0,0,0,0,0,0,0,0,0,0,0,0,0,0
2642,153362,2021,Russia,Italy,0,3,6,9,22/06/2021,0,0,0,0,0,0,0,0,0,0,0,0,0,0,0,0,1,0,0,1
2643,153362,2021,Germany,Russia,0,1,2,3,21/06/2021,0,0,1,1,0,0,0,0,0,0,0,0,0,0,0,0,0,0,0,0
2644,153362,2021,Bulgaria,Russia,1,3,6,10,17/06/2021,0,0,6,6,6,1,5,12,2,4,0,6,3,3,7,13,7,1,1,9
2645,153362,2021,Argentina,Russia,0,0,5,5,16/06/2021,0,0,1,1,0,0,0,0,0,0,0,0,0,0,0,0,0,0,0,0
2646,153362,2021,Russia,Serbia,1,0,2,3,15/06/2021,0,0,0,0,0,0,0,0,0,0,0,0,0,0,0,0,0,0,0,0
2647,153362,2021,Slovenia,Russia,1,1,4,6,11/06/2021,0,0,2,2,2,0,3,5,1,0,0,1,4,1,6,11,2,0,0,2
2648,153362,2021,Russia,Canada,0,0,0,0,10/06/2021,0,0,0,0,0,0,0,0,0,0,0,0,0,0,0,0,0,0,0,0
2649,153362,2021,France,Russia,0,3,5,8,09/06/2021,0,0,3,3,6,1,5,12,2,3,2,7,6,1,11,18,1,1,0,2
2650,153362,2021,Russia,Poland,0,2,2,4,05/06/2021,0,0,4,4,3,3,2,8,0,2,2,4,3,1,7,11,1,0,0,1
2651,153362,2021,Russia,Australia,0,0,2,2,04/06/2021,0,0,0,0,1,0,1,2,0,1,0,1,4,0,0,4,1,1,0,2
2652,153362,2021,Russia,USA,0,1,1,2,03/06/2021,0,0,0,0,0,1,1,2,0,0,0,0,0,0,0,0,0,0,1,1
2653,153362,2021,Russia,Japan,0,1,9,10,30/05/2021,0,0,0,0,6,2,7,15,0,3,1,4,2,0,5,7,4,0,1,5
2654,153362,2021,Iran,Russia,1,3,13,17,29/05/2021,0,0,1,1,10,3,8,21,2,3,3,8,7,0,6,13,6,1,1,8
2655,153362,2021,Netherlands,Russia,2,2,4,8,28/05/2021,0,0,0,0,2,1,3,6,0,2,0,2,2,1,2,5,1,0,0,1
2656,136632,2021,Brazil,Russia,0,0,0,0,23/06/2021,0,0,0,0,0,0,0,0,0,0,0,0,0,0,0,0,0,0,0,0
2657,136632,2021,Russia,Italy,1,2,3,6,22/06/2021,16,0,43,59,0,0,0,0,1,2,4,7,0,0,0,0,2,0,1,3
2658,136632,2021,Germany,Russia,0,0,0,0,21/06/2021,0,0,0,0,0,0,0,0,0,0,0,0,0,0,0,0,0,0,0,0
2659,136632,2021,Bulgaria,Russia,0,0,2,2,17/06/2021,0,0,0,0,0,0,0,0,0,0,0,0,0,0,0,0,0,1,0,1
2660,136632,2021,Argentina,Russia,0,2,3,5,16/06/2021,7,1,20,28,1,0,0,1,1,1,1,3,0,0,0,0,4,1,0,5
2661,136632,2021,Russia,Serbia,0,2,3,5,15/06/2021,10,0,22,32,0,0,0,0,0,1,1,2,0,0,0,0,3,1,0,4
2662,136632,2021,Slovenia,Russia,0,0,2,2,11/06/2021,5,1,23,29,0,0,0,0,1,1,3,5,0,0,0,0,5,0,1,6
2663,136632,2021,Russia,Canada,0,0,0,0,10/06/2021,0,0,0,0,0,0,0,0,0,0,0,0,0,0,0,0,0,0,0,0
2664,136632,2021,France,Russia,0,3,5,8,09/06/2021,19,0,32,51,2,0,0,2,0,3,1,4,0,0,1,1,3,0,0,3
2665,136632,2021,Russia,Poland,1,1,5,7,05/06/2021,16,1,30,47,0,0,0,0,1,3,2,6,0,0,0,0,1,1,0,2
2666,136632,2021,Russia,Australia,0,0,0,0,04/06/2021,0,0,0,0,0,0,0,0,0,0,0,0,0,0,0,0,0,0,0,0
2667,136632,2021,Russia,USA,0,1,15,16,03/06/2021,28,0,61,89,2,0,0,2,1,4,2,7,0,0,0,0,4,6,2,12
2668,136632,2021,Russia,Japan,1,0,8,9,30/05/2021,22,0,46,68,0,0,1,1,4,2,3,9,0,0,0,0,3,1,2,6
2669,136632,2021,Iran,Russia,1,1,9,11,29/05/2021,14,0,1,15,0,0,0,0,0,0,0,0,0,0,0,0,2,1,1,4
2670,136632,2021,Netherlands,Russia,2,4,4,10,28/05/2021,17,0,20,37,0,0,0,0,0,2,0,2,0,0,1,1,1,2,0,3
2671,122265,2021,Bulgaria,Russia,0,0,0,0,17/06/2021,0,0,0,0,0,0,0,0,0,0,0,0,0,0,0,0,0,0,0,0
2672,122265,2021,Argentina,Russia,0,2,1,3,16/06/2021,0,0,3,3,8,2,3,13,2,1,2,5,0,0,0,0,4,2,1,7
2673,122265,2021,Russia,Serbia,0,0,0,0,15/06/2021,0,0,0,0,0,0,0,0,0,0,0,0,0,0,0,0,0,0,0,0
2674,122265,2021,France,Russia,1,1,4,6,09/06/2021,0,0,2,2,5,2,8,15,0,2,4,6,0,0,0,0,1,0,1,2
2675,122265,2021,Russia,Poland,2,6,6,14,05/06/2021,0,0,2,2,6,0,3,9,0,3,3,6,0,1,0,1,1,0,1,2
2676,122265,2021,Russia,Australia,0,4,6,10,04/06/2021,0,0,1,1,12,1,7,20,2,0,4,6,0,0,0,0,2,1,0,3
2677,122265,2021,Russia,USA,0,1,2,3,03/06/2021,0,0,0,0,1,0,1,2,1,1,0,2,0,0,0,0,1,0,0,1
2678,142635,2021,Brazil,Russia,0,0,0,0,23/06/2021,0,0,0,0,0,0,0,0,0,0,0,0,0,0,0,0,0,0,0,0
2679,142635,2021,Russia,Italy,1,1,13,15,22/06/2021,0,0,1,1,14,5,5,24,0,4,1,5,0,0,0,0,1,0,1,2
2680,142635,2021,Germany,Russia,0,0,0,0,21/06/2021,0,0,0,0,0,0,0,0,0,0,0,0,0,0,0,0,0,0,0,0
2681,142635,2021,Bulgaria,Russia,0,3,9,12,17/06/2021,0,0,1,1,12,3,8,23,1,0,2,3,0,0,1,1,2,0,0,2
2682,142635,2021,Argentina,Russia,1,1,7,9,16/06/2021,0,0,0,0,3,1,8,12,1,0,0,1,0,0,0,0,1,0,1,2
2683,142635,2021,Russia,Serbia,0,0,2,2,15/06/2021,0,0,0,0,0,0,0,0,0,0,0,0,0,0,0,0,0,0,0,0
2684,142635,2021,Slovenia,Russia,0,2,8,10,11/06/2021,0,0,0,0,6,2,5,13,0,4,2,6,0,0,0,0,2,0,0,2
2685,142635,2021,Russia,Canada,0,0,0,0,10/06/2021,0,0,0,0,0,0,0,0,0,0,0,0,0,0,0,0,0,0,0,0
2686,142635,2021,France,Russia,0,3,7,10,09/06/2021,0,0,0,0,5,1,3,9,0,1,3,4,0,0,0,0,1,0,0,1
2687,142635,2021,Russia,Poland,0,1,0,1,05/06/2021,0,0,0,0,0,0,0,0,0,0,0,0,0,0,0,0,0,0,0,0
2688,142635,2021,Russia,Australia,0,5,8,13,04/06/2021,0,0,0,0,14,4,6,24,0,4,2,6,0,0,0,0,2,2,0,4
2689,142635,2021,Russia,USA,0,1,4,5,03/06/2021,0,0,0,0,0,0,0,0,0,0,0,0,0,0,0,0,0,0,0,0
2690,142635,2021,Russia,Japan,1,0,6,7,30/05/2021,0,0,0,0,0,0,0,0,0,0,0,0,0,0,0,0,1,0,0,1
2691,142635,2021,Iran,Russia,0,3,0,3,29/05/2021,0,0,0,0,2,0,0,2,0,0,0,0,0,0,0,0,0,0,0,0
2692,142635,2021,Netherlands,Russia,0,0,3,3,28/05/2021,0,0,0,0,0,0,0,0,0,0,0,0,0,0,0,0,0,0,0,0
2693,117184,2021,Brazil,Russia,2,3,10,15,23/06/2021,0,0,2,2,11,1,4,16,1,2,0,3,0,0,1,1,6,0,1,7
2694,117184,2021,Russia,Italy,0,2,4,6,22/06/2021,0,0,0,0,5,2,2,9,2,3,2,7,0,0,0,0,2,1,0,3
2695,117184,2021,Germany,Russia,1,2,9,12,21/06/2021,0,0,2,2,17,4,11,32,0,0,5,5,0,0,1,1,7,1,1,9
2696,117184,2021,Bulgaria,Russia,0,0,0,0,17/06/2021,0,0,0,0,0,0,0,0,0,0,0,0,0,0,0,0,0,0,0,0
2697,117184,2021,Argentina,Russia,0,2,1,3,16/06/2021,0,0,0,0,1,0,4,5,2,2,1,5,0,0,0,0,0,0,0,0
2698,117184,2021,Russia,Serbia,0,3,9,12,15/06/2021,0,0,1,1,20,5,14,39,3,6,1,10,0,0,7,7,6,2,0,8
2699,117184,2021,Slovenia,Russia,2,3,6,11,11/06/2021,0,0,2,2,7,3,9,19,1,3,1,5,0,0,0,0,5,1,0,6
2700,117184,2021,Russia,Canada,2,3,18,23,10/06/2021,0,1,3,4,19,3,10,32,1,1,1,3,1,0,0,1,4,2,0,6
2701,117184,2021,France,Russia,0,2,5,7,09/06/2021,0,0,0,0,2,3,2,7,0,0,0,0,0,0,1,1,0,0,0,0
2702,117184,2021,Russia,Poland,2,2,15,19,05/06/2021,0,0,2,2,16,8,8,32,0,1,1,2,1,0,0,1,7,1,1,9
2703,117184,2021,Russia,USA,1,3,18,22,03/06/2021,0,1,2,3,13,2,15,30,1,2,2,5,0,0,1,1,7,0,0,7
2704,117184,2021,Russia,Japan,2,3,16,21,30/05/2021,0,0,0,0,20,4,14,38,1,6,2,9,1,0,4,5,8,2,1,11
2705,117184,2021,Iran,Russia,2,4,7,13,29/05/2021,0,0,0,0,19,3,10,32,1,2,3,6,1,0,0,1,5,1,1,7
2706,117184,2021,Netherlands,Russia,3,2,17,22,28/05/2021,0,0,0,0,17,7,8,32,4,1,1,6,1,0,1,2,7,1,0,8
2707,152885,2021,Brazil,Russia,1,0,8,9,23/06/2021,0,0,2,2,11,3,5,19,1,3,0,4,4,0,14,18,2,1,0,3
2708,152885,2021,Russia,Italy,1,4,14,19,22/06/2021,0,0,4,4,11,2,12,25,1,4,0,5,11,6,22,39,6,0,1,7
2709,152885,2021,Germany,Russia,2,2,15,19,21/06/2021,1,0,2,3,11,6,9,26,1,1,2,4,3,0,14,17,5,0,0,5
2710,152885,2021,Bulgaria,Russia,0,0,0,0,17/06/2021,0,0,0,0,0,0,0,0,0,0,0,0,0,0,0,0,0,0,0,0
2711,152885,2021,Argentina,Russia,0,6,10,16,16/06/2021,0,0,6,6,14,3,14,31,1,4,1,6,10,0,16,26,4,1,0,5
2712,152885,2021,Russia,Serbia,2,3,16,21,15/06/2021,0,0,7,7,9,3,15,27,2,1,0,3,13,2,11,26,5,1,0,6
2713,152885,2021,Slovenia,Russia,0,3,7,10,11/06/2021,0,0,4,4,7,3,14,24,4,3,2,9,4,1,20,25,2,2,0,4
2714,152885,2021,Russia,Canada,0,2,4,6,10/06/2021,0,0,1,1,4,1,6,11,0,0,0,0,3,3,2,8,2,0,0,2
2715,152885,2021,France,Russia,1,2,15,18,09/06/2021,0,0,4,4,14,3,10,27,0,5,0,5,8,3,16,27,9,2,0,11
2716,152885,2021,Russia,Poland,0,1,3,4,05/06/2021,0,0,1,1,4,4,4,12,0,1,2,3,2,2,6,10,1,1,0,2
2717,152885,2021,Russia,USA,0,3,10,13,03/06/2021,0,0,3,3,17,3,8,28,0,5,0,5,6,0,12,18,12,1,2,15
2718,152885,2021,Russia,Japan,3,4,5,12,30/05/2021,0,0,0,0,9,4,9,22,2,1,2,5,10,1,14,25,1,0,0,1
2719,152885,2021,Iran,Russia,0,0,13,13,29/05/2021,0,0,0,0,10,1,5,16,0,5,3,8,4,2,16,22,3,0,3,6
2720,152885,2021,Netherlands,Russia,0,4,8,12,28/05/2021,0,0,3,3,11,1,8,20,0,4,2,6,7,2,12,21,7,3,1,11
2721,143711,2021,Brazil,Russia,0,0,2,2,23/06/2021,0,0,1,1,1,1,1,3,0,0,1,1,0,0,0,0,0,0,0,0
2722,143711,2021,Russia,Italy,1,1,5,7,22/06/2021,0,0,0,0,8,1,0,9,3,2,4,9,0,0,0,0,1,1,0,2
2723,143711,2021,Germany,Russia,0,3,3,6,21/06/2021,0,0,2,2,9,0,2,11,4,3,6,13,1,0,1,2,0,0,0,0
2724,143711,2021,Bulgaria,Russia,0,3,5,8,17/06/2021,0,0,0,0,6,0,1,7,0,3,2,5,0,0,0,0,0,1,0,1
2725,143711,2021,Argentina,Russia,0,2,6,8,16/06/2021,0,0,0,0,7,0,4,11,1,4,6,11,0,0,1,1,2,0,0,2
2726,143711,2021,Russia,Serbia,2,4,6,12,15/06/2021,0,0,2,2,5,2,4,11,4,6,3,13,0,0,0,0,2,1,0,3
2727,143711,2021,Slovenia,Russia,0,1,4,5,11/06/2021,0,0,0,0,5,1,2,8,1,2,1,4,0,0,0,0,0,1,0,1
2728,143711,2021,Russia,Canada,0,0,0,0,10/06/2021,0,0,0,0,0,0,0,0,0,0,0,0,0,0,0,0,0,0,0,0
2729,143711,2021,France,Russia,0,3,10,13,09/06/2021,0,0,0,0,8,0,4,12,1,5,2,8,0,0,1,1,3,0,0,3
2730,143711,2021,Russia,Poland,0,0,0,0,05/06/2021,0,0,0,0,0,0,0,0,0,0,0,0,0,0,0,0,0,0,0,0
2731,143711,2021,Russia,Australia,0,0,0,0,04/06/2021,0,0,0,0,0,0,0,0,0,0,0,0,0,0,0,0,0,0,0,0
2732,143711,2021,Russia,USA,1,1,4,6,03/06/2021,0,0,2,2,3,0,3,6,1,2,1,4,0,0,0,0,1,0,0,1
2733,143711,2021,Russia,Japan,0,2,11,13,30/05/2021,0,0,0,0,6,2,1,9,6,6,3,15,0,0,0,0,3,2,1,6
2734,143711,2021,Iran,Russia,0,0,1,1,29/05/2021,0,0,0,0,1,0,0,1,0,1,0,1,0,0,1,1,0,0,0,0
2735,143711,2021,Netherlands,Russia,0,0,0,0,28/05/2021,0,0,0,0,0,0,0,0,0,0,0,0,0,0,0,0,0,0,0,0
2736,124794,2021,Brazil,Russia,2,3,8,13,23/06/2021,21,2,38,61,1,0,2,3,0,2,2,4,0,0,0,0,2,1,0,3
2737,124794,2021,Russia,Italy,0,2,3,5,22/06/2021,12,0,20,32,0,0,0,0,0,5,0,5,0,0,0,0,0,0,0,0
2738,124794,2021,Germany,Russia,1,2,18,21,21/06/2021,27,1,53,81,2,0,1,3,2,3,3,8,0,0,0,0,8,2,1,11
2739,124794,2021,Bulgaria,Russia,4,4,13,21,17/06/2021,16,0,37,53,2,0,0,2,0,1,2,3,0,0,1,1,7,1,0,8
2740,124794,2021,Argentina,Russia,1,3,9,13,16/06/2021,21,0,32,53,1,0,2,3,2,1,0,3,0,0,0,0,7,0,0,7
2741,124794,2021,Russia,Serbia,2,0,14,16,15/06/2021,14,2,45,61,0,0,3,3,1,4,1,6,0,0,1,1,8,2,0,10
2742,124794,2021,Slovenia,Russia,2,0,16,18,11/06/2021,20,0,44,64,0,0,0,0,0,5,3,8,0,0,0,0,3,2,4,9
2743,124794,2021,Russia,Canada,1,3,7,11,10/06/2021,14,2,73,89,0,0,0,0,2,3,2,7,0,0,2,2,3,1,0,4
2744,124794,2021,France,Russia,0,1,2,3,09/06/2021,14,0,26,40,0,0,0,0,0,3,1,4,0,0,0,0,1,1,0,2
2745,124794,2021,Russia,Poland,0,1,4,5,05/06/2021,8,1,23,32,0,0,0,0,0,1,2,3,0,0,1,1,3,0,1,4
2746,124794,2021,Russia,Australia,0,3,12,15,04/06/2021,18,0,62,80,0,0,1,1,0,2,3,5,0,0,0,0,1,0,0,1
2747,124794,2021,Russia,USA,0,0,0,0,03/06/2021,0,0,0,0,0,0,0,0,0,0,0,0,0,0,0,0,0,0,0,0
2748,124794,2021,Russia,Japan,0,2,5,7,30/05/2021,20,0,27,47,1,1,0,2,0,3,0,3,0,0,0,0,2,2,0,4
2749,124794,2021,Iran,Russia,0,3,6,9,29/05/2021,23,0,0,23,2,1,0,3,0,1,2,3,0,0,0,0,4,0,2,6
2750,124794,2021,Netherlands,Russia,0,1,3,4,28/05/2021,21,0,23,44,1,0,1,2,0,0,1,1,0,0,0,0,2,1,0,3
2751,132391,2021,Brazil,Russia,0,0,0,0,23/06/2021,0,0,5,5,0,0,0,0,0,0,0,0,5,2,16,23,5,6,0,11
2752,132391,2021,Russia,Italy,0,0,0,0,22/06/2021,0,0,6,6,0,0,0,0,0,0,0,0,6,1,11,18,11,3,1,15
2753,132391,2021,Germany,Russia,0,0,0,0,21/06/2021,0,0,6,6,0,0,0,0,0,0,0,0,6,0,11,17,10,4,0,14
2754,132391,2021,Bulgaria,Russia,0,0,0,0,17/06/2021,0,0,5,5,0,0,0,0,0,0,0,0,5,1,10,16,10,2,0,12
2755,132391,2021,Argentina,Russia,0,0,0,0,16/06/2021,0,0,3,3,0,0,0,0,0,0,0,0,7,1,13,21,6,3,1,10
2756,132391,2021,Russia,Serbia,0,0,0,0,15/06/2021,0,0,7,7,0,0,0,0,0,0,0,0,6,0,12,18,9,3,0,12
2757,132391,2021,Slovenia,Russia,0,0,0,0,11/06/2021,0,0,0,0,0,0,0,0,0,0,0,0,0,0,0,0,0,0,0,0
2758,132391,2021,Russia,Canada,0,0,0,0,10/06/2021,0,0,0,0,0,0,0,0,0,0,0,0,0,0,0,0,0,0,0,0
2759,132391,2021,France,Russia,0,0,0,0,09/06/2021,0,0,0,0,0,0,0,0,0,0,0,0,0,0,0,0,0,0,0,0
2760,132391,2021,Russia,Poland,0,0,0,0,05/06/2021,0,0,1,1,0,0,0,0,0,0,0,0,6,4,16,26,6,3,1,10
2761,132391,2021,Russia,Australia,0,0,0,0,04/06/2021,0,0,2,2,0,0,0,0,0,0,0,0,3,0,7,10,4,3,0,7
2762,132391,2021,Russia,USA,0,0,0,0,03/06/2021,0,0,5,5,0,0,0,0,0,0,0,0,9,2,17,28,7,1,1,9
2763,132391,2021,Russia,Japan,0,0,0,0,30/05/2021,0,0,0,0,0,0,0,0,0,0,0,0,0,0,0,0,0,0,0,0
2764,132391,2021,Iran,Russia,0,0,0,0,29/05/2021,0,0,0,0,0,0,0,0,0,0,0,0,8,1,12,21,17,2,0,19
2765,132391,2021,Netherlands,Russia,0,0,0,0,28/05/2021,0,0,3,3,0,0,0,0,0,0,0,0,5,1,13,19,8,7,0,15
2766,124926,2021,Argentina,Serbia,0,1,4,5,17/06/2021,0,0,1,1,3,4,3,10,0,0,0,0,1,0,7,8,1,0,0,1
2767,124926,2021,Serbia,Bulgaria,2,2,8,12,16/06/2021,0,0,2,2,6,3,2,11,1,2,3,6,2,1,10,13,0,0,0,0
2768,124926,2021,Russia,Serbia,2,4,11,17,15/06/2021,0,0,3,3,15,9,7,31,1,5,4,10,12,2,30,44,6,1,1,8
2769,124926,2021,USA,Serbia,0,3,7,10,11/06/2021,0,0,0,0,20,5,8,33,2,2,2,6,8,2,18,28,1,5,0,6
2770,124926,2021,Serbia,Iran,1,6,7,14,10/06/2021,0,0,3,3,18,4,13,35,1,4,1,6,9,1,19,29,5,2,1,8
2771,124926,2021,Serbia,Germany,1,2,15,18,09/06/2021,0,0,5,5,9,1,11,21,1,5,0,6,3,1,11,15,6,2,1,9
2772,124926,2021,Brazil,Serbia,0,4,11,15,05/06/2021,0,0,5,5,10,5,11,26,1,5,2,8,10,2,24,36,5,3,1,9
2773,124926,2021,Serbia,France,1,5,11,17,04/06/2021,0,0,1,1,8,5,11,24,2,2,5,9,8,5,15,28,7,1,0,8
2774,124926,2021,Japan,Serbia,0,0,16,16,03/06/2021,0,0,3,3,19,1,11,31,3,1,1,5,11,0,14,25,2,5,1,8
2775,124926,2021,Serbia,Slovenia,0,4,13,17,28/05/2021,0,0,3,3,18,7,9,34,4,2,0,6,5,1,13,19,6,3,1,10
2776,136360,2021,Canada,Serbia,0,0,0,0,23/06/2021,0,0,2,2,0,0,0,0,0,0,0,0,0,0,0,0,4,2,1,7
2777,136360,2021,Serbia,Netherlands,0,0,0,0,22/06/2021,0,0,2,2,0,0,0,0,0,0,0,0,0,0,0,0,2,4,1,7
2778,136360,2021,Australia,Serbia,0,0,0,0,21/06/2021,0,0,1,1,0,0,0,0,0,0,0,0,0,0,0,0,7,1,1,9
2779,136360,2021,Argentina,Serbia,0,0,0,0,17/06/2021,0,0,0,0,0,0,0,0,0,0,0,0,0,0,0,0,0,0,0,0
2780,136360,2021,Serbia,Bulgaria,0,0,0,0,16/06/2021,0,0,0,0,0,0,0,0,0,0,0,0,0,0,0,0,0,0,0,0
2781,136360,2021,Russia,Serbia,0,0,0,0,15/06/2021,0,0,1,1,0,0,0,0,0,0,0,0,0,0,0,0,0,1,0,1
2782,136360,2021,USA,Serbia,0,0,0,0,11/06/2021,0,0,1,1,0,0,0,0,0,0,0,0,0,0,0,0,1,3,0,4
2783,136360,2021,Serbia,Iran,0,0,0,0,10/06/2021,0,0,0,0,0,0,0,0,0,0,0,0,0,0,0,0,0,0,0,0
2784,136360,2021,Serbia,Germany,0,0,0,0,09/06/2021,0,0,0,0,0,0,0,0,0,0,0,0,0,0,0,0,4,0,1,5
2785,136360,2021,Brazil,Serbia,0,0,0,0,05/06/2021,0,0,0,0,0,0,0,0,0,0,0,0,0,0,0,0,0,0,0,0
2786,136360,2021,Serbia,France,0,0,0,0,04/06/2021,0,0,0,0,0,0,0,0,0,0,0,0,0,0,0,0,0,0,0,0
2787,136360,2021,Japan,Serbia,0,0,0,0,03/06/2021,0,0,0,0,0,0,0,0,0,0,0,0,0,0,0,0,0,0,0,0
2788,136360,2021,Serbia,Italy,0,0,0,0,30/05/2021,0,0,0,0,0,0,0,0,0,0,0,0,0,0,0,0,0,0,0,0
2789,136360,2021,Poland,Serbia,0,0,0,0,29/05/2021,0,0,0,0,0,0,0,0,0,0,0,0,0,0,0,0,0,0,0,0
2790,136360,2021,Serbia,Slovenia,0,0,0,0,28/05/2021,0,0,0,0,0,0,0,0,0,0,0,0,0,0,0,0,0,0,0,0
2791,150383,2021,Canada,Serbia,0,0,0,0,23/06/2021,0,0,10,10,0,0,0,0,0,0,0,0,8,0,18,26,8,0,1,9
2792,150383,2021,Serbia,Netherlands,0,0,0,0,22/06/2021,0,0,2,2,0,0,0,0,0,0,0,0,6,1,11,18,7,2,0,9
2793,150383,2021,Australia,Serbia,0,0,0,0,21/06/2021,0,0,1,1,0,0,0,0,0,0,0,0,8,3,5,16,0,0,0,0
2794,150383,2021,Argentina,Serbia,0,0,0,0,17/06/2021,0,0,4,4,0,0,0,0,0,0,0,0,5,1,15,21,6,5,2,13
2795,150383,2021,Serbia,Bulgaria,0,0,0,0,16/06/2021,0,0,1,1,0,0,0,0,0,0,0,0,4,1,12,17,5,0,0,5
2796,150383,2021,Russia,Serbia,0,0,0,0,15/06/2021,0,0,1,1,0,0,0,0,0,0,0,0,3,3,10,16,3,3,2,8
2797,150383,2021,USA,Serbia,0,0,0,0,11/06/2021,0,0,4,4,0,0,0,0,0,0,0,0,2,2,19,23,2,3,1,6
2798,150383,2021,Serbia,Iran,0,0,0,0,10/06/2021,0,0,9,9,0,0,0,0,0,0,0,0,10,1,16,27,5,8,0,13
2799,150383,2021,Serbia,Germany,0,0,0,0,09/06/2021,0,0,2,2,0,0,0,0,0,0,0,0,3,1,16,20,1,1,0,2
2800,150383,2021,Brazil,Serbia,0,0,0,0,05/06/2021,0,0,5,5,0,0,0,0,0,0,0,0,3,0,14,17,11,3,0,14
2801,150383,2021,Serbia,France,0,0,0,0,04/06/2021,0,0,6,6,0,0,0,0,0,0,0,0,15,3,13,31,4,1,0,5
2802,150383,2021,Japan,Serbia,0,0,0,0,03/06/2021,0,0,2,2,0,0,0,0,0,0,0,0,3,0,7,10,3,7,0,10
2803,150383,2021,Serbia,Italy,0,0,0,0,30/05/2021,0,1,10,11,0,0,0,0,0,0,0,0,9,0,6,15,11,2,0,13
2804,150383,2021,Poland,Serbia,0,0,0,0,29/05/2021,0,0,4,4,0,0,0,0,0,0,0,0,8,6,10,24,10,3,2,15
2805,150383,2021,Serbia,Slovenia,0,0,0,0,28/05/2021,0,0,3,3,0,0,0,0,0,0,0,0,6,2,11,19,3,0,0,3
2806,146579,2021,Canada,Serbia,0,5,13,18,23/06/2021,0,0,1,1,10,2,4,16,4,6,9,19,2,0,2,4,5,0,1,6
2807,146579,2021,Serbia,Netherlands,3,1,16,20,22/06/2021,0,1,1,2,8,0,4,12,1,6,7,14,0,1,0,1,3,1,1,5
2808,146579,2021,Australia,Serbia,3,3,8,14,21/06/2021,0,0,2,2,5,1,1,7,7,1,2,10,0,0,0,0,2,1,0,3
2809,146579,2021,Argentina,Serbia,0,0,9,9,17/06/2021,0,0,2,2,4,2,1,7,3,1,4,8,0,0,0,0,0,1,0,1
2810,146579,2021,Serbia,Bulgaria,2,1,13,16,16/06/2021,0,0,3,3,7,0,0,7,0,3,2,5,1,0,0,1,2,0,0,2
2811,146579,2021,Russia,Serbia,0,0,15,15,15/06/2021,0,0,4,4,9,0,2,11,2,5,3,10,1,0,0,1,2,0,0,2
2812,146579,2021,USA,Serbia,0,1,16,17,11/06/2021,0,0,1,1,7,1,2,10,2,5,1,8,0,0,0,0,1,2,0,3
2813,146579,2021,Serbia,Iran,1,4,22,27,10/06/2021,0,0,5,5,9,3,3,15,1,3,2,6,1,0,1,2,6,2,0,8
2814,146579,2021,Serbia,Germany,1,2,13,16,09/06/2021,0,0,1,1,6,0,2,8,2,3,8,13,0,0,1,1,1,1,2,4
2815,146579,2021,Brazil,Serbia,0,1,12,13,05/06/2021,0,0,0,0,11,3,3,17,1,5,3,9,1,0,0,1,5,2,0,7
2816,146579,2021,Serbia,France,0,3,13,16,04/06/2021,0,0,2,2,10,0,2,12,3,12,8,23,0,0,0,0,4,1,0,5
2817,146579,2021,Japan,Serbia,0,2,14,16,03/06/2021,0,0,1,1,10,2,4,16,4,5,1,10,0,0,1,1,1,0,0,1
2818,146579,2021,Serbia,Italy,0,3,10,13,30/05/2021,0,0,0,0,3,1,2,6,0,3,1,4,0,0,0,0,1,0,0,1
2819,146579,2021,Poland,Serbia,0,3,13,16,29/05/2021,0,0,0,0,4,4,0,8,1,2,0,3,1,0,0,1,4,0,0,4
2820,146579,2021,Serbia,Slovenia,0,2,11,13,28/05/2021,0,0,0,0,3,2,2,7,1,3,1,5,2,0,3,5,2,1,0,3
2821,132022,2021,Canada,Serbia,5,5,19,29,23/06/2021,1,1,7,9,13,4,16,33,2,3,5,10,10,0,16,26,11,2,1,14
2822,132022,2021,Serbia,Netherlands,1,4,12,17,22/06/2021,0,0,10,10,11,1,5,17,0,2,0,2,11,2,20,33,2,1,0,3
2823,132022,2021,Australia,Serbia,2,0,8,10,21/06/2021,0,0,0,0,9,1,7,17,1,0,0,1,4,0,1,5,2,1,0,3
2824,132022,2021,Argentina,Serbia,0,1,10,11,17/06/2021,0,0,2,2,11,3,9,23,1,3,1,5,4,1,13,18,2,0,0,2
2825,132022,2021,Serbia,Bulgaria,3,1,15,19,16/06/2021,0,0,2,2,9,2,3,14,1,1,2,4,2,1,8,11,6,0,0,6
2826,132022,2021,Russia,Serbia,0,4,10,14,15/06/2021,0,0,5,5,14,4,10,28,1,4,2,7,4,1,13,18,5,3,2,10
2827,132022,2021,USA,Serbia,3,2,15,20,11/06/2021,0,0,2,2,9,0,7,16,2,3,1,6,9,2,3,14,6,4,1,11
2828,132022,2021,Serbia,Iran,2,0,11,13,10/06/2021,0,0,1,1,4,1,4,9,0,1,1,2,4,2,4,10,2,5,0,7
2829,132022,2021,Serbia,Germany,0,1,0,1,09/06/2021,0,0,1,1,0,1,3,4,0,0,0,0,2,2,4,8,4,0,0,4
2830,132022,2021,Brazil,Serbia,2,2,9,13,05/06/2021,0,0,1,1,12,4,8,24,0,2,1,3,14,1,9,24,7,1,3,11
2831,132022,2021,Serbia,France,0,3,13,16,04/06/2021,0,0,5,5,15,4,7,26,0,4,3,7,14,1,11,26,6,4,0,10
2832,132022,2021,Japan,Serbia,1,4,10,15,03/06/2021,0,0,4,4,11,3,2,16,2,4,1,7,20,2,14,36,4,2,0,6
2833,132022,2021,Serbia,Italy,0,3,9,12,30/05/2021,0,0,0,0,17,3,17,37,0,1,5,6,6,1,14,21,7,2,0,9
2834,132022,2021,Poland,Serbia,1,3,10,14,29/05/2021,0,0,0,0,12,1,4,17,0,3,0,3,6,6,12,24,6,1,0,7
2835,132022,2021,Serbia,Slovenia,0,2,17,19,28/05/2021,0,0,1,1,11,3,9,23,2,4,0,6,13,1,19,33,5,1,1,7
2836,124911,2021,Canada,Serbia,0,0,0,0,23/06/2021,0,0,0,0,0,0,0,0,0,0,0,0,0,0,0,0,0,0,0,0
2837,124911,2021,Serbia,Netherlands,0,2,8,10,22/06/2021,22,1,44,67,0,0,0,0,0,2,2,4,0,0,0,0,2,2,1,5
2838,124911,2021,Australia,Serbia,0,0,2,2,21/06/2021,2,0,11,13,0,0,0,0,0,1,0,1,0,0,0,0,1,0,0,1
2839,124911,2021,Argentina,Serbia,0,1,6,7,17/06/2021,20,0,43,63,0,0,0,0,0,0,1,1,0,0,0,0,4,2,1,7
2840,124911,2021,Serbia,Bulgaria,0,0,7,7,16/06/2021,21,1,29,51,0,0,1,1,0,0,1,1,0,0,0,0,4,3,1,8
2841,124911,2021,Russia,Serbia,1,1,13,15,15/06/2021,20,0,66,86,1,0,2,3,0,2,3,5,0,1,0,1,10,3,6,19
2842,124911,2021,USA,Serbia,0,0,16,16,11/06/2021,19,0,60,79,0,0,0,0,1,1,0,2,0,0,2,2,4,3,0,7
2843,124911,2021,Serbia,Iran,0,0,9,9,10/06/2021,34,0,55,89,0,0,0,0,0,1,2,3,0,0,0,0,8,3,1,12
2844,124911,2021,Serbia,Germany,0,0,1,1,09/06/2021,5,1,3,9,0,0,1,1,0,0,0,0,0,0,0,0,2,0,1,3
2845,124911,2021,Brazil,Serbia,0,1,10,11,05/06/2021,26,0,39,65,0,0,0,0,1,1,0,2,0,0,0,0,2,2,0,4
2846,124911,2021,Serbia,France,0,1,16,17,04/06/2021,23,1,59,83,0,0,0,0,1,6,0,7,0,0,0,0,6,2,1,9
2847,124911,2021,Japan,Serbia,0,0,18,18,03/06/2021,34,0,48,82,2,0,0,2,2,2,0,4,0,0,1,1,5,2,0,7
2848,124911,2021,Serbia,Italy,1,2,13,16,30/05/2021,26,1,77,104,1,0,1,2,1,1,6,8,0,0,1,1,10,3,1,14
2849,124911,2021,Poland,Serbia,0,2,9,11,29/05/2021,27,0,58,85,1,1,1,3,0,3,0,3,0,0,0,0,4,1,0,5
2850,124911,2021,Serbia,Slovenia,0,3,14,17,28/05/2021,36,0,71,107,0,0,0,0,2,2,0,4,0,0,1,1,11,3,0,14
2851,162122,2021,Canada,Serbia,2,1,15,18,23/06/2021,0,0,3,3,13,6,15,34,0,1,4,5,9,1,21,31,14,1,1,16
2852,162122,2021,Serbia,Netherlands,0,3,8,11,22/06/2021,0,0,0,0,10,1,7,18,2,4,2,8,8,0,10,18,1,2,1,4
2853,162122,2021,Australia,Serbia,0,1,2,3,21/06/2021,0,0,0,0,2,0,3,5,0,1,0,1,3,2,4,9,0,1,0,1
2854,162122,2021,Argentina,Serbia,0,0,0,0,17/06/2021,0,0,0,0,0,0,0,0,0,0,0,0,0,0,0,0,0,0,0,0
2855,162122,2021,Serbia,Bulgaria,0,0,0,0,16/06/2021,0,0,0,0,0,0,0,0,0,0,0,0,0,0,0,0,0,0,0,0
2856,162122,2021,Russia,Serbia,0,0,0,0,15/06/2021,0,0,0,0,0,0,0,0,0,0,0,0,0,0,0,0,0,0,0,0
2857,162122,2021,USA,Serbia,0,0,0,0,11/06/2021,0,0,0,0,0,0,0,0,0,0,0,0,0,0,0,0,0,0,0,0
2858,162122,2021,Serbia,Iran,0,0,0,0,10/06/2021,0,0,0,0,0,0,0,0,0,0,0,0,0,0,0,0,0,0,0,0
2859,162122,2021,Serbia,Germany,0,0,0,0,09/06/2021,0,0,0,0,0,0,0,0,0,0,0,0,0,0,0,0,0,0,0,0
2860,162122,2021,Brazil,Serbia,0,0,0,0,05/06/2021,0,0,0,0,0,0,0,0,0,0,0,0,0,0,0,0,0,0,0,0
2861,162122,2021,Serbia,France,0,0,0,0,04/06/2021,0,0,0,0,0,0,0,0,0,0,0,0,0,0,0,0,0,0,0,0
2862,162122,2021,Japan,Serbia,0,0,0,0,03/06/2021,0,0,0,0,0,0,0,0,0,0,0,0,0,0,0,0,0,0,0,0
2863,162122,2021,Serbia,Italy,0,0,0,0,30/05/2021,0,0,0,0,0,0,0,0,0,0,0,0,0,0,0,0,0,0,0,0
2864,162122,2021,Poland,Serbia,0,1,0,1,29/05/2021,0,0,0,0,1,1,3,5,0,0,0,0,1,2,1,4,3,1,0,4
2865,173249,2021,Canada,Serbia,0,0,0,0,23/06/2021,0,0,0,0,0,0,0,0,0,0,0,0,0,0,0,0,0,0,0,0
2866,173249,2021,Serbia,Netherlands,0,0,0,0,22/06/2021,0,0,0,0,0,0,0,0,0,0,0,0,0,0,0,0,0,0,0,0
2867,173249,2021,Australia,Serbia,0,0,0,0,21/06/2021,0,0,0,0,0,0,0,0,0,0,0,0,0,0,0,0,0,0,0,0
2868,173249,2021,Poland,Serbia,0,0,0,0,29/05/2021,0,0,0,0,0,0,0,0,0,0,0,0,0,0,0,0,0,0,0,0
2869,173249,2021,Serbia,Slovenia,0,0,0,0,28/05/2021,1,0,1,2,0,0,0,0,0,0,0,0,0,0,0,0,0,0,0,0
2870,173251,2021,Canada,Serbia,0,0,0,0,23/06/2021,0,0,0,0,0,0,0,0,0,0,0,0,0,0,0,0,0,0,0,0
2871,173251,2021,Serbia,Netherlands,0,3,4,7,22/06/2021,0,0,0,0,6,2,2,10,1,0,1,2,1,2,9,12,2,1,1,4
2872,173251,2021,Australia,Serbia,0,3,6,9,21/06/2021,0,0,1,1,7,2,7,16,0,0,2,2,8,0,8,16,3,0,1,4
2873,173251,2021,Argentina,Serbia,1,2,4,7,17/06/2021,0,0,0,0,2,2,3,7,1,0,1,2,2,1,12,15,0,0,1,1
2874,173251,2021,Serbia,Bulgaria,0,0,0,0,16/06/2021,0,0,0,0,0,0,0,0,0,0,0,0,0,0,0,0,0,0,0,0
2875,173251,2021,Russia,Serbia,0,0,0,0,15/06/2021,0,0,0,0,0,0,0,0,0,0,0,0,0,0,0,0,0,0,0,0
2876,173251,2021,USA,Serbia,0,0,0,0,11/06/2021,0,0,0,0,0,0,0,0,0,0,0,0,0,0,0,0,0,0,0,0
2877,173251,2021,Serbia,Iran,1,4,8,13,10/06/2021,0,0,1,1,5,4,5,14,1,1,2,4,4,2,3,9,6,1,0,7
2878,173251,2021,Serbia,Germany,2,6,5,13,09/06/2021,0,0,2,2,12,3,4,19,1,2,3,6,3,2,7,12,7,3,2,12
2879,173251,2021,Brazil,Serbia,0,0,0,0,05/06/2021,0,0,0,0,0,0,0,0,0,0,0,0,0,0,0,0,0,0,0,0
2880,173251,2021,Serbia,France,0,0,0,0,04/06/2021,0,0,0,0,0,0,0,0,0,0,0,0,0,0,0,0,0,0,0,0
2881,173251,2021,Japan,Serbia,0,0,0,0,03/06/2021,0,0,0,0,0,0,0,0,0,0,0,0,0,0,0,0,0,0,0,0
2882,173251,2021,Serbia,Italy,0,6,6,12,30/05/2021,0,0,0,0,9,3,8,20,3,2,1,6,9,0,23,32,8,3,0,11
2883,173251,2021,Poland,Serbia,0,1,5,6,29/05/2021,0,0,0,0,3,1,2,6,1,1,0,2,1,1,7,9,2,0,0,2
2884,173251,2021,Serbia,Slovenia,0,0,0,0,28/05/2021,0,0,0,0,0,0,0,0,0,0,0,0,0,0,0,0,0,0,0,0
2885,143792,2021,Argentina,Serbia,0,0,7,7,17/06/2021,0,0,1,1,4,0,0,4,0,3,0,3,0,0,0,0,1,1,0,2
2886,143792,2021,Serbia,Bulgaria,0,0,0,0,16/06/2021,0,0,0,0,1,0,0,1,0,0,1,1,0,0,0,0,0,0,0,0
2887,143792,2021,Russia,Serbia,0,0,0,0,15/06/2021,0,0,0,0,0,0,0,0,0,0,0,0,0,0,0,0,0,0,0,0
2888,143792,2021,USA,Serbia,0,0,0,0,11/06/2021,0,0,0,0,0,0,0,0,0,0,0,0,0,0,0,0,0,0,0,0
2889,143792,2021,Serbia,Iran,0,0,0,0,10/06/2021,0,0,0,0,0,0,0,0,0,0,0,0,0,0,0,0,0,0,0,0
2890,143792,2021,Serbia,Germany,0,0,0,0,09/06/2021,0,0,0,0,0,0,0,0,0,0,0,0,0,0,0,0,0,0,0,0
2891,143792,2021,Brazil,Serbia,0,1,6,7,05/06/2021,0,0,0,0,3,0,1,4,0,3,1,4,0,0,0,0,1,0,0,1
2892,143792,2021,Serbia,France,0,0,0,0,04/06/2021,0,0,0,0,0,0,0,0,0,0,0,0,0,0,0,0,0,0,0,0
2893,143792,2021,Japan,Serbia,0,0,0,0,03/06/2021,0,0,0,0,0,0,0,0,0,0,0,0,0,0,0,0,0,0,0,0
2894,143792,2021,Serbia,Italy,0,0,7,7,30/05/2021,0,0,0,0,3,0,0,3,3,3,1,7,0,0,3,3,1,2,0,3
2895,143792,2021,Poland,Serbia,0,0,1,1,29/05/2021,0,0,0,0,0,0,1,1,0,0,0,0,0,0,0,0,0,0,0,0
2896,143792,2021,Serbia,Slovenia,0,0,0,0,28/05/2021,0,0,0,0,0,0,0,0,0,0,0,0,0,0,0,0,0,0,0,0
2897,124915,2021,Canada,Serbia,0,4,3,7,23/06/2021,0,0,2,2,12,8,9,29,0,3,5,8,0,0,0,0,8,1,1,10
2898,124915,2021,Serbia,Netherlands,0,0,0,0,22/06/2021,0,0,0,0,0,0,0,0,0,0,0,0,0,0,0,0,0,0,0,0
2899,124915,2021,Australia,Serbia,0,4,11,15,21/06/2021,0,0,3,3,19,4,6,29,0,3,0,3,0,0,0,0,3,1,0,4
2900,124915,2021,Argentina,Serbia,0,1,3,4,17/06/2021,0,0,1,1,1,0,1,2,0,1,0,1,0,0,0,0,0,1,0,1
2901,124915,2021,Serbia,Bulgaria,1,3,5,9,16/06/2021,0,0,1,1,11,5,3,19,0,1,5,6,0,0,0,0,4,2,2,8
2902,124915,2021,Russia,Serbia,0,1,9,10,15/06/2021,0,0,2,2,7,6,7,20,2,1,2,5,0,0,0,0,2,1,2,5
2903,124915,2021,USA,Serbia,2,4,9,15,11/06/2021,0,0,1,1,15,5,7,27,0,3,2,5,0,1,0,1,4,6,0,10
2904,124915,2021,Serbia,Iran,0,0,2,2,10/06/2021,0,0,1,1,2,1,0,3,0,0,0,0,0,0,0,0,0,0,0,0
2905,124915,2021,Serbia,Germany,0,1,0,1,09/06/2021,0,0,0,0,1,0,1,2,0,1,2,3,0,0,0,0,0,0,0,0
2906,124915,2021,Brazil,Serbia,1,1,10,12,05/06/2021,0,0,1,1,10,8,6,24,1,1,2,4,0,0,0,0,1,1,1,3
2907,124915,2021,Serbia,France,2,4,11,17,04/06/2021,0,0,2,2,20,3,7,30,2,1,4,7,0,0,0,0,3,0,0,3
2908,124915,2021,Japan,Serbia,0,4,9,13,03/06/2021,0,0,2,2,7,4,7,18,1,3,4,8,0,0,0,0,2,0,0,2
2909,124915,2021,Serbia,Italy,0,1,1,2,30/05/2021,0,0,0,0,0,0,3,3,0,0,1,1,0,0,0,0,1,0,0,1
2910,124915,2021,Poland,Serbia,2,1,11,14,29/05/2021,0,0,0,0,9,8,10,27,0,2,0,2,0,0,1,1,4,1,0,5
2911,124915,2021,Serbia,Slovenia,0,0,0,0,28/05/2021,0,0,0,0,0,0,0,0,0,0,0,0,0,0,0,0,0,0,0,0
2912,143794,2021,Canada,Serbia,1,4,1,6,23/06/2021,0,0,2,2,7,6,6,19,1,0,2,3,0,0,0,0,1,0,0,1
2913,143794,2021,Serbia,Netherlands,8,4,15,27,22/06/2021,0,0,2,2,24,8,10,42,1,6,1,8,0,0,0,0,3,2,0,5
2914,143794,2021,Australia,Serbia,0,0,0,0,21/06/2021,0,0,0,0,0,0,0,0,0,0,0,0,0,0,0,0,0,0,0,0
2915,143794,2021,Argentina,Serbia,1,5,6,12,17/06/2021,0,0,2,2,10,5,6,21,1,2,4,7,0,0,0,0,5,0,1,6
2916,143794,2021,Serbia,Bulgaria,0,0,0,0,16/06/2021,0,0,0,0,0,0,0,0,0,0,0,0,0,0,0,0,0,0,0,0
2917,143794,2021,Russia,Serbia,0,2,2,4,15/06/2021,0,0,0,0,4,4,2,10,0,0,0,0,0,0,0,0,1,1,0,2
2918,143794,2021,USA,Serbia,0,0,0,0,11/06/2021,0,0,0,0,0,0,0,0,0,0,0,0,0,0,0,0,0,0,0,0
2919,143794,2021,Serbia,Iran,1,5,7,13,10/06/2021,0,0,2,2,21,3,8,32,1,2,3,6,0,0,0,0,7,1,0,8
2920,143794,2021,Serbia,Germany,2,5,6,13,09/06/2021,0,0,1,1,13,4,11,28,0,1,2,3,0,0,0,0,3,3,0,6
2921,143794,2021,Brazil,Serbia,1,2,1,4,05/06/2021,0,0,0,0,0,5,3,8,0,1,0,1,0,0,0,0,0,2,0,2
2922,143794,2021,Serbia,France,0,2,3,5,04/06/2021,0,0,0,0,5,0,0,5,0,0,0,0,0,0,0,0,0,0,0,0
2923,143794,2021,Japan,Serbia,0,2,0,2,03/06/2021,0,0,3,3,0,0,5,5,1,2,0,3,0,0,0,0,0,0,0,0
2924,143794,2021,Serbia,Italy,2,7,10,19,30/05/2021,0,0,0,0,18,5,17,40,1,3,3,7,0,0,0,0,4,1,0,5
2925,143794,2021,Poland,Serbia,2,0,3,5,29/05/2021,0,0,0,0,4,0,2,6,0,0,0,0,0,0,0,0,0,0,0,0
2926,143794,2021,Serbia,Slovenia,1,6,8,15,28/05/2021,0,0,1,1,27,6,11,44,1,4,1,6,0,0,0,0,3,1,0,4
2927,116525,2021,Canada,Serbia,0,6,6,12,23/06/2021,0,0,3,3,6,2,1,9,2,2,7,11,1,0,1,2,1,1,0,2
2928,116525,2021,Serbia,Netherlands,0,1,11,12,22/06/2021,0,0,1,1,5,4,2,11,0,5,6,11,1,0,1,2,5,1,0,6
2929,116525,2021,Australia,Serbia,0,2,18,20,21/06/2021,0,0,2,2,7,1,1,9,3,5,1,9,1,0,0,1,3,0,0,3
2930,116525,2021,Argentina,Serbia,0,2,6,8,17/06/2021,0,0,1,1,3,1,2,6,1,5,0,6,0,0,0,0,1,1,0,2
2931,116525,2021,Serbia,Bulgaria,1,1,9,11,16/06/2021,0,0,4,4,7,0,1,8,5,4,3,12,0,0,0,0,1,1,0,2
2932,116525,2021,Russia,Serbia,0,3,14,17,15/06/2021,0,0,2,2,5,0,2,7,1,8,5,14,0,0,0,0,1,1,0,2
2933,116525,2021,USA,Serbia,0,3,14,17,11/06/2021,0,0,0,0,4,1,2,7,4,3,1,8,0,0,1,1,1,1,0,2
2934,116525,2021,Serbia,Iran,3,2,16,21,10/06/2021,0,0,2,2,6,0,2,8,8,4,4,16,0,0,1,1,3,3,2,8
2935,116525,2021,Serbia,Germany,1,3,10,14,09/06/2021,0,0,2,2,3,0,3,6,4,3,4,11,0,0,0,0,3,0,1,4
2936,116525,2021,Brazil,Serbia,0,0,7,7,05/06/2021,0,0,0,0,3,0,1,4,1,2,2,5,0,0,0,0,1,1,0,2
2937,116525,2021,Serbia,France,0,4,18,22,04/06/2021,0,0,1,1,4,2,2,8,3,6,5,14,0,0,0,0,2,0,0,2
2938,116525,2021,Japan,Serbia,0,3,9,12,03/06/2021,0,0,1,1,9,1,1,11,4,3,1,8,0,0,0,0,1,1,0,2
2939,116525,2021,Serbia,Italy,1,0,14,15,30/05/2021,0,0,0,0,10,2,2,14,3,4,6,13,0,0,1,1,0,0,1,1
2940,116525,2021,Poland,Serbia,1,2,11,14,29/05/2021,0,0,0,0,11,0,4,15,1,6,4,11,0,0,0,0,3,1,0,4
2941,116525,2021,Serbia,Slovenia,2,2,20,24,28/05/2021,0,0,1,1,4,1,1,6,4,6,2,12,0,0,1,1,4,0,0,4
2942,173250,2021,Canada,Serbia,0,2,11,13,23/06/2021,28,1,84,113,1,0,0,1,0,1,3,4,0,0,1,1,7,2,0,9
2943,173250,2021,Serbia,Netherlands,0,0,4,4,22/06/2021,6,0,18,24,0,0,0,0,0,1,0,1,0,0,0,0,1,0,0,1
2944,173250,2021,Australia,Serbia,1,2,15,18,21/06/2021,19,2,42,63,0,0,0,0,0,2,3,5,0,0,0,0,1,0,0,1
2945,173250,2021,Argentina,Serbia,0,0,0,0,17/06/2021,0,0,4,4,0,0,0,0,0,0,0,0,0,0,0,0,1,1,0,2
2946,173250,2021,Serbia,Bulgaria,0,0,0,0,16/06/2021,0,0,0,0,0,0,0,0,0,0,0,0,0,0,0,0,0,0,0,0
2947,173250,2021,Russia,Serbia,0,0,0,0,15/06/2021,2,0,2,4,0,0,0,0,0,0,0,0,0,0,0,0,0,0,0,0
2948,173250,2021,USA,Serbia,0,0,0,0,11/06/2021,0,0,0,0,0,0,0,0,0,0,0,0,0,0,0,0,0,0,0,0
2949,173250,2021,Serbia,Iran,0,0,0,0,10/06/2021,3,0,0,3,0,0,0,0,0,0,0,0,0,0,1,1,0,0,0,0
2950,173250,2021,Serbia,Germany,0,2,13,15,09/06/2021,25,0,39,64,1,0,0,1,0,1,3,4,0,0,0,0,4,1,0,5
2951,173250,2021,Brazil,Serbia,0,0,4,4,05/06/2021,12,0,20,32,0,0,1,1,1,1,1,3,0,0,0,0,2,1,0,3
2952,173250,2021,Serbia,France,0,0,0,0,04/06/2021,2,0,4,6,0,0,0,0,0,0,0,0,0,0,0,0,1,0,0,1
2953,173250,2021,Japan,Serbia,0,0,0,0,03/06/2021,1,0,2,3,0,0,0,0,0,1,0,1,0,0,0,0,0,0,0,0
2954,173250,2021,Serbia,Italy,0,0,0,0,30/05/2021,0,0,7,7,0,0,0,0,0,0,0,0,0,0,0,0,1,1,0,2
2955,168276,2021,Canada,Serbia,0,0,0,0,23/06/2021,0,0,0,0,0,0,0,0,0,0,0,0,0,0,0,0,0,0,0,0
2956,168276,2021,Serbia,Netherlands,0,0,0,0,22/06/2021,0,0,0,0,0,0,0,0,0,0,0,0,0,0,0,0,0,0,0,0
2957,168276,2021,Australia,Serbia,0,0,0,0,21/06/2021,0,0,0,0,0,1,0,1,0,0,0,0,0,0,0,0,0,0,0,0
2958,168276,2021,Serbia,Italy,0,0,0,0,30/05/2021,0,0,0,0,0,0,0,0,0,0,0,0,0,0,0,0,0,0,0,0
2959,168276,2021,Poland,Serbia,0,0,0,0,29/05/2021,0,0,0,0,0,0,0,0,0,0,0,0,0,0,0,0,0,0,0,0
2960,146751,2021,Canada,Serbia,0,0,0,0,23/06/2021,0,0,0,0,0,0,0,0,0,0,0,0,0,0,0,0,0,0,0,0
2961,146751,2021,Serbia,Netherlands,0,0,0,0,22/06/2021,0,0,0,0,0,0,0,0,0,0,0,0,0,0,3,3,0,0,0,0
2962,146751,2021,Australia,Serbia,0,0,2,2,21/06/2021,0,0,1,1,3,1,1,5,0,1,0,1,3,1,8,12,0,2,0,2
2963,146751,2021,Argentina,Serbia,0,0,0,0,17/06/2021,0,0,0,0,0,0,0,0,0,0,0,0,0,0,1,1,0,0,0,0
2964,146751,2021,Serbia,Bulgaria,0,0,0,0,16/06/2021,0,0,1,1,1,0,3,4,0,0,0,0,1,0,2,3,3,0,0,3
2965,146751,2021,Russia,Serbia,0,0,0,0,15/06/2021,0,0,0,0,0,0,0,0,0,0,0,0,0,0,0,0,0,0,0,0
2966,146751,2021,USA,Serbia,0,0,0,0,11/06/2021,0,0,0,0,0,0,0,0,0,0,0,0,0,0,1,1,0,0,0,0
2967,146751,2021,Serbia,Iran,0,0,0,0,10/06/2021,0,0,0,0,0,0,0,0,0,0,0,0,1,1,1,3,0,0,0,0
2968,146751,2021,Serbia,Germany,0,1,0,1,09/06/2021,0,0,1,1,0,0,1,1,1,0,1,2,1,0,3,4,1,0,0,1
2969,146751,2021,Brazil,Serbia,0,0,0,0,05/06/2021,0,0,0,0,0,0,0,0,0,0,0,0,0,0,0,0,0,0,0,0
2970,146751,2021,Serbia,France,0,0,0,0,04/06/2021,0,0,0,0,0,0,0,0,0,0,0,0,0,0,0,0,0,0,0,0
2971,146751,2021,Japan,Serbia,0,0,0,0,03/06/2021,0,0,0,0,0,0,0,0,0,0,0,0,0,0,0,0,0,0,0,0
2972,146751,2021,Serbia,Italy,0,0,0,0,30/05/2021,0,0,0,0,0,0,0,0,0,0,0,0,0,0,0,0,0,0,0,0
2973,146751,2021,Poland,Serbia,0,2,0,2,29/05/2021,0,0,0,0,0,2,3,5,0,1,1,2,5,2,6,13,2,0,0,2
2974,146751,2021,Serbia,Slovenia,0,0,0,0,28/05/2021,0,0,0,0,0,0,0,0,0,0,0,0,0,0,0,0,0,0,0,0
2975,151390,2021,France,Slovenia,0,2,7,9,27/06/2021,0,0,0,0,11,1,6,18,1,8,1,10,0,0,0,0,3,1,0,4
2976,151390,2021,Poland,Slovenia,3,3,8,14,26/06/2021,0,0,2,2,7,4,10,21,2,5,2,9,0,0,0,0,2,0,0,2
2977,151390,2021,Slovenia,Bulgaria,0,1,11,12,23/06/2021,0,0,0,0,12,3,4,19,1,3,1,5,0,0,0,0,1,0,0,1
2978,151390,2021,Japan,Slovenia,1,3,6,10,22/06/2021,0,0,0,0,11,2,7,20,2,3,1,6,0,0,1,1,5,0,0,5
2979,151390,2021,Slovenia,USA,1,6,12,19,21/06/2021,0,0,2,2,15,8,5,28,2,2,0,4,0,0,0,0,7,2,2,11
2980,151390,2021,Iran,Slovenia,2,4,12,18,17/06/2021,0,0,1,1,8,7,9,24,1,5,1,7,0,0,0,0,3,1,0,4
2981,151390,2021,Brazil,Slovenia,0,4,10,14,15/06/2021,0,0,2,2,15,4,7,26,0,2,2,4,0,0,0,0,2,1,0,3
2982,151390,2021,Slovenia,Russia,1,5,6,12,11/06/2021,0,0,4,4,5,8,4,17,0,3,2,5,0,0,0,0,7,2,0,9
2983,151390,2021,Slovenia,Canada,2,3,12,17,09/06/2021,0,0,3,3,14,4,5,23,1,1,0,2,0,0,0,0,6,1,1,8
2984,151390,2021,Slovenia,Germany,0,2,3,5,05/06/2021,0,0,1,1,12,2,5,19,1,6,2,9,0,0,0,0,3,0,0,3
2985,151390,2021,Argentina,Slovenia,1,3,8,12,04/06/2021,0,0,2,2,6,3,7,16,0,1,0,1,0,0,0,0,2,0,0,2
2986,151390,2021,Netherlands,Slovenia,1,2,12,15,03/06/2021,0,0,1,1,10,3,4,17,1,2,3,6,0,0,0,0,5,1,1,7
2987,151390,2021,Poland,Slovenia,1,3,10,14,30/05/2021,0,0,2,2,15,3,19,37,2,4,0,6,0,0,0,0,0,1,0,1
2988,151390,2021,Italy,Slovenia,0,0,0,0,29/05/2021,0,0,0,0,0,0,0,0,0,0,0,0,0,0,0,0,0,0,0,0
2989,151390,2021,Serbia,Slovenia,0,5,9,14,28/05/2021,0,0,0,0,13,9,5,27,1,3,1,5,0,0,0,0,5,4,0,9
2990,114962,2021,France,Slovenia,1,3,9,13,27/06/2021,0,0,0,0,3,1,3,7,1,3,4,8,1,0,1,2,1,0,0,1
2991,114962,2021,Poland,Slovenia,2,3,8,13,26/06/2021,0,0,0,0,7,1,2,10,0,2,3,5,0,0,1,1,2,0,0,2
2992,114962,2021,Slovenia,Bulgaria,1,0,11,12,23/06/2021,0,0,0,0,5,2,0,7,0,1,1,2,0,0,0,0,2,0,0,2
2993,114962,2021,Japan,Slovenia,1,0,9,10,22/06/2021,0,0,0,0,3,0,0,3,0,1,0,1,0,0,0,0,0,0,0,0
2994,114962,2021,Slovenia,USA,1,6,11,18,21/06/2021,0,0,0,0,8,0,4,12,4,4,3,11,0,0,3,3,2,0,0,2
2995,114962,2021,Iran,Slovenia,0,4,12,16,17/06/2021,0,0,4,4,8,1,3,12,1,2,1,4,2,0,0,2,4,0,0,4
2996,114962,2021,Slovenia,Australia,3,4,21,28,16/06/2021,0,0,1,1,7,1,0,8,0,1,4,5,1,0,2,3,4,1,0,5
2997,114962,2021,Brazil,Slovenia,1,3,14,18,15/06/2021,0,0,1,1,8,1,4,13,4,6,4,14,0,0,0,0,1,2,0,3
2998,114962,2021,Slovenia,Russia,1,5,10,16,11/06/2021,0,0,1,1,6,1,4,11,1,2,6,9,0,0,0,0,3,0,1,4
2999,114962,2021,France,Slovenia,1,7,6,14,10/06/2021,0,0,0,0,11,1,3,15,1,4,5,10,0,0,0,0,2,0,0,2
3000,114962,2021,Slovenia,Canada,1,3,10,14,09/06/2021,0,0,0,0,4,0,1,5,0,3,5,8,1,0,0,1,0,0,0,0
3001,114962,2021,Slovenia,Germany,0,2,8,10,05/06/2021,0,0,1,1,5,2,3,10,0,1,9,10,1,0,2,3,2,0,0,2
3002,114962,2021,Argentina,Slovenia,0,2,10,12,04/06/2021,0,0,0,0,6,0,2,8,1,6,7,14,0,0,1,1,3,1,0,4
3003,114962,2021,Netherlands,Slovenia,0,2,10,12,03/06/2021,0,0,2,2,3,0,1,4,2,1,2,5,0,0,0,0,2,1,0,3
3004,114962,2021,Poland,Slovenia,3,2,12,17,30/05/2021,0,0,3,3,6,1,7,14,1,1,0,2,0,0,2,2,1,0,0,1
3005,114962,2021,Italy,Slovenia,1,0,17,18,29/05/2021,0,0,0,0,6,1,4,11,1,0,0,1,1,1,0,2,0,0,0,0
3006,114962,2021,Serbia,Slovenia,1,2,13,16,28/05/2021,0,0,0,0,6,2,0,8,3,2,0,5,0,0,0,0,1,1,0,2
3007,181130,2021,France,Slovenia,0,0,0,0,10/06/2021,0,0,0,0,0,0,0,0,0,0,0,0,0,0,0,0,0,0,0,0
3008,181130,2021,Slovenia,Germany,0,0,0,0,05/06/2021,3,1,2,6,0,0,0,0,0,0,0,0,0,0,0,0,0,0,0,0
3009,181130,2021,Argentina,Slovenia,0,0,0,0,04/06/2021,0,0,0,0,0,0,0,0,0,0,0,0,0,0,0,0,0,0,0,0
3010,181130,2021,Netherlands,Slovenia,0,1,0,1,03/06/2021,0,0,8,8,0,0,0,0,1,0,0,1,0,0,0,0,0,1,0,1
3011,151391,2021,France,Slovenia,0,1,6,7,27/06/2021,0,0,3,3,0,1,1,2,1,5,2,8,0,0,0,0,3,0,0,3
3012,151391,2021,Poland,Slovenia,0,1,5,6,26/06/2021,0,0,1,1,2,1,1,4,1,1,0,2,0,0,1,1,0,0,0,0
3013,151391,2021,Slovenia,Bulgaria,0,3,9,12,23/06/2021,0,0,2,2,2,0,0,2,1,1,4,6,0,0,0,0,5,1,0,6
3014,151391,2021,Japan,Slovenia,0,1,11,12,22/06/2021,1,0,1,2,6,0,0,6,3,2,1,6,0,0,0,0,0,1,0,1
3015,151391,2021,Slovenia,USA,1,2,16,19,21/06/2021,0,0,1,1,4,2,3,9,2,6,6,14,1,0,0,1,2,1,1,4
3016,151391,2021,Iran,Slovenia,0,1,12,13,17/06/2021,0,0,1,1,5,1,2,8,2,4,3,9,3,0,1,4,2,4,0,6
3017,151391,2021,Slovenia,Australia,0,2,8,10,16/06/2021,0,0,0,0,7,1,2,10,1,3,6,10,0,0,0,0,2,2,0,4
3018,151391,2021,Brazil,Slovenia,3,1,16,20,15/06/2021,0,0,0,0,7,3,2,12,2,6,2,10,1,0,0,1,5,3,0,8
3019,151391,2021,Slovenia,Russia,0,0,12,12,11/06/2021,0,1,3,4,2,1,3,6,2,7,8,17,0,0,0,0,4,2,1,7
3020,151391,2021,Slovenia,Canada,0,2,9,11,09/06/2021,0,0,1,1,3,0,2,5,1,2,2,5,0,0,1,1,0,0,0,0
3021,151391,2021,Slovenia,Germany,0,1,9,10,05/06/2021,0,0,0,0,1,3,1,5,0,4,4,8,1,0,0,1,2,0,0,2
3022,151391,2021,Argentina,Slovenia,1,4,11,16,04/06/2021,0,0,1,1,2,1,4,7,2,2,8,12,0,0,2,2,3,0,0,3
3023,151391,2021,Netherlands,Slovenia,0,0,9,9,03/06/2021,0,0,1,1,3,0,2,5,1,3,4,8,0,0,0,0,0,0,0,0
3024,151391,2021,Poland,Slovenia,0,2,12,14,30/05/2021,0,0,3,3,7,2,4,13,2,5,2,9,0,0,1,1,0,1,0,1
3025,151391,2021,Italy,Slovenia,2,1,7,10,29/05/2021,0,0,2,2,6,0,0,6,2,0,0,2,0,0,1,1,0,0,0,0
3026,151391,2021,Serbia,Slovenia,0,1,15,16,28/05/2021,0,0,0,0,8,0,3,11,4,5,1,10,0,0,4,4,3,1,0,4
3027,119022,2021,France,Slovenia,0,0,0,0,27/06/2021,0,0,0,0,0,0,0,0,0,0,0,0,0,0,0,0,0,0,0,0
3028,119022,2021,Poland,Slovenia,0,0,0,0,26/06/2021,0,0,0,0,0,0,0,0,0,0,0,0,0,0,0,0,0,0,0,0
3029,119022,2021,Slovenia,Bulgaria,0,0,0,0,23/06/2021,0,0,0,0,0,0,0,0,0,0,0,0,0,0,0,0,0,0,0,0
3030,119022,2021,Japan,Slovenia,0,0,0,0,22/06/2021,0,0,0,0,0,0,0,0,0,0,0,0,0,0,0,0,0,0,0,0
3031,119022,2021,Slovenia,USA,0,0,2,2,21/06/2021,0,0,0,0,0,0,1,1,0,0,0,0,0,0,0,0,0,0,1,1
3032,119022,2021,Iran,Slovenia,0,0,0,0,17/06/2021,0,0,0,0,0,0,0,0,0,0,0,0,0,0,0,0,0,0,0,0
3033,119022,2021,Slovenia,Australia,0,3,7,10,16/06/2021,0,0,3,3,8,3,12,23,1,1,4,6,0,0,0,0,3,3,0,6
3034,119022,2021,Brazil,Slovenia,0,1,1,2,15/06/2021,0,0,2,2,0,0,3,3,0,0,0,0,0,0,0,0,1,0,0,1
3035,119022,2021,Slovenia,Russia,1,1,14,16,11/06/2021,0,0,0,0,4,1,2,7,1,0,3,4,0,0,0,0,1,1,0,2
3036,119022,2021,France,Slovenia,1,4,7,12,10/06/2021,0,0,1,1,9,0,10,19,0,4,6,10,0,0,0,0,7,2,2,11
3037,119022,2021,Slovenia,Canada,0,0,0,0,09/06/2021,0,0,0,0,0,0,0,0,0,0,0,0,0,0,0,0,0,0,0,0
3038,119022,2021,Slovenia,Germany,0,0,0,0,05/06/2021,0,0,0,0,0,0,3,3,0,0,1,1,0,0,0,0,0,0,0,0
3039,119022,2021,Argentina,Slovenia,0,1,2,3,04/06/2021,0,0,0,0,4,0,3,7,0,2,0,2,0,0,0,0,0,1,0,1
3040,119022,2021,Netherlands,Slovenia,0,0,0,0,03/06/2021,0,0,0,0,0,0,0,0,0,0,0,0,0,0,0,0,0,0,0,0
3041,119022,2021,Poland,Slovenia,1,0,1,2,30/05/2021,0,0,0,0,2,0,1,3,0,0,0,0,0,0,0,0,0,0,0,0
3042,119022,2021,Italy,Slovenia,0,1,1,2,29/05/2021,0,0,0,0,0,0,0,0,0,1,0,1,0,0,0,0,0,0,0,0
3043,114952,2021,France,Slovenia,0,0,0,0,27/06/2021,0,0,0,0,0,0,0,0,0,0,0,0,0,0,0,0,0,0,0,0
3044,114952,2021,Poland,Slovenia,0,1,2,3,26/06/2021,0,0,0,0,0,1,1,2,0,0,0,0,0,0,0,0,1,0,0,1
3045,114952,2021,Slovenia,Bulgaria,0,0,0,0,23/06/2021,0,0,0,0,0,0,0,0,0,0,0,0,0,0,0,0,0,0,0,0
3046,114952,2021,Japan,Slovenia,0,0,0,0,22/06/2021,0,0,0,0,0,0,0,0,0,0,0,0,0,0,0,0,0,0,0,0
3047,114952,2021,Slovenia,USA,0,0,0,0,21/06/2021,0,0,0,0,0,0,0,0,0,0,0,0,0,0,0,0,0,0,0,0
3048,114952,2021,Iran,Slovenia,0,0,2,2,17/06/2021,0,0,0,0,2,0,1,3,0,1,0,1,0,0,0,0,0,1,0,1
3049,114952,2021,Slovenia,Australia,0,0,1,1,16/06/2021,0,0,0,0,2,2,0,4,0,0,0,0,0,0,0,0,0,0,0,0
3050,114952,2021,Brazil,Slovenia,0,0,0,0,15/06/2021,0,0,0,0,0,0,0,0,0,0,0,0,0,0,0,0,0,0,0,0
3051,114952,2021,Slovenia,Russia,0,0,0,0,11/06/2021,0,0,0,0,0,0,0,0,0,0,0,0,0,0,0,0,0,0,0,0
3052,114952,2021,France,Slovenia,0,3,1,4,10/06/2021,0,0,0,0,4,3,1,8,0,0,0,0,0,0,0,0,0,0,0,0
3053,114952,2021,Slovenia,Canada,0,0,0,0,09/06/2021,0,0,0,0,0,0,0,0,0,0,0,0,0,0,0,0,0,0,0,0
3054,114952,2021,Slovenia,Germany,1,2,3,6,05/06/2021,0,0,1,1,4,0,7,11,2,0,1,3,0,0,0,0,7,1,1,9
3055,114952,2021,Argentina,Slovenia,0,0,0,0,04/06/2021,0,0,0,0,0,0,0,0,0,0,0,0,0,0,0,0,0,0,0,0
3056,114952,2021,Netherlands,Slovenia,0,0,0,0,03/06/2021,0,0,0,0,0,0,0,0,0,0,0,0,0,0,0,0,0,0,0,0
3057,114952,2021,Italy,Slovenia,0,4,6,10,29/05/2021,0,0,2,2,6,2,9,17,0,0,0,0,0,0,0,0,1,0,0,1
3058,114952,2021,Serbia,Slovenia,0,0,2,2,28/05/2021,0,0,0,0,1,0,0,1,0,0,0,0,0,0,0,0,0,0,0,0
3059,114956,2021,France,Slovenia,0,0,0,0,27/06/2021,0,0,0,0,0,0,0,0,0,0,0,0,0,0,0,0,0,0,0,0
3060,114956,2021,Poland,Slovenia,0,0,2,2,26/06/2021,4,0,6,10,0,0,0,0,2,1,1,4,0,0,0,0,0,0,0,0
3061,114956,2021,Slovenia,Bulgaria,0,0,0,0,23/06/2021,0,0,0,0,0,0,0,0,0,0,0,0,0,0,0,0,0,0,0,0
3062,114956,2021,Japan,Slovenia,0,0,0,0,22/06/2021,0,0,0,0,0,0,0,0,0,0,0,0,0,0,0,0,0,0,0,0
3063,114956,2021,Slovenia,USA,0,0,0,0,21/06/2021,0,0,0,0,0,0,0,0,0,0,0,0,0,0,0,0,0,0,0,0
3064,114956,2021,Iran,Slovenia,0,0,0,0,17/06/2021,2,0,7,9,0,0,0,0,0,0,0,0,0,0,0,0,0,0,0,0
3065,114956,2021,Slovenia,Australia,0,0,0,0,16/06/2021,3,0,6,9,0,0,0,0,0,1,0,1,0,0,0,0,0,0,0,0
3066,114956,2021,Brazil,Slovenia,0,0,0,0,15/06/2021,3,0,1,4,0,0,0,0,0,0,0,0,0,1,0,1,0,1,0,1
3067,114956,2021,Slovenia,Russia,0,0,0,0,11/06/2021,0,0,0,0,0,0,0,0,0,0,0,0,0,0,0,0,0,0,0,0
3068,114956,2021,France,Slovenia,1,1,1,3,10/06/2021,16,2,7,25,0,0,0,0,0,0,0,0,0,0,0,0,0,3,0,3
3069,114956,2021,Slovenia,Canada,0,0,0,0,09/06/2021,0,0,0,0,0,0,0,0,0,0,0,0,0,0,0,0,0,0,0,0
3070,114956,2021,Poland,Slovenia,0,0,0,0,30/05/2021,1,1,2,4,0,0,0,0,0,0,0,0,0,0,0,0,0,0,0,0
3071,114956,2021,Italy,Slovenia,0,0,0,0,29/05/2021,1,0,4,5,0,0,0,0,0,0,0,0,0,0,0,0,0,0,0,0
3072,114956,2021,Serbia,Slovenia,1,0,11,12,28/05/2021,36,0,51,87,0,2,0,2,0,1,1,2,0,0,0,0,5,5,0,10
3073,151404,2021,France,Slovenia,0,0,0,0,27/06/2021,0,0,0,0,0,0,0,0,0,0,0,0,0,0,0,0,1,0,0,1
3074,151404,2021,Slovenia,Bulgaria,0,1,1,2,23/06/2021,0,0,0,0,0,0,1,1,0,0,0,0,0,0,1,1,0,0,0,0
3075,151404,2021,Slovenia,USA,0,0,0,0,21/06/2021,0,0,0,0,0,0,0,0,0,0,0,0,0,0,0,0,0,0,0,0
3076,151404,2021,Slovenia,Australia,0,0,0,0,16/06/2021,0,0,0,0,0,0,0,0,0,0,0,0,0,0,0,0,0,0,0,0
3077,151404,2021,Brazil,Slovenia,0,0,0,0,15/06/2021,0,0,0,0,0,0,0,0,0,0,0,0,0,0,0,0,0,0,0,0
3078,151404,2021,France,Slovenia,0,1,3,4,10/06/2021,0,1,1,2,1,3,0,4,2,1,2,5,0,0,0,0,0,1,0,1
3079,151404,2021,Slovenia,Canada,0,0,0,0,09/06/2021,0,0,0,0,0,0,0,0,0,0,0,0,0,0,0,0,0,0,0,0
3080,151404,2021,Slovenia,Germany,0,0,4,4,05/06/2021,0,0,0,0,1,0,2,3,1,1,4,6,0,0,1,1,0,1,0,1
3081,151404,2021,Argentina,Slovenia,0,0,0,0,04/06/2021,0,0,0,0,0,0,0,0,0,0,0,0,0,0,0,0,0,0,0,0
3082,151404,2021,Poland,Slovenia,0,0,0,0,30/05/2021,0,0,0,0,0,0,0,0,0,0,0,0,0,0,0,0,0,0,0,0
3083,151404,2021,Serbia,Slovenia,0,0,0,0,28/05/2021,0,0,0,0,0,0,0,0,0,0,0,0,0,0,0,0,0,0,0,0
3084,155920,2021,France,Slovenia,0,0,0,0,27/06/2021,0,0,0,0,0,0,0,0,0,0,0,0,0,0,0,0,0,0,0,0
3085,155920,2021,Poland,Slovenia,0,0,0,0,26/06/2021,0,0,0,0,0,0,0,0,0,0,0,0,0,0,0,0,0,0,0,0
3086,155920,2021,Slovenia,Bulgaria,0,0,0,0,23/06/2021,0,0,0,0,0,0,0,0,0,0,0,0,0,0,0,0,0,0,0,0
3087,155920,2021,Japan,Slovenia,0,0,1,1,22/06/2021,0,0,3,3,5,4,4,13,1,1,0,2,1,2,5,8,2,0,0,2
3088,155920,2021,Slovenia,USA,0,0,0,0,21/06/2021,0,0,0,0,0,0,0,0,0,0,0,0,0,0,0,0,0,0,0,0
3089,155920,2021,Iran,Slovenia,0,0,0,0,17/06/2021,0,0,0,0,0,0,0,0,0,0,0,0,0,0,0,0,0,0,0,0
3090,155920,2021,Slovenia,Australia,0,0,2,2,16/06/2021,0,0,0,0,5,1,4,10,0,1,0,1,3,2,5,10,1,0,0,1
3091,155920,2021,Brazil,Slovenia,0,0,0,0,15/06/2021,0,0,0,0,0,0,0,0,0,0,0,0,0,0,0,0,0,0,0,0
3092,155920,2021,Slovenia,Russia,0,0,0,0,11/06/2021,0,0,0,0,0,0,0,0,0,0,0,0,0,0,0,0,0,0,0,0
3093,155920,2021,France,Slovenia,0,2,2,4,10/06/2021,0,0,0,0,0,0,2,2,0,1,0,1,1,2,5,8,1,0,0,1
3094,155920,2021,Slovenia,Canada,0,0,0,0,09/06/2021,0,0,0,0,0,0,0,0,0,0,0,0,0,0,0,0,0,0,0,0
3095,155920,2021,Slovenia,Germany,0,0,2,2,05/06/2021,0,0,1,1,2,1,3,6,0,0,1,1,1,0,3,4,1,0,1,2
3096,155920,2021,Argentina,Slovenia,2,4,8,14,04/06/2021,0,0,3,3,11,2,5,18,1,1,1,3,1,0,15,16,7,3,1,11
3097,155920,2021,Netherlands,Slovenia,0,0,0,0,03/06/2021,0,0,0,0,0,0,0,0,0,0,0,0,0,0,0,0,0,0,0,0
3098,155920,2021,Poland,Slovenia,0,0,0,0,30/05/2021,0,0,0,0,0,0,0,0,0,0,0,0,0,0,0,0,0,0,0,0
3099,155920,2021,Italy,Slovenia,0,2,5,7,29/05/2021,0,0,3,3,12,1,12,25,0,0,0,0,7,0,6,13,1,0,0,1
3100,155920,2021,Serbia,Slovenia,0,0,2,2,28/05/2021,0,0,0,0,2,0,0,2,0,0,0,0,0,0,2,2,0,2,0,2
3101,154546,2021,France,Slovenia,0,0,0,0,27/06/2021,0,0,0,0,0,0,0,0,0,0,0,0,0,0,0,0,0,0,0,0
3102,154546,2021,Poland,Slovenia,0,0,0,0,26/06/2021,0,0,0,0,0,0,0,0,0,0,0,0,0,0,0,0,0,0,0,0
3103,154546,2021,Slovenia,Bulgaria,0,0,0,0,23/06/2021,0,0,1,1,0,0,0,0,0,0,0,0,0,1,2,3,1,0,0,1
3104,154546,2021,Japan,Slovenia,0,0,1,1,22/06/2021,0,0,0,0,0,0,1,1,0,0,0,0,0,0,0,0,0,0,0,0
3105,154546,2021,Iran,Slovenia,0,0,0,0,17/06/2021,0,0,0,0,0,0,0,0,0,0,0,0,0,0,0,0,0,0,0,0
3106,154546,2021,Slovenia,Australia,0,0,0,0,16/06/2021,0,0,0,0,0,0,0,0,0,0,0,0,0,0,0,0,0,0,0,0
3107,154546,2021,Slovenia,Russia,0,0,0,0,11/06/2021,0,0,0,0,0,0,0,0,0,0,0,0,1,0,0,1,0,0,0,0
3108,154546,2021,France,Slovenia,0,0,0,0,10/06/2021,0,0,0,0,0,0,0,0,0,0,0,0,0,0,0,0,0,0,0,0
3109,154546,2021,Slovenia,Germany,0,0,0,0,05/06/2021,0,0,0,0,0,0,0,0,0,0,0,0,0,0,0,0,0,0,0,0
3110,154546,2021,Netherlands,Slovenia,0,0,0,0,03/06/2021,0,0,0,0,0,0,0,0,0,0,0,0,0,0,0,0,0,0,0,0
3111,154546,2021,Poland,Slovenia,0,0,0,0,30/05/2021,2,0,1,3,0,0,0,0,0,0,0,0,0,0,0,0,0,0,0,0
3112,154546,2021,Italy,Slovenia,0,0,0,0,29/05/2021,0,0,0,0,0,0,0,0,0,0,0,0,0,0,0,0,0,0,0,0
3113,154546,2021,Serbia,Slovenia,0,0,0,0,28/05/2021,0,0,0,0,0,0,0,0,0,0,0,0,0,0,1,1,1,0,0,1
3114,144415,2021,France,Slovenia,0,0,0,0,27/06/2021,0,0,5,5,0,0,0,0,0,0,0,0,4,1,10,15,5,0,0,5
3115,144415,2021,Poland,Slovenia,0,0,0,0,26/06/2021,0,0,3,3,0,0,0,0,0,0,0,0,6,4,18,28,13,4,2,19
3116,144415,2021,Slovenia,Bulgaria,0,0,0,0,23/06/2021,0,0,2,2,0,0,0,0,0,0,0,0,7,0,7,14,6,5,0,11
3117,144415,2021,Japan,Slovenia,0,0,0,0,22/06/2021,0,0,2,2,0,0,0,0,0,0,0,0,6,0,10,16,2,4,0,6
3118,144415,2021,Slovenia,USA,0,0,0,0,21/06/2021,1,0,5,6,0,0,0,0,0,0,0,0,6,1,8,15,13,3,1,17
3119,144415,2021,Iran,Slovenia,0,0,0,0,17/06/2021,0,1,3,4,0,0,0,0,0,0,0,0,11,3,7,21,8,7,0,15
3120,144415,2021,Slovenia,Australia,0,0,0,0,16/06/2021,0,0,3,3,0,0,0,0,0,0,0,0,7,1,7,15,9,6,0,15
3121,144415,2021,Brazil,Slovenia,0,0,0,0,15/06/2021,0,0,4,4,0,0,0,0,0,0,0,0,6,1,11,18,8,5,1,14
3122,144415,2021,Slovenia,Russia,0,0,0,0,11/06/2021,0,0,9,9,0,0,0,0,0,0,0,0,5,4,14,23,8,1,0,9
3123,144415,2021,France,Slovenia,0,0,0,0,10/06/2021,0,0,3,3,0,0,0,0,0,0,0,0,6,0,17,23,11,8,1,20
3124,144415,2021,Slovenia,Canada,0,0,0,0,09/06/2021,0,0,7,7,0,0,0,0,0,0,0,0,6,0,9,15,6,2,0,8
3125,144415,2021,Slovenia,Germany,0,0,0,0,05/06/2021,0,0,5,5,0,0,0,0,0,0,0,0,8,2,9,19,18,3,0,21
3126,144415,2021,Argentina,Slovenia,0,0,0,0,04/06/2021,0,0,3,3,0,0,0,0,0,0,0,0,3,0,8,11,12,1,0,13
3127,144415,2021,Netherlands,Slovenia,0,0,0,0,03/06/2021,0,0,2,2,0,0,0,0,0,0,0,0,9,0,2,11,7,1,0,8
3128,144415,2021,Poland,Slovenia,0,0,0,0,30/05/2021,0,0,4,4,0,0,0,0,0,0,0,0,8,1,10,19,17,5,1,23
3129,144415,2021,Italy,Slovenia,0,0,0,0,29/05/2021,0,0,2,2,0,0,0,0,0,0,0,0,4,0,3,7,2,0,0,2
3130,144415,2021,Serbia,Slovenia,0,0,0,0,28/05/2021,0,0,6,6,0,0,0,0,0,0,0,0,7,0,13,20,5,5,1,11
3131,161754,2021,Poland,Slovenia,0,0,0,0,26/06/2021,0,0,0,0,0,0,0,0,0,0,0,0,0,0,0,0,0,0,0,0
3132,161754,2021,Japan,Slovenia,1,0,4,5,22/06/2021,0,0,0,0,2,0,0,2,0,1,1,2,0,0,0,0,0,0,0,0
3133,161754,2021,Slovenia,USA,0,0,0,0,21/06/2021,0,0,0,0,0,0,0,0,0,0,0,0,0,0,0,0,0,0,0,0
3134,161754,2021,Iran,Slovenia,0,0,0,0,17/06/2021,0,0,0,0,0,0,0,0,0,0,0,0,0,0,0,0,0,0,0,0
3135,161754,2021,Slovenia,Australia,0,0,0,0,16/06/2021,0,0,0,0,0,0,0,0,0,0,0,0,0,0,0,0,0,0,0,0
3136,161754,2021,Brazil,Slovenia,0,0,0,0,15/06/2021,0,0,0,0,0,0,0,0,0,0,0,0,0,0,0,0,0,0,0,0
3137,161754,2021,Slovenia,Russia,0,0,0,0,11/06/2021,1,0,3,4,0,0,0,0,0,0,2,2,0,0,0,0,0,0,0,0
3138,161754,2021,France,Slovenia,0,2,11,13,10/06/2021,0,0,0,0,1,0,1,2,0,1,1,2,0,0,0,0,1,0,0,1
3139,161754,2021,Slovenia,Canada,0,0,0,0,09/06/2021,0,0,1,1,0,0,0,0,0,0,0,0,0,0,0,0,0,0,0,0
3140,161754,2021,Argentina,Slovenia,0,0,0,0,04/06/2021,0,0,0,0,0,0,0,0,0,0,0,0,0,0,0,0,1,0,0,1
3141,161754,2021,Netherlands,Slovenia,0,0,4,4,03/06/2021,0,0,0,0,1,0,1,2,0,0,2,2,0,0,0,0,1,0,0,1
3142,161754,2021,Poland,Slovenia,0,0,0,0,30/05/2021,0,0,0,0,0,0,0,0,0,0,0,0,0,0,0,0,0,0,0,0
3143,161754,2021,Italy,Slovenia,0,0,1,1,29/05/2021,0,0,0,0,0,0,0,0,0,0,0,0,0,0,1,1,0,0,0,0
3144,161754,2021,Serbia,Slovenia,0,0,0,0,28/05/2021,0,0,0,0,0,0,0,0,0,0,0,0,0,0,0,0,0,0,0,0
3145,119018,2021,France,Slovenia,1,2,7,10,27/06/2021,17,0,48,65,0,0,1,1,1,3,1,5,0,0,0,0,4,0,1,5
3146,119018,2021,Poland,Slovenia,0,0,7,7,26/06/2021,15,0,46,61,0,0,0,0,0,2,1,3,0,0,0,0,4,0,1,5
3147,119018,2021,Slovenia,Bulgaria,1,2,10,13,23/06/2021,18,0,36,54,0,0,1,1,0,0,3,3,0,0,0,0,3,2,1,6
3148,119018,2021,Japan,Slovenia,1,1,12,14,22/06/2021,21,1,42,64,0,0,1,1,2,0,0,2,0,0,0,0,7,1,0,8
3149,119018,2021,Slovenia,USA,1,2,15,18,21/06/2021,20,1,93,114,1,0,0,1,1,5,2,8,0,0,2,2,4,3,2,9
3150,119018,2021,Iran,Slovenia,1,2,10,13,17/06/2021,26,0,57,83,1,0,1,2,0,2,0,2,0,0,0,0,7,3,0,10
3151,119018,2021,Slovenia,Australia,0,1,17,18,16/06/2021,36,0,43,79,2,0,0,2,0,0,1,1,0,0,0,0,6,2,2,10
3152,119018,2021,Brazil,Slovenia,0,1,15,16,15/06/2021,33,1,58,92,3,0,0,3,0,4,1,5,0,0,0,0,4,4,5,13
3153,119018,2021,Slovenia,Russia,1,4,11,16,11/06/2021,26,0,67,93,0,0,1,1,2,1,5,8,0,0,0,0,10,2,0,12
3154,119018,2021,France,Slovenia,0,1,13,14,10/06/2021,38,1,28,67,0,0,0,0,3,3,3,9,0,0,0,0,5,0,2,7
3155,119018,2021,Slovenia,Canada,0,3,5,8,09/06/2021,14,0,44,58,1,0,0,1,0,1,2,3,0,0,0,0,7,2,1,10
3156,119018,2021,Slovenia,Germany,2,2,18,22,05/06/2021,35,0,61,96,1,0,0,1,0,4,2,6,0,0,0,0,8,4,1,13
3157,119018,2021,Argentina,Slovenia,0,0,9,9,04/06/2021,35,1,39,75,1,0,0,1,0,1,3,4,0,0,0,0,5,0,1,6
3158,119018,2021,Netherlands,Slovenia,3,1,6,10,03/06/2021,11,1,37,49,0,0,0,0,1,2,0,3,0,0,1,1,9,2,2,13
3159,119018,2021,Poland,Slovenia,0,2,19,21,30/05/2021,37,0,59,96,2,1,0,3,1,1,0,2,0,0,0,0,4,3,0,7
3160,119018,2021,Italy,Slovenia,1,4,2,7,29/05/2021,18,0,38,56,0,0,0,0,0,0,0,0,0,0,0,0,0,0,0,0
3161,119018,2021,Serbia,Slovenia,1,0,3,4,28/05/2021,7,0,7,14,0,0,1,1,0,1,2,3,0,0,0,0,0,0,1,1
3162,114957,2021,France,Slovenia,0,2,7,9,27/06/2021,0,0,5,5,8,4,6,18,2,3,2,7,3,2,12,17,1,1,0,2
3163,114957,2021,Poland,Slovenia,0,3,11,14,26/06/2021,0,0,1,1,13,3,4,20,0,1,1,2,1,2,13,16,3,3,2,8
3164,114957,2021,Slovenia,Bulgaria,1,0,6,7,23/06/2021,0,0,4,4,3,2,1,6,0,2,0,2,0,0,2,2,1,1,0,2
3165,114957,2021,Japan,Slovenia,0,2,13,15,22/06/2021,0,0,5,5,12,1,6,19,2,2,1,5,3,0,13,16,3,0,0,3
3166,114957,2021,Slovenia,USA,0,6,18,24,21/06/2021,0,0,3,3,16,2,17,35,0,5,3,8,7,2,30,39,9,0,2,11
3167,114957,2021,Iran,Slovenia,0,3,17,20,17/06/2021,0,0,3,3,16,3,8,27,1,2,0,3,14,0,14,28,3,6,0,9
3168,114957,2021,Slovenia,Australia,0,1,2,3,16/06/2021,0,0,0,0,1,3,3,7,0,0,0,0,2,0,1,3,5,0,0,5
3169,114957,2021,Brazil,Slovenia,0,3,10,13,15/06/2021,0,0,1,1,9,2,12,23,0,3,2,5,4,2,12,18,7,2,0,9
3170,114957,2021,Slovenia,Russia,0,4,8,12,11/06/2021,0,0,5,5,18,5,14,37,0,5,2,7,6,1,19,26,6,3,1,10
3171,114957,2021,France,Slovenia,0,0,0,0,10/06/2021,0,0,0,0,0,0,0,0,0,0,0,0,0,0,0,0,0,0,0,0
3172,114957,2021,Slovenia,Canada,0,1,9,10,09/06/2021,0,0,1,1,9,2,6,17,1,1,0,2,7,2,11,20,5,4,0,9
3173,114957,2021,Slovenia,Germany,1,3,10,14,05/06/2021,1,0,2,3,11,6,14,31,0,2,1,3,3,0,12,15,8,2,0,10
3174,114957,2021,Argentina,Slovenia,0,0,0,0,04/06/2021,0,0,0,0,0,0,0,0,0,0,0,0,0,0,0,0,0,0,0,0
3175,114957,2021,Netherlands,Slovenia,1,3,9,13,03/06/2021,0,0,7,7,8,0,6,14,0,3,0,3,7,2,12,21,3,0,1,4
3176,114957,2021,Poland,Slovenia,0,3,11,14,30/05/2021,0,1,9,10,12,2,17,31,1,2,0,3,18,1,14,33,5,1,0,6
3177,114957,2021,Italy,Slovenia,0,0,0,0,29/05/2021,0,0,0,0,0,0,0,0,0,0,0,0,0,0,0,0,0,0,0,0
3178,114957,2021,Serbia,Slovenia,0,4,7,11,28/05/2021,0,0,0,0,14,4,14,32,0,0,1,1,4,3,19,26,3,4,1,8
3179,136918,2021,France,Slovenia,1,0,9,10,27/06/2021,0,0,0,0,8,6,12,26,0,2,2,4,8,2,14,24,8,1,2,11
3180,136918,2021,Poland,Slovenia,0,3,5,8,26/06/2021,0,0,5,5,9,8,9,26,1,0,3,4,9,0,8,17,2,1,1,4
3181,136918,2021,Slovenia,Bulgaria,0,1,8,9,23/06/2021,0,0,2,2,6,4,9,19,1,5,4,10,5,1,10,16,9,2,1,12
3182,136918,2021,Japan,Slovenia,1,2,6,9,22/06/2021,0,0,1,1,6,1,8,15,0,3,0,3,5,0,6,11,2,2,0,4
3183,136918,2021,Slovenia,USA,0,3,14,17,21/06/2021,0,0,5,5,25,5,13,43,2,3,0,5,6,3,22,31,4,5,2,11
3184,136918,2021,Iran,Slovenia,0,6,7,13,17/06/2021,0,0,4,4,20,5,9,34,1,0,0,1,8,1,15,24,2,3,0,5
3185,136918,2021,Slovenia,Australia,1,3,6,10,16/06/2021,0,0,4,4,14,2,5,21,1,1,1,3,6,0,4,10,7,3,0,10
3186,136918,2021,Brazil,Slovenia,1,4,9,14,15/06/2021,0,0,3,3,14,4,11,29,1,3,3,7,12,2,28,42,12,1,0,13
3187,136918,2021,Slovenia,Russia,2,6,11,19,11/06/2021,0,0,3,3,27,2,11,40,3,3,3,9,5,2,26,33,8,0,0,8
3188,136918,2021,France,Slovenia,2,4,12,18,10/06/2021,0,0,5,5,10,0,14,24,4,3,0,7,9,2,19,30,5,0,2,7
3189,136918,2021,Slovenia,Canada,2,1,6,9,09/06/2021,0,0,1,1,10,4,4,18,0,1,1,2,5,0,6,11,1,1,0,2
3190,136918,2021,Slovenia,Germany,0,6,4,10,05/06/2021,0,0,0,0,7,1,10,18,1,1,1,3,9,4,6,19,4,2,0,6
3191,136918,2021,Argentina,Slovenia,0,2,6,8,04/06/2021,0,0,3,3,11,3,14,28,1,2,6,9,6,0,13,19,7,1,2,10
3192,136918,2021,Netherlands,Slovenia,0,0,0,0,03/06/2021,0,0,0,0,0,0,0,0,0,0,0,0,0,0,0,0,0,0,0,0
3193,136918,2021,Poland,Slovenia,0,4,11,15,30/05/2021,0,0,6,6,16,7,17,40,1,3,0,4,10,1,13,24,3,4,1,8
3194,136918,2021,Italy,Slovenia,4,2,13,19,29/05/2021,0,0,4,4,8,0,8,16,1,0,0,1,5,3,8,16,1,0,0,1
3195,136918,2021,Serbia,Slovenia,1,5,13,19,28/05/2021,0,1,2,3,9,4,14,27,1,2,1,4,15,0,20,35,4,5,2,11
3196,168747,2021,France,Slovenia,0,1,0,1,27/06/2021,0,0,1,1,1,2,2,5,0,0,0,0,0,0,3,3,0,0,0,0
3197,168747,2021,Poland,Slovenia,0,0,0,0,26/06/2021,0,0,0,0,0,0,0,0,0,0,0,0,0,0,0,0,0,0,0,0
3198,168747,2021,Slovenia,Bulgaria,0,1,6,7,23/06/2021,0,0,1,1,8,1,1,10,2,3,0,5,0,0,5,5,1,0,1,2
3199,168747,2021,Japan,Slovenia,0,0,0,0,22/06/2021,0,0,1,1,0,0,0,0,0,0,0,0,0,0,0,0,0,1,0,1
3200,168747,2021,Slovenia,USA,0,0,0,0,21/06/2021,0,0,0,0,0,0,0,0,0,0,0,0,0,0,0,0,0,0,0,0
3201,168747,2021,Iran,Slovenia,0,0,0,0,17/06/2021,0,0,0,0,0,0,2,2,0,1,0,1,0,0,3,3,0,0,0,0
3202,168747,2021,Slovenia,Australia,0,2,8,10,16/06/2021,0,0,2,2,11,4,4,19,3,3,4,10,8,0,17,25,3,1,0,4
3203,168747,2021,Brazil,Slovenia,0,1,0,1,15/06/2021,0,0,1,1,2,0,1,3,0,0,0,0,0,1,2,3,0,0,0,0
3204,168747,2021,Slovenia,Russia,0,0,2,2,11/06/2021,0,0,0,0,2,1,0,3,0,0,1,1,0,0,3,3,2,1,0,3
3205,168747,2021,France,Slovenia,0,7,8,15,10/06/2021,0,0,3,3,19,2,10,31,1,8,0,9,3,2,13,18,6,0,1,7
3206,168747,2021,Slovenia,Canada,0,2,3,5,09/06/2021,0,0,1,1,3,0,0,3,0,0,0,0,0,0,2,2,1,1,0,2
3207,168747,2021,Slovenia,Germany,1,2,1,4,05/06/2021,0,0,0,0,3,1,1,5,0,0,1,1,2,1,6,9,2,1,0,3
3208,168747,2021,Argentina,Slovenia,0,0,0,0,04/06/2021,0,0,0,0,0,0,0,0,0,0,0,0,0,0,0,0,0,0,0,0
3209,168747,2021,Netherlands,Slovenia,1,2,7,10,03/06/2021,0,1,0,1,14,4,9,27,1,0,2,3,2,1,3,6,2,2,0,4
3210,168747,2021,Poland,Slovenia,0,0,0,0,30/05/2021,0,0,0,0,1,0,0,1,0,0,0,0,0,0,0,0,0,0,0,0
3211,168747,2021,Italy,Slovenia,0,0,0,0,29/05/2021,0,0,0,0,2,1,4,7,0,0,0,0,2,1,2,5,0,0,0,0
3212,168747,2021,Serbia,Slovenia,0,0,0,0,28/05/2021,0,0,0,0,0,0,0,0,0,0,0,0,0,0,0,0,0,0,0,0
3213,118893,2021,USA,Japan,1,5,5,11,23/06/2021,0,0,1,1,11,1,7,19,0,0,0,0,0,0,0,0,5,3,0,8
3214,118893,2021,Bulgaria,USA,0,0,0,0,22/06/2021,0,0,0,0,0,0,0,0,0,0,0,0,0,0,0,0,0,0,0,0
3215,118893,2021,Slovenia,USA,0,1,9,10,21/06/2021,0,0,3,3,8,5,11,24,1,4,1,6,2,0,3,5,4,3,0,7
3216,118893,2021,Netherlands,USA,0,6,9,15,17/06/2021,0,1,2,3,17,4,7,28,2,7,7,16,1,0,3,4,5,4,1,10
3217,118893,2021,USA,France,0,0,0,0,16/06/2021,0,0,0,0,0,0,0,0,0,0,0,0,0,0,0,0,0,0,0,0
3218,118893,2021,Italy,USA,3,3,9,15,15/06/2021,0,0,0,0,13,3,5,21,1,1,3,5,2,0,0,2,4,1,1,6
3219,118893,2021,USA,Serbia,0,1,5,6,11/06/2021,0,0,1,1,7,3,5,15,2,1,1,4,0,0,1,1,3,2,0,5
3220,118893,2021,USA,Australia,1,3,8,12,05/06/2021,0,0,2,2,12,2,4,18,1,0,0,1,2,0,6,8,4,2,2,8
3221,118893,2021,Poland,USA,0,4,1,5,04/06/2021,0,0,0,0,9,2,5,16,0,0,1,1,9,1,6,16,5,1,2,8
3222,124941,2021,Slovenia,USA,1,7,11,19,21/06/2021,1,0,2,3,16,4,13,33,4,3,2,9,17,2,17,36,7,1,1,9
3223,124941,2021,Netherlands,USA,4,2,11,17,17/06/2021,0,0,8,8,15,5,8,28,2,5,3,10,8,2,16,26,4,3,0,7
3224,124941,2021,Italy,USA,0,2,7,9,15/06/2021,0,0,2,2,12,0,7,19,2,0,0,2,6,1,10,17,4,0,0,4
3225,124941,2021,USA,Serbia,0,0,0,0,11/06/2021,0,0,0,0,0,0,0,0,0,0,0,0,0,0,0,0,0,0,0,0
3226,124941,2021,Germany,USA,0,0,0,0,10/06/2021,0,0,0,0,0,0,0,0,0,0,0,0,0,0,0,0,0,0,0,0
3227,124941,2021,Iran,USA,0,0,0,0,09/06/2021,0,0,0,0,0,0,0,0,0,0,0,0,0,0,0,0,0,0,0,0
3228,147721,2021,USA,Japan,0,0,0,0,23/06/2021,0,0,0,0,0,0,0,0,0,0,0,0,0,0,0,0,0,0,0,0
3229,147721,2021,Bulgaria,USA,0,0,9,9,22/06/2021,0,0,0,0,6,1,3,10,4,1,3,8,0,0,3,3,2,0,0,2
3230,147721,2021,Slovenia,USA,0,0,0,0,21/06/2021,0,0,0,0,0,0,0,0,0,0,0,0,0,0,0,0,0,0,0,0
3231,147721,2021,Netherlands,USA,0,0,0,0,17/06/2021,0,0,0,0,0,0,0,0,0,0,0,0,0,0,0,0,0,0,0,0
3232,147721,2021,USA,France,0,0,0,0,16/06/2021,0,0,0,0,0,0,0,0,0,0,0,0,0,0,0,0,0,0,0,0
3233,147721,2021,Italy,USA,0,0,0,0,15/06/2021,0,0,0,0,0,0,0,0,0,0,0,0,0,0,0,0,0,0,0,0
3234,147721,2021,Germany,USA,0,0,0,0,10/06/2021,0,0,0,0,0,0,0,0,0,0,0,0,0,0,0,0,0,0,0,0
3235,147721,2021,Iran,USA,0,0,10,10,09/06/2021,0,0,0,0,2,0,6,8,3,5,3,11,1,0,0,1,3,0,0,3
3236,147721,2021,USA,Australia,0,4,4,8,05/06/2021,0,0,0,0,6,0,6,12,1,3,5,9,1,0,2,3,4,0,1,5
3237,147721,2021,Poland,USA,0,0,0,0,04/06/2021,0,0,0,0,0,0,0,0,0,0,0,0,0,0,0,0,0,0,0,0
3238,147721,2021,Russia,USA,1,1,5,7,03/06/2021,0,0,0,0,4,1,0,5,0,2,1,3,0,0,0,0,2,0,0,2
3239,147721,2021,USA,Argentina,0,0,0,0,30/05/2021,0,0,0,0,0,0,0,0,0,0,0,0,0,0,0,0,0,0,0,0
3240,147721,2021,USA,Brazil,0,2,7,9,29/05/2021,0,0,0,0,5,0,3,8,2,0,0,2,0,0,0,0,0,0,0,0
3241,147417,2021,USA,Japan,0,0,0,0,23/06/2021,0,0,0,0,0,0,0,0,0,0,0,0,0,0,0,0,0,0,0,0
3242,147417,2021,Bulgaria,USA,0,1,10,11,22/06/2021,0,0,1,1,8,4,3,15,0,4,2,6,0,0,0,0,6,2,0,8
3243,147417,2021,Slovenia,USA,0,1,3,4,21/06/2021,0,0,1,1,5,3,2,10,0,2,0,2,0,0,0,0,0,0,1,1
3244,147417,2021,Netherlands,USA,0,0,0,0,17/06/2021,0,0,0,0,0,0,0,0,0,0,0,0,0,0,0,0,0,0,0,0
3245,147417,2021,USA,France,2,5,9,16,16/06/2021,0,0,1,1,7,5,13,25,5,4,4,13,0,0,1,1,6,3,0,9
3246,147417,2021,Italy,USA,0,0,0,0,15/06/2021,0,0,0,0,0,0,0,0,0,0,0,0,0,0,0,0,0,0,0,0
3247,147417,2021,Germany,USA,1,3,9,13,10/06/2021,0,0,1,1,7,1,6,14,1,3,4,8,0,0,0,0,6,1,2,9
3248,147417,2021,Iran,USA,0,0,1,1,09/06/2021,0,0,0,0,2,1,1,4,1,1,1,3,0,0,0,0,1,0,0,1
3249,147417,2021,USA,Australia,0,1,9,10,05/06/2021,0,0,1,1,9,3,8,20,2,2,3,7,0,0,0,0,4,1,0,5
3250,147417,2021,Poland,USA,0,2,1,3,04/06/2021,0,0,0,0,2,2,3,7,1,0,2,3,0,0,0,0,2,0,0,2
3251,147417,2021,Russia,USA,0,2,7,9,03/06/2021,0,0,2,2,6,2,4,12,0,1,4,5,0,0,0,0,3,1,0,4
3252,147417,2021,USA,Argentina,0,2,6,8,30/05/2021,0,0,0,0,13,0,5,18,3,1,1,5,0,0,0,0,4,0,0,4
3253,147417,2021,USA,Brazil,0,0,0,0,29/05/2021,0,0,0,0,0,0,0,0,0,0,0,0,0,0,0,0,0,0,0,0
3254,147417,2021,USA,Canada,1,5,5,11,28/05/2021,0,0,0,0,11,4,18,33,1,2,2,5,1,0,0,1,6,2,0,8
3255,140185,2021,USA,Japan,0,0,0,0,23/06/2021,0,0,0,0,0,0,0,0,0,0,0,0,0,0,0,0,0,0,0,0
3256,140185,2021,Bulgaria,USA,3,2,9,14,22/06/2021,0,0,0,0,3,1,2,6,1,3,8,12,0,0,0,0,1,0,0,1
3257,140185,2021,Slovenia,USA,1,3,0,4,21/06/2021,0,0,0,0,4,0,0,4,0,2,0,2,0,0,0,0,0,0,0,0
3258,140185,2021,Netherlands,USA,1,4,11,16,17/06/2021,0,0,1,1,7,1,3,11,3,4,7,14,1,0,0,1,4,0,0,4
3259,140185,2021,USA,France,1,7,13,21,16/06/2021,0,0,1,1,6,2,5,13,3,9,9,21,1,0,0,1,4,0,2,6
3260,140185,2021,Italy,USA,2,1,3,6,15/06/2021,0,0,1,1,1,1,1,3,1,1,1,3,0,0,0,0,1,0,0,1
3261,140185,2021,USA,Serbia,0,0,0,0,11/06/2021,0,0,0,0,0,0,0,0,0,0,0,0,0,0,0,0,0,0,0,0
3262,140185,2021,Germany,USA,0,5,6,11,10/06/2021,0,0,1,1,5,0,2,7,1,0,5,6,0,0,0,0,3,0,0,3
3263,140185,2021,Iran,USA,0,0,0,0,09/06/2021,0,0,0,0,0,0,0,0,0,0,0,0,0,0,0,0,0,0,0,0
3264,140185,2021,USA,Australia,0,0,0,0,05/06/2021,0,0,0,0,0,0,0,0,0,0,0,0,0,0,0,0,0,0,0,0
3265,140185,2021,Poland,USA,1,3,9,13,04/06/2021,0,0,1,1,4,1,5,10,3,0,0,3,1,0,0,1,0,1,0,1
3266,140185,2021,Russia,USA,0,2,2,4,03/06/2021,0,0,0,0,4,0,2,6,1,2,1,4,1,0,2,3,0,0,1,1
3267,140185,2021,USA,Brazil,1,5,5,11,29/05/2021,0,0,1,1,5,1,5,11,2,0,0,2,2,0,1,3,0,0,0,0
3268,118913,2021,USA,Japan,0,0,0,0,23/06/2021,0,0,0,0,0,0,0,0,0,0,0,0,0,0,0,0,0,0,0,0
3269,118913,2021,Bulgaria,USA,1,1,11,13,22/06/2021,22,0,45,67,2,0,0,2,0,3,1,4,0,0,0,0,3,0,1,4
3270,118913,2021,Slovenia,USA,0,0,0,0,21/06/2021,0,0,0,0,0,0,0,0,0,0,0,0,0,0,0,0,0,0,0,0
3271,118913,2021,Netherlands,USA,0,0,0,0,17/06/2021,0,0,0,0,0,0,0,0,0,0,0,0,0,0,0,0,0,0,0,0
3272,118913,2021,USA,France,0,3,12,15,16/06/2021,33,0,76,109,3,0,1,4,1,4,3,8,0,0,0,0,9,0,1,10
3273,118913,2021,Italy,USA,0,0,0,0,15/06/2021,0,0,0,0,0,0,0,0,0,0,0,0,0,0,0,0,0,0,0,0
3274,118913,2021,USA,Serbia,0,0,0,0,11/06/2021,1,0,4,5,0,0,0,0,0,0,0,0,0,0,0,0,0,0,0,0
3275,118913,2021,Germany,USA,1,2,8,11,10/06/2021,20,0,33,53,1,0,0,1,4,1,2,7,0,0,0,0,7,0,0,7
3276,118913,2021,Iran,USA,0,0,7,7,09/06/2021,20,1,59,80,1,0,0,1,0,1,3,4,0,0,0,0,4,1,2,7
3277,118913,2021,USA,Australia,0,0,1,1,05/06/2021,2,0,7,9,0,0,0,0,0,0,0,0,0,0,0,0,0,1,0,1
3278,118913,2021,Russia,USA,0,0,0,0,03/06/2021,0,0,0,0,0,0,0,0,0,0,0,0,0,0,0,0,0,0,0,0
3279,118913,2021,USA,Brazil,0,0,0,0,29/05/2021,0,0,0,0,0,0,0,0,0,0,0,0,0,0,0,0,0,0,0,0
3280,118913,2021,USA,Canada,0,0,0,0,28/05/2021,0,0,0,0,0,0,0,0,0,0,0,0,0,0,0,0,0,0,0,0
3281,139254,2021,USA,Japan,0,4,5,9,23/06/2021,0,0,5,5,11,3,6,20,4,3,0,7,5,0,7,12,0,3,0,3
3282,139254,2021,Bulgaria,USA,0,0,0,0,22/06/2021,0,0,0,0,0,0,0,0,0,0,0,0,0,0,0,0,0,0,0,0
3283,139254,2021,Slovenia,USA,1,2,17,20,21/06/2021,0,0,3,3,15,2,12,29,1,7,2,10,8,1,25,34,12,3,2,17
3284,139254,2021,Netherlands,USA,0,0,0,0,17/06/2021,0,0,0,0,0,0,0,0,0,0,0,0,0,0,0,0,0,0,0,0
3285,139254,2021,USA,France,0,4,13,17,16/06/2021,0,0,5,5,19,5,21,45,2,4,3,9,14,0,21,35,9,3,2,14
3286,139254,2021,Italy,USA,0,3,8,11,15/06/2021,0,0,1,1,8,1,10,19,0,1,0,1,1,0,13,14,10,2,1,13
3287,139254,2021,USA,Serbia,0,4,8,12,11/06/2021,0,0,5,5,20,1,9,30,2,2,0,4,7,1,12,20,4,3,0,7
3288,139254,2021,Germany,USA,0,0,2,2,10/06/2021,0,0,0,0,0,0,0,0,0,0,0,0,0,0,0,0,0,0,0,0
3289,139254,2021,Iran,USA,0,1,8,9,09/06/2021,0,0,1,1,5,5,12,22,0,0,3,3,6,1,6,13,2,1,0,3
3290,139254,2021,USA,Australia,0,0,0,0,05/06/2021,0,0,0,0,0,0,0,0,0,0,0,0,0,0,0,0,0,0,0,0
3291,139254,2021,Poland,USA,0,1,1,2,04/06/2021,0,0,1,1,3,3,3,9,0,1,0,1,4,0,10,14,0,1,0,1
3292,139254,2021,Russia,USA,0,4,12,16,03/06/2021,0,0,2,2,10,7,9,26,2,3,2,7,3,1,18,22,6,2,1,9
3293,139254,2021,USA,Argentina,0,6,6,12,30/05/2021,0,0,6,6,15,3,9,27,5,5,0,10,14,0,22,36,4,0,2,6
3294,139254,2021,USA,Brazil,2,1,9,12,29/05/2021,0,0,2,2,7,2,10,19,1,0,1,2,12,3,17,32,1,0,0,1
3295,139254,2021,USA,Canada,1,3,8,12,28/05/2021,0,0,0,0,13,6,5,24,1,0,2,3,5,1,12,18,8,3,0,11
3296,170104,2021,USA,Japan,0,0,0,0,23/06/2021,0,0,0,0,0,0,0,0,0,0,0,0,0,0,0,0,0,0,0,0
3297,170104,2021,Bulgaria,USA,0,1,6,7,22/06/2021,0,0,1,1,2,0,1,3,0,1,0,1,0,0,0,0,0,0,1,1
3298,170104,2021,Iran,USA,0,0,0,0,09/06/2021,0,0,0,0,0,0,0,0,0,0,0,0,0,0,0,0,0,0,0,0
3299,170104,2021,USA,Canada,0,0,0,0,28/05/2021,0,0,0,0,0,0,0,0,0,0,0,0,0,0,0,0,0,0,0,0
3300,124879,2021,USA,Japan,1,1,16,18,23/06/2021,22,0,33,55,3,1,2,6,1,0,1,2,0,0,0,0,9,2,1,12
3301,124879,2021,Bulgaria,USA,0,0,0,0,22/06/2021,0,0,0,0,0,0,0,0,0,0,0,0,0,0,0,0,0,0,0,0
3302,124879,2021,Slovenia,USA,0,3,18,21,21/06/2021,42,0,66,108,0,0,4,4,1,10,5,16,0,0,1,1,7,2,2,11
3303,124879,2021,Netherlands,USA,3,2,16,21,17/06/2021,28,0,63,91,3,0,1,4,0,0,3,3,0,0,0,0,6,1,2,9
3304,124879,2021,USA,France,0,0,0,0,16/06/2021,0,0,0,0,0,0,0,0,0,0,0,0,0,0,0,0,0,0,0,0
3305,124879,2021,Italy,USA,2,2,9,13,15/06/2021,17,1,51,69,0,0,1,1,0,2,1,3,0,0,0,0,5,1,0,6
3306,124879,2021,USA,Australia,1,2,10,13,05/06/2021,21,0,34,55,2,0,2,4,1,4,4,9,0,0,0,0,6,3,1,10
3307,124879,2021,Poland,USA,0,2,5,7,04/06/2021,21,1,29,51,0,0,2,2,0,1,0,1,0,0,0,0,1,3,0,4
3308,124879,2021,Russia,USA,1,3,13,17,03/06/2021,35,0,50,85,4,0,2,6,0,4,2,6,0,0,1,1,4,6,2,12
3309,124879,2021,USA,Argentina,3,2,16,21,30/05/2021,37,0,45,82,1,0,0,1,1,3,2,6,0,0,0,0,2,2,0,4
3310,124879,2021,USA,Brazil,1,1,14,16,29/05/2021,19,0,58,77,0,1,1,2,0,0,0,0,0,0,0,0,0,0,0,0
3311,124879,2021,USA,Canada,1,0,12,13,28/05/2021,29,0,59,88,3,0,3,6,1,2,1,4,0,0,0,0,2,0,0,2
3312,118901,2021,USA,Japan,0,2,12,14,23/06/2021,0,0,1,1,6,1,0,7,4,4,1,9,0,0,0,0,1,0,0,1
3313,118901,2021,Bulgaria,USA,0,0,0,0,22/06/2021,0,0,0,0,0,0,0,0,0,0,0,0,0,0,0,0,0,0,0,0
3314,118901,2021,Slovenia,USA,1,3,12,16,21/06/2021,0,0,2,2,9,2,4,15,2,4,2,8,0,0,0,0,5,1,0,6
3315,118901,2021,Netherlands,USA,0,0,0,0,17/06/2021,0,0,0,0,0,0,0,0,0,0,0,0,0,0,0,0,0,0,0,0
3316,118901,2021,USA,France,0,5,9,14,16/06/2021,0,0,3,3,10,0,5,15,2,4,5,11,0,0,0,0,4,0,0,4
3317,118901,2021,Italy,USA,1,2,1,4,15/06/2021,0,0,0,0,2,0,3,5,1,1,4,6,0,0,1,1,2,0,0,2
3318,118901,2021,USA,Serbia,2,2,11,15,11/06/2021,0,0,2,2,3,2,4,9,2,4,1,7,2,0,0,2,1,0,0,1
3319,118901,2021,Germany,USA,0,0,0,0,10/06/2021,0,0,0,0,0,0,0,0,0,0,0,0,0,0,0,0,0,0,0,0
3320,118901,2021,Poland,USA,0,3,3,6,04/06/2021,0,0,0,0,1,2,5,8,3,0,0,3,0,0,0,0,1,1,0,2
3321,118901,2021,USA,Argentina,1,5,18,24,30/05/2021,0,0,2,2,6,0,3,9,0,2,0,2,0,0,1,1,2,0,0,2
3322,118901,2021,USA,Brazil,0,0,0,0,29/05/2021,0,0,0,0,0,0,0,0,0,0,0,0,0,0,0,0,0,0,0,0
3323,118901,2021,USA,Canada,1,5,5,11,28/05/2021,1,0,0,1,3,0,4,7,1,1,3,5,0,0,1,1,2,0,0,2
3324,136074,2021,USA,Serbia,1,3,4,8,11/06/2021,0,0,1,1,10,2,2,14,0,3,0,3,0,0,0,0,2,2,0,4
3325,136074,2021,Germany,USA,0,1,0,1,10/06/2021,0,0,0,0,1,0,1,2,1,1,0,2,0,0,0,0,1,0,0,1
3326,136074,2021,Iran,USA,0,5,5,10,09/06/2021,0,0,1,1,14,3,9,26,0,2,1,3,0,0,0,0,4,2,2,8
3327,136074,2021,USA,Australia,0,0,0,0,05/06/2021,0,0,0,0,0,0,0,0,0,0,0,0,0,0,0,0,0,0,0,0
3328,136074,2021,Poland,USA,0,0,7,7,04/06/2021,0,0,0,0,5,3,6,14,0,0,1,1,0,0,1,1,3,2,0,5
3329,136074,2021,Russia,USA,0,2,2,4,03/06/2021,0,0,1,1,4,3,7,14,0,0,1,1,0,0,0,0,2,1,0,3
3330,136074,2021,USA,Argentina,1,3,2,6,30/05/2021,0,0,1,1,6,6,3,15,3,1,0,4,0,0,0,0,2,0,2,4
3331,136074,2021,USA,Brazil,0,5,6,11,29/05/2021,0,0,1,1,15,6,9,30,3,0,0,3,0,0,0,0,0,0,0,0
3332,136074,2021,USA,Canada,0,0,0,0,28/05/2021,0,0,0,0,0,0,0,0,0,0,0,0,0,0,0,0,0,0,0,0
3333,147725,2021,USA,Japan,0,0,0,0,23/06/2021,0,0,0,0,0,0,0,0,0,0,0,0,0,0,0,0,0,0,0,0
3334,147725,2021,Bulgaria,USA,0,0,0,0,22/06/2021,0,0,0,0,0,0,0,0,0,0,0,0,0,0,0,0,0,0,0,0
3335,147725,2021,Slovenia,USA,0,0,0,0,21/06/2021,0,0,0,0,0,0,0,0,0,0,0,0,0,0,0,0,0,0,0,0
3336,147725,2021,USA,France,0,0,0,0,16/06/2021,0,0,0,0,0,0,0,0,0,0,0,0,0,0,0,0,0,0,0,0
3337,147725,2021,USA,Serbia,0,3,4,7,11/06/2021,0,0,1,1,5,4,6,15,0,1,0,1,5,3,7,15,0,3,0,3
3338,147725,2021,Germany,USA,1,5,4,10,10/06/2021,0,0,2,2,9,4,10,23,2,2,2,6,3,3,9,15,3,0,1,4
3339,147725,2021,Iran,USA,1,1,5,7,09/06/2021,0,0,1,1,0,2,1,3,0,1,0,1,3,0,3,6,0,0,0,0
3340,147725,2021,Russia,USA,0,0,0,0,03/06/2021,0,0,0,0,0,0,0,0,0,0,0,0,0,0,0,0,0,0,0,0
3341,147725,2021,USA,Argentina,0,0,0,0,30/05/2021,0,0,0,0,0,0,0,0,0,0,0,0,0,0,0,0,0,0,0,0
3342,147725,2021,USA,Brazil,0,0,0,0,29/05/2021,0,0,0,0,0,0,0,0,0,0,0,0,0,0,0,0,0,0,0,0
3343,147725,2021,USA,Canada,0,0,0,0,28/05/2021,0,0,0,0,0,0,0,0,0,0,0,0,0,0,0,0,0,0,0,0
3344,147543,2021,USA,Serbia,0,4,13,17,11/06/2021,25,0,63,88,2,1,1,4,0,3,1,4,0,0,0,0,4,1,0,5
3345,147543,2021,Germany,USA,0,0,0,0,10/06/2021,2,0,2,4,1,0,0,1,0,0,0,0,0,0,0,0,0,0,0,0
3346,147543,2021,Iran,USA,0,0,0,0,09/06/2021,0,0,1,1,0,0,0,0,0,0,0,0,0,0,1,1,0,0,0,0
3347,147543,2021,Poland,USA,0,0,4,4,04/06/2021,12,0,17,29,1,0,0,1,0,0,1,1,0,0,0,0,3,2,0,5
3348,147543,2021,USA,Argentina,0,0,0,0,30/05/2021,0,0,0,0,0,0,0,0,0,0,0,0,0,0,0,0,0,0,0,0
3349,143682,2021,USA,Japan,0,0,0,0,23/06/2021,0,0,0,0,0,0,0,0,0,0,0,0,0,0,0,0,0,0,0,0
3350,143682,2021,Bulgaria,USA,1,3,7,11,22/06/2021,0,0,2,2,7,1,10,18,2,2,3,7,6,0,11,17,9,5,0,14
3351,143682,2021,Slovenia,USA,0,0,0,0,21/06/2021,0,0,0,0,0,0,0,0,0,0,0,0,0,1,0,1,0,0,0,0
3352,143682,2021,Netherlands,USA,0,0,0,0,17/06/2021,0,0,0,0,0,0,0,0,0,0,0,0,0,0,0,0,0,0,0,0
3353,143682,2021,USA,France,0,0,15,15,16/06/2021,0,0,2,2,12,5,13,30,1,5,5,11,13,2,14,29,6,2,1,9
3354,143682,2021,Italy,USA,0,0,0,0,15/06/2021,0,0,0,0,0,0,0,0,0,0,0,0,0,0,0,0,0,0,0,0
3355,143682,2021,USA,Australia,3,1,11,15,05/06/2021,0,0,1,1,4,3,8,15,1,1,0,2,11,0,17,28,1,1,1,3
3356,143682,2021,Poland,USA,0,2,1,3,04/06/2021,0,0,0,0,2,0,3,5,0,1,0,1,2,0,2,4,0,3,0,3
3357,143682,2021,Russia,USA,1,2,12,15,03/06/2021,0,0,2,2,14,2,5,21,1,2,2,5,5,1,15,21,6,7,2,15
3358,143682,2021,USA,Argentina,0,0,0,0,30/05/2021,0,0,0,0,0,0,0,0,0,0,0,0,0,0,0,0,0,0,0,0
3359,143682,2021,USA,Brazil,0,1,4,5,29/05/2021,0,0,0,0,4,3,6,13,1,1,0,2,8,1,8,17,0,0,0,0
3360,143682,2021,USA,Canada,0,0,0,0,28/05/2021,0,0,0,0,0,0,0,0,0,0,0,0,0,0,0,0,0,0,0,0
3361,133463,2021,USA,Japan,0,2,7,9,23/06/2021,0,0,3,3,12,1,3,16,0,2,0,2,13,1,12,26,4,6,0,10
3362,133463,2021,Bulgaria,USA,0,3,6,9,22/06/2021,0,0,1,1,13,2,8,23,0,0,3,3,7,0,7,14,6,1,1,8
3363,133463,2021,Slovenia,USA,1,1,3,5,21/06/2021,0,0,0,0,0,0,1,1,0,1,0,1,0,0,1,1,1,0,0,1
3364,133463,2021,Netherlands,USA,3,4,15,22,17/06/2021,0,0,0,0,17,3,10,30,1,2,3,6,13,3,12,28,7,1,0,8
3365,133463,2021,USA,France,0,0,2,2,16/06/2021,0,0,0,0,0,0,0,0,0,0,0,0,0,0,0,0,0,0,0,0
3366,133463,2021,Italy,USA,0,1,0,1,15/06/2021,0,0,0,0,0,0,0,0,0,0,0,0,0,0,0,0,0,0,0,0
3367,133463,2021,USA,Serbia,0,2,7,9,11/06/2021,0,0,0,0,4,1,7,12,1,1,0,2,12,1,5,18,2,2,0,4
3368,133463,2021,Germany,USA,2,2,14,18,10/06/2021,0,0,1,1,9,0,6,15,1,2,2,5,2,1,9,12,3,2,0,5
3369,133463,2021,Iran,USA,0,0,12,12,09/06/2021,0,0,1,1,11,2,6,19,1,4,1,6,8,4,14,26,9,1,1,11
3370,133463,2021,USA,Australia,0,1,1,2,05/06/2021,0,0,0,0,0,0,0,0,0,0,0,0,0,0,0,0,0,0,0,0
3371,133463,2021,Poland,USA,1,1,6,8,04/06/2021,0,0,1,1,2,2,8,12,0,1,2,3,5,1,8,14,5,1,0,6
3372,133463,2021,Russia,USA,0,0,0,0,03/06/2021,0,0,0,0,0,0,0,0,0,0,0,0,0,0,0,0,0,0,0,0
3373,133463,2021,USA,Argentina,1,2,12,15,30/05/2021,0,0,5,5,5,5,11,21,0,2,1,3,7,0,7,14,9,4,2,15
3374,133463,2021,USA,Brazil,0,0,2,2,29/05/2021,0,0,0,0,0,1,3,4,0,0,0,0,0,1,2,3,0,0,0,0
3375,133463,2021,USA,Canada,0,2,10,12,28/05/2021,0,0,0,0,5,2,8,15,0,0,0,0,10,2,12,24,4,2,0,6
3376,148120,2021,USA,Serbia,0,0,0,0,11/06/2021,0,0,0,0,0,0,0,0,0,0,0,0,0,0,0,0,0,0,0,0
3377,148120,2021,Iran,USA,0,3,8,11,09/06/2021,0,0,0,0,2,2,1,5,1,3,2,6,0,0,1,1,2,0,1,3
3378,148120,2021,USA,Australia,0,0,0,0,05/06/2021,0,0,0,0,0,0,0,0,0,0,0,0,0,0,0,0,0,0,0,0
3379,148120,2021,Poland,USA,0,0,3,3,04/06/2021,0,0,1,1,3,1,0,4,1,0,1,2,0,0,0,0,0,0,1,1
3380,148120,2021,Russia,USA,0,0,8,8,03/06/2021,0,0,1,1,4,0,2,6,1,1,0,2,0,0,0,0,1,0,1,2
3381,148120,2021,USA,Argentina,0,0,0,0,30/05/2021,0,0,0,0,0,0,0,0,0,0,0,0,0,0,0,0,0,0,0,0
3382,148120,2021,USA,Canada,0,1,14,15,28/05/2021,0,0,0,0,8,0,4,12,1,3,0,4,0,0,0,0,2,1,0,3
3383,116069,2021,USA,Japan,0,4,8,12,23/06/2021,0,0,4,4,5,0,6,11,1,4,2,7,0,0,0,0,3,0,0,3
3384,116069,2021,Bulgaria,USA,0,0,0,0,22/06/2021,0,0,0,0,0,0,0,0,0,0,0,0,0,0,0,0,0,0,0,0
3385,116069,2021,Slovenia,USA,1,1,12,14,21/06/2021,0,0,2,2,4,4,3,11,1,6,4,11,0,0,0,0,5,0,1,6
3386,116069,2021,Netherlands,USA,1,4,13,18,17/06/2021,0,0,3,3,8,1,1,10,0,6,6,12,1,0,1,2,4,0,1,5
3387,116069,2021,USA,France,0,0,0,0,16/06/2021,0,0,0,0,0,0,0,0,0,0,0,0,0,0,0,0,0,0,0,0
3388,116069,2021,Italy,USA,1,1,13,15,15/06/2021,0,0,0,0,3,0,2,5,2,1,3,6,1,0,0,1,5,2,0,7
3389,116069,2021,USA,Serbia,4,2,11,17,11/06/2021,0,0,0,0,4,1,4,9,1,3,1,5,1,0,3,4,1,1,0,2
3390,116069,2021,Germany,USA,1,3,7,11,10/06/2021,0,0,2,2,3,1,4,8,1,2,4,7,1,0,0,1,4,0,0,4
3391,116069,2021,Iran,USA,0,0,0,0,09/06/2021,0,0,0,0,0,0,0,0,0,0,0,0,0,0,0,0,0,0,0,0
3392,116069,2021,USA,Australia,1,2,9,12,05/06/2021,0,0,0,0,5,0,0,5,3,2,3,8,0,0,0,0,3,0,1,4
3393,116069,2021,Russia,USA,0,1,5,6,03/06/2021,0,0,0,0,2,1,2,5,0,2,1,3,0,0,0,0,2,1,0,3
3394,116069,2021,USA,Argentina,0,5,6,11,30/05/2021,0,0,1,1,8,2,4,14,0,0,1,1,0,0,0,0,1,0,0,1
3395,116069,2021,USA,Brazil,0,0,0,0,29/05/2021,0,0,0,0,0,0,0,0,0,0,0,0,0,0,0,0,0,0,0,0
3396,116069,2021,USA,Canada,0,0,0,0,28/05/2021,0,0,0,0,0,0,0,0,0,0,0,0,0,0,0,0,0,0,0,0
3397,133895,2021,Netherlands,USA,0,0,0,0,17/06/2021,0,0,2,2,0,0,0,0,0,0,0,0,3,1,5,9,7,3,1,11
3398,133895,2021,USA,France,0,0,0,0,16/06/2021,0,0,0,0,0,0,0,0,0,0,0,0,0,0,0,0,0,0,0,0
3399,133895,2021,Italy,USA,0,0,0,0,15/06/2021,0,0,0,0,0,0,0,0,0,0,0,0,0,0,0,0,0,0,0,0
3400,133895,2021,USA,Serbia,0,0,0,0,11/06/2021,0,0,0,0,0,0,0,0,0,0,0,0,0,0,0,0,0,0,0,0
3401,133895,2021,Germany,USA,0,0,0,0,10/06/2021,0,0,0,0,0,0,0,0,0,0,0,0,0,0,0,0,0,0,0,0
3402,133895,2021,USA,Australia,0,0,0,0,05/06/2021,0,0,8,8,0,0,0,0,0,0,0,0,3,1,10,14,7,2,0,9
3403,133895,2021,Poland,USA,0,0,0,0,04/06/2021,0,0,0,0,0,0,0,0,0,0,0,0,0,0,0,0,0,0,0,0
3404,133895,2021,Russia,USA,0,0,0,0,03/06/2021,0,0,0,0,0,0,0,0,0,0,0,0,0,0,0,0,0,0,0,0
3405,133895,2021,USA,Argentina,0,0,0,0,30/05/2021,0,0,0,0,0,0,0,0,0,0,0,0,0,0,0,0,0,0,0,0
3406,133895,2021,USA,Brazil,0,0,0,0,29/05/2021,0,0,0,0,0,0,0,0,0,0,0,0,0,0,0,0,0,0,0,0
3407,133895,2021,USA,Canada,0,0,0,0,28/05/2021,0,0,0,0,0,0,0,0,0,0,0,0,0,0,0,0,0,0,0,0
3408,119732,2021,USA,Japan,0,0,0,0,23/06/2021,0,0,4,4,0,0,0,0,0,0,0,0,6,1,8,15,1,0,2,3
3409,119732,2021,Bulgaria,USA,0,0,0,0,22/06/2021,0,0,6,6,0,0,0,0,0,0,0,0,3,0,7,10,8,3,0,11
3410,119732,2021,Slovenia,USA,0,0,0,0,21/06/2021,0,0,7,7,0,0,0,0,0,0,0,0,2,0,12,14,9,0,0,9
3411,119732,2021,Netherlands,USA,0,0,0,0,17/06/2021,0,0,3,3,0,0,0,0,0,0,0,0,5,1,3,9,7,0,0,7
3412,119732,2021,USA,France,0,0,0,0,16/06/2021,0,0,8,8,0,0,0,0,0,0,0,0,8,1,12,21,14,3,0,17
3413,119732,2021,Italy,USA,0,0,0,0,15/06/2021,0,0,3,3,0,0,0,0,0,0,0,0,5,2,2,9,6,5,0,11
3414,119732,2021,USA,Serbia,0,0,0,0,11/06/2021,0,0,3,3,0,0,0,0,0,0,0,0,12,0,10,22,1,5,0,6
3415,119732,2021,Germany,USA,0,0,0,0,10/06/2021,0,0,5,5,0,0,0,0,0,0,0,0,5,0,7,12,6,1,0,7
3416,119732,2021,Iran,USA,0,0,0,0,09/06/2021,0,0,8,8,0,0,0,0,0,0,0,0,4,0,11,15,9,3,0,12
3417,119732,2021,USA,Australia,0,0,0,0,05/06/2021,0,0,0,0,0,0,0,0,0,0,0,0,0,0,0,0,0,0,0,0
3418,119732,2021,Poland,USA,0,0,0,0,04/06/2021,0,0,1,1,0,0,0,0,0,0,0,0,4,0,11,15,8,7,0,15
3419,119732,2021,Russia,USA,0,0,0,0,03/06/2021,0,0,5,5,0,0,0,0,0,0,0,0,10,0,17,27,8,2,1,11
3420,119732,2021,USA,Argentina,0,0,0,0,30/05/2021,0,0,3,3,0,0,0,0,0,0,0,0,9,1,5,15,6,5,0,11
3421,119732,2021,USA,Brazil,0,0,0,0,29/05/2021,0,0,1,1,0,0,0,0,0,0,0,0,4,1,2,7,2,0,0,2
3422,119732,2021,USA,Canada,0,0,0,0,28/05/2021,0,0,2,2,0,0,0,0,0,0,0,0,3,0,7,10,16,3,0,19
3423,142412,2022,USA,Argentina,0,1,3,4,10/07/2022,2,0,1,3,0,0,0,0,0,0,0,0,0,0,0,0,0,0,0,0
3424,142412,2022,France,Argentina,0,0,3,3,09/07/2022,1,0,1,2,0,0,0,0,0,0,0,0,0,0,0,0,0,0,0,0
3425,142412,2022,Argentina,Australia,0,0,0,0,08/07/2022,0,0,0,0,0,0,0,0,0,0,0,0,0,0,0,0,0,0,0,0
3426,142412,2022,Canada,Argentina,0,0,0,0,05/07/2022,0,0,7,7,0,0,0,0,0,0,0,0,0,0,0,0,0,0,0,0
3427,142412,2022,Argentina,Netherlands,0,1,14,15,25/06/2022,35,0,59,94,1,0,1,2,0,3,7,10,0,1,1,2,4,7,4,15
3428,142412,2022,Argentina,China,0,0,17,17,24/06/2022,36,0,41,77,1,0,0,1,0,1,1,2,0,0,0,0,6,1,1,8
3429,142412,2022,Argentina,Slovenia,0,2,6,8,23/06/2022,25,0,42,67,1,1,0,2,1,1,1,3,0,0,0,0,7,2,0,9
3430,142412,2022,Argentina,Japan,0,2,13,15,21/06/2022,25,0,44,69,1,0,0,1,0,1,0,1,0,0,1,1,4,0,1,5
3431,142412,2022,Argentina,Italy,0,1,9,10,12/06/2022,47,0,30,77,0,0,1,1,0,4,0,4,0,0,0,0,7,0,4,11
3432,142412,2022,Serbia,Argentina,0,0,4,4,10/06/2022,27,0,19,46,0,1,0,1,1,0,0,1,0,0,0,0,3,0,0,3
3433,142412,2022,Germany,Argentina,0,0,10,10,09/06/2022,23,0,44,67,0,0,2,2,0,1,0,1,0,0,1,1,6,0,2,8
3434,142412,2022,Poland,Argentina,1,1,8,10,08/06/2022,31,0,31,62,1,0,0,1,0,0,0,0,0,0,0,0,4,3,3,10
3435,174866,2022,,,-,-,-,-,-,-,-,-,-,-,-,-,-,-,-,-,-,-,-,-,-,-,-,-,-
3436,142410,2022,,,-,-,-,-,-,-,-,-,-,-,-,-,-,-,-,-,-,-,-,-,-,-,-,-,-
3437,142411,2022,USA,Argentina,0,1,12,13,10/07/2022,0,0,2,2,8,0,4,12,3,7,4,14,1,1,2,4,1,2,2,5
3438,142411,2022,France,Argentina,0,2,5,7,09/07/2022,0,0,1,1,5,1,4,10,1,2,4,7,0,0,1,1,2,0,1,3
3439,142411,2022,Argentina,Australia,0,1,16,17,08/07/2022,0,0,0,0,10,0,7,17,5,3,5,13,0,0,0,0,1,2,0,3
3440,142411,2022,Canada,Argentina,0,0,0,0,05/07/2022,0,0,0,0,0,0,0,0,0,0,0,0,0,0,0,0,0,0,0,0
3441,142411,2022,Argentina,Netherlands,0,0,0,0,25/06/2022,0,0,0,0,0,0,0,0,0,0,0,0,0,0,0,0,0,0,0,0
3442,142411,2022,Argentina,China,0,0,0,0,24/06/2022,0,0,0,0,0,0,0,0,0,0,0,0,0,0,0,0,0,0,0,0
3443,142411,2022,Argentina,Slovenia,0,0,0,0,23/06/2022,0,0,0,0,0,0,0,0,0,0,0,0,0,0,0,0,0,0,0,0
3444,142411,2022,Argentina,Japan,0,0,4,4,21/06/2022,0,0,0,0,0,2,2,4,1,3,3,7,0,0,0,0,1,0,0,1
3445,142411,2022,Argentina,Italy,0,3,10,13,12/06/2022,0,0,0,0,3,0,2,5,5,3,1,9,1,0,1,2,1,0,2,3
3446,142411,2022,Serbia,Argentina,0,0,0,0,10/06/2022,0,0,0,0,0,0,0,0,0,0,0,0,0,0,0,0,0,0,0,0
3447,142411,2022,Germany,Argentina,0,0,0,0,09/06/2022,0,0,0,0,0,0,0,0,0,0,0,0,0,0,0,0,0,0,0,0
3448,142411,2022,Poland,Argentina,0,0,0,0,08/06/2022,0,0,0,0,0,0,0,0,0,0,0,0,0,0,0,0,0,0,0,0
3449,171315,2022,,,-,-,-,-,-,-,-,-,-,-,-,-,-,-,-,-,-,-,-,-,-,-,-,-,-
3450,132647,2022,,,-,-,-,-,-,-,-,-,-,-,-,-,-,-,-,-,-,-,-,-,-,-,-,-,-
3451,118886,2022,,,-,-,-,-,-,-,-,-,-,-,-,-,-,-,-,-,-,-,-,-,-,-,-,-,-
3452,152692,2022,USA,Argentina,0,3,16,19,10/07/2022,0,0,0,0,9,3,7,19,2,7,3,12,0,0,1,1,4,1,3,8
3453,152692,2022,France,Argentina,1,5,10,16,09/07/2022,0,0,4,4,10,0,3,13,1,6,5,12,1,0,1,2,1,1,0,2
3454,152692,2022,Argentina,Australia,0,2,4,6,08/07/2022,0,0,0,0,5,2,1,8,2,2,2,6,0,0,0,0,2,0,0,2
3455,152692,2022,Canada,Argentina,0,4,14,18,05/07/2022,0,1,0,1,11,2,6,19,1,4,1,6,1,0,1,2,0,0,1,1
3456,152692,2022,Argentina,Netherlands,0,4,10,14,25/06/2022,0,0,1,1,10,1,4,15,6,7,6,19,1,0,5,6,1,1,0,2
3457,152692,2022,Argentina,China,0,4,13,17,24/06/2022,0,0,2,2,12,1,5,18,1,8,3,12,1,0,0,1,2,0,1,3
3458,152692,2022,Argentina,Slovenia,1,4,9,14,23/06/2022,0,0,1,1,6,2,7,15,5,5,4,14,2,0,0,2,3,0,1,4
3459,152692,2022,Argentina,Japan,0,3,11,14,21/06/2022,0,0,1,1,8,1,3,12,3,7,10,20,1,0,2,3,3,2,2,7
3460,152692,2022,Argentina,Italy,2,6,14,22,12/06/2022,0,0,2,2,12,2,7,21,2,7,9,18,1,0,3,4,4,0,4,8
3461,152692,2022,Serbia,Argentina,0,0,0,0,10/06/2022,0,0,0,0,0,0,0,0,0,0,0,0,0,0,0,0,0,0,0,0
3462,152692,2022,Germany,Argentina,3,2,18,23,09/06/2022,0,0,1,1,8,2,3,13,2,14,5,21,0,0,0,0,1,0,1,2
3463,152692,2022,Poland,Argentina,1,3,9,13,08/06/2022,0,0,0,0,4,1,5,10,1,3,5,9,0,0,0,0,0,0,0,0
3464,153053,2022,USA,Argentina,0,0,0,0,10/07/2022,0,0,6,6,0,0,0,0,0,0,0,0,11,1,9,21,12,4,2,18
3465,153053,2022,France,Argentina,0,0,0,0,09/07/2022,0,0,8,8,0,0,0,0,0,0,0,0,3,0,13,16,8,6,3,17
3466,153053,2022,Argentina,Australia,0,0,0,0,08/07/2022,0,0,6,6,0,0,0,0,0,0,0,0,13,0,2,15,10,1,1,12
3467,153053,2022,Canada,Argentina,0,0,0,0,05/07/2022,0,0,3,3,0,0,0,0,0,0,0,0,7,0,6,13,5,7,2,14
3468,153053,2022,Argentina,Netherlands,0,0,0,0,25/06/2022,0,0,3,3,0,0,0,0,0,0,0,0,8,2,6,16,12,7,0,19
3469,153053,2022,Argentina,China,0,0,0,0,24/06/2022,1,0,9,10,0,0,0,0,0,0,0,0,12,0,12,24,11,3,1,15
3470,153053,2022,Argentina,Slovenia,0,0,0,0,23/06/2022,1,1,7,9,0,0,0,0,0,0,0,0,7,1,8,16,12,10,1,23
3471,153053,2022,Argentina,Japan,0,0,0,0,21/06/2022,0,0,2,2,0,0,0,0,0,0,0,0,4,2,10,16,12,3,0,15
3472,153053,2022,Argentina,Italy,0,0,0,0,12/06/2022,0,0,5,5,0,0,0,0,0,0,0,0,6,1,13,20,11,5,6,22
3473,153053,2022,Serbia,Argentina,0,0,0,0,10/06/2022,0,0,4,4,0,0,0,0,0,0,0,0,3,0,19,22,6,1,4,11
3474,153053,2022,Germany,Argentina,0,0,0,0,09/06/2022,0,0,7,7,0,0,0,0,0,0,0,0,7,2,8,17,14,2,2,18
3475,153053,2022,Poland,Argentina,0,0,0,0,08/06/2022,0,0,9,9,0,0,0,0,0,0,0,0,6,1,10,17,4,3,2,9
3476,136737,2022,USA,Argentina,0,0,0,0,10/07/2022,0,0,0,0,0,0,0,0,0,0,0,0,0,0,0,0,0,0,0,0
3477,136737,2022,France,Argentina,0,0,0,0,09/07/2022,0,0,0,0,0,0,0,0,0,0,0,0,0,0,0,0,0,0,0,0
3478,136737,2022,Argentina,Australia,0,0,0,0,08/07/2022,0,0,0,0,0,0,0,0,0,0,0,0,0,0,0,0,0,0,0,0
3479,136737,2022,Canada,Argentina,0,1,1,2,05/07/2022,0,0,0,0,0,0,0,0,0,0,0,0,0,0,0,0,0,0,0,0
3480,136737,2022,Argentina,Netherlands,0,0,2,2,25/06/2022,0,0,0,0,0,0,0,0,0,0,0,0,0,0,0,0,1,0,0,1
3481,136737,2022,Argentina,China,0,0,0,0,24/06/2022,0,0,0,0,0,0,0,0,0,0,0,0,0,0,0,0,0,0,0,0
3482,136737,2022,Argentina,Slovenia,0,0,1,1,23/06/2022,0,0,0,0,0,0,0,0,0,0,0,0,0,0,0,0,0,0,0,0
3483,136737,2022,Argentina,Japan,1,3,14,18,21/06/2022,0,0,5,5,7,2,6,15,0,2,1,3,7,0,11,18,1,3,0,4
3484,136737,2022,Argentina,Italy,0,1,5,6,12/06/2022,0,0,2,2,3,0,4,7,0,0,2,2,0,0,4,4,2,1,2,5
3485,136737,2022,Serbia,Argentina,0,0,2,2,10/06/2022,0,0,1,1,1,0,0,1,0,0,0,0,1,3,3,7,0,0,0,0
3486,136737,2022,Germany,Argentina,0,1,16,17,09/06/2022,0,0,4,4,10,2,6,18,0,3,2,5,3,5,12,20,5,0,1,6
3487,136737,2022,Poland,Argentina,1,1,7,9,08/06/2022,0,0,1,1,9,3,13,25,0,0,4,4,1,0,13,14,7,3,0,10
3488,174853,2022,USA,Argentina,0,1,2,3,10/07/2022,0,0,2,2,4,2,4,10,0,1,0,1,4,0,5,9,1,1,1,3
3489,174853,2022,France,Argentina,0,0,0,0,09/07/2022,0,0,2,2,0,0,1,1,0,0,0,0,0,0,0,0,0,0,0,0
3490,174853,2022,Argentina,Australia,0,0,3,3,08/07/2022,0,0,0,0,2,3,4,9,0,0,0,0,3,0,5,8,1,0,1,2
3491,174853,2022,Canada,Argentina,0,0,0,0,05/07/2022,0,0,0,0,1,1,1,3,0,0,0,0,0,0,0,0,0,0,0,0
3492,174853,2022,Argentina,Netherlands,0,0,0,0,25/06/2022,0,0,0,0,0,0,0,0,0,0,0,0,0,0,0,0,0,0,0,0
3493,174853,2022,Argentina,China,0,0,0,0,24/06/2022,0,0,0,0,0,0,0,0,0,0,0,0,0,0,0,0,0,0,0,0
3494,174853,2022,Argentina,Slovenia,0,0,4,4,23/06/2022,0,0,0,0,2,3,3,8,1,0,1,2,1,1,4,6,2,1,0,3
3495,174853,2022,Argentina,Japan,0,0,0,0,21/06/2022,0,0,0,0,0,0,0,0,0,0,0,0,0,0,0,0,0,0,0,0
3496,174853,2022,Argentina,Italy,0,0,2,2,12/06/2022,0,0,1,1,1,4,3,8,1,0,0,1,3,1,3,7,0,2,0,2
3497,174853,2022,Serbia,Argentina,2,2,9,13,10/06/2022,1,0,3,4,8,5,8,21,3,3,1,7,5,0,15,20,1,1,2,4
3498,174853,2022,Germany,Argentina,0,1,2,3,09/06/2022,0,0,0,0,1,3,5,9,2,1,1,4,1,0,4,5,0,1,1,2
3499,174853,2022,Poland,Argentina,0,0,4,4,08/06/2022,0,0,0,0,3,0,2,5,0,3,0,3,2,1,7,10,1,3,0,4
3500,142415,2022,USA,Argentina,0,0,0,0,10/07/2022,0,0,0,0,0,0,0,0,0,0,0,0,0,0,0,0,0,0,0,0
3501,142415,2022,France,Argentina,0,0,1,1,09/07/2022,0,0,0,0,0,0,0,0,0,0,0,0,0,0,0,0,0,0,0,0
3502,142415,2022,Argentina,Australia,3,3,10,16,08/07/2022,1,0,0,1,16,5,3,24,0,6,3,9,0,0,0,0,6,5,1,12
3503,142415,2022,Canada,Argentina,0,3,4,7,05/07/2022,0,0,0,0,2,5,2,9,1,1,0,2,0,0,0,0,2,0,0,2
3504,142415,2022,Argentina,Netherlands,1,6,12,19,25/06/2022,0,0,0,0,19,3,9,31,1,7,2,10,0,1,0,1,6,2,1,9
3505,142415,2022,Argentina,China,2,4,15,21,24/06/2022,0,1,0,1,20,1,8,29,3,3,2,8,0,0,0,0,5,5,0,10
3506,142415,2022,Argentina,Slovenia,1,5,7,13,23/06/2022,0,0,0,0,11,5,13,29,0,2,2,4,2,0,3,5,6,0,1,7
3507,142415,2022,Argentina,Japan,0,7,6,13,21/06/2022,0,0,0,0,17,4,9,30,1,2,0,3,0,1,1,2,3,1,0,4
3508,142415,2022,Argentina,Italy,0,5,9,14,12/06/2022,0,0,2,2,17,6,11,34,1,7,4,12,0,2,2,4,2,1,6,9
3509,142415,2022,Serbia,Argentina,2,4,6,12,10/06/2022,0,0,1,1,11,7,12,30,2,2,2,6,1,0,0,1,3,4,1,8
3510,142415,2022,Germany,Argentina,1,4,11,16,09/06/2022,0,0,1,1,16,5,10,31,2,4,0,6,0,0,1,1,2,5,2,9
3511,142415,2022,Poland,Argentina,0,5,8,13,08/06/2022,0,0,1,1,7,3,12,22,1,3,5,9,0,0,1,1,2,2,0,4
3512,125048,2022,USA,Argentina,0,5,11,16,10/07/2022,1,0,2,3,16,6,14,36,0,6,2,8,3,0,16,19,4,4,2,10
3513,125048,2022,France,Argentina,1,6,8,15,09/07/2022,0,0,2,2,15,3,11,29,1,3,9,13,3,2,15,20,10,2,4,16
3514,125048,2022,Argentina,Australia,1,3,8,12,08/07/2022,0,0,1,1,10,3,3,16,1,2,0,3,7,2,15,24,6,2,4,12
3515,125048,2022,Canada,Argentina,1,5,7,13,05/07/2022,0,0,2,2,15,1,15,31,2,3,8,13,5,1,26,32,7,2,0,9
3516,125048,2022,Argentina,Netherlands,3,5,11,19,25/06/2022,0,0,3,3,15,2,10,27,1,2,5,8,11,2,13,26,2,4,0,6
3517,125048,2022,Argentina,China,1,5,8,14,24/06/2022,0,0,2,2,12,2,8,22,0,5,1,6,8,1,28,37,6,1,2,9
3518,125048,2022,Argentina,Slovenia,0,4,10,14,23/06/2022,0,0,3,3,11,3,10,24,1,4,4,9,9,3,16,28,6,3,1,10
3519,125048,2022,Argentina,Japan,0,0,12,12,21/06/2022,0,0,1,1,13,2,8,23,0,4,7,11,9,6,14,29,4,2,2,8
3520,125048,2022,Argentina,Italy,0,3,11,14,12/06/2022,1,0,3,4,7,0,7,14,0,5,4,9,0,0,10,10,7,1,3,11
3521,125048,2022,Serbia,Argentina,0,2,1,3,10/06/2022,0,0,0,0,2,2,2,6,0,2,2,4,3,1,9,13,1,0,3,4
3522,125048,2022,Germany,Argentina,2,0,10,12,09/06/2022,0,0,2,2,10,1,13,24,2,3,1,6,5,2,15,22,1,1,2,4
3523,125048,2022,Poland,Argentina,0,1,4,5,08/06/2022,0,0,3,3,4,2,7,13,1,2,0,3,0,1,12,13,2,3,1,6
3524,125049,2022,,,-,-,-,-,-,-,-,-,-,-,-,-,-,-,-,-,-,-,-,-,-,-,-,-,-
3525,117457,2022,USA,Argentina,1,3,19,23,10/07/2022,55,1,53,109,0,1,2,3,2,5,5,12,0,0,0,0,3,0,2,5
3526,117457,2022,France,Argentina,0,3,9,12,09/07/2022,28,0,60,88,2,1,1,4,0,2,2,4,0,0,0,0,4,3,2,9
3527,117457,2022,Argentina,Australia,3,1,12,16,08/07/2022,46,0,42,88,0,0,1,1,0,3,2,5,0,0,1,1,3,5,3,11
3528,117457,2022,Canada,Argentina,1,4,14,19,05/07/2022,28,0,63,91,0,0,0,0,1,2,3,6,0,0,0,0,5,0,0,5
3529,162546,2022,USA,Argentina,0,5,9,14,10/07/2022,0,0,1,1,24,3,10,37,0,4,2,6,2,0,7,9,6,3,1,10
3530,162546,2022,France,Argentina,1,3,10,14,09/07/2022,0,0,1,1,12,2,11,25,1,1,1,3,0,0,1,1,10,2,0,12
3531,162546,2022,Argentina,Australia,0,1,2,3,08/07/2022,0,0,0,0,1,2,2,5,0,0,0,0,2,1,4,7,0,1,0,1
3532,162546,2022,Canada,Argentina,0,1,12,13,05/07/2022,0,0,2,2,13,2,11,26,0,2,2,4,3,1,7,11,6,1,2,9
3533,162546,2022,Argentina,Netherlands,0,0,0,0,25/06/2022,0,0,0,0,0,0,0,0,0,0,0,0,0,0,0,0,0,0,0,0
3534,162546,2022,Argentina,China,0,0,0,0,24/06/2022,0,0,0,0,0,0,0,0,0,0,0,0,0,0,0,0,0,0,0,0
3535,162546,2022,Argentina,Slovenia,0,1,0,1,23/06/2022,0,0,0,0,0,1,2,3,0,0,0,0,0,0,0,0,1,0,0,1
3536,162546,2022,Argentina,Japan,0,1,0,1,21/06/2022,0,0,0,0,0,0,0,0,0,0,0,0,0,0,0,0,0,0,0,0
3537,162546,2022,Argentina,Italy,0,1,7,8,12/06/2022,0,0,4,4,8,6,11,25,0,2,3,5,1,3,16,20,2,1,2,5
3538,162546,2022,Serbia,Argentina,0,6,9,15,10/06/2022,0,0,4,4,18,3,11,32,0,5,2,7,4,2,13,19,2,3,2,7
3539,162546,2022,Germany,Argentina,0,0,0,0,09/06/2022,0,0,0,0,0,0,0,0,0,0,0,0,0,0,0,0,0,0,0,0
3540,162546,2022,Poland,Argentina,0,1,0,1,08/06/2022,0,0,0,0,0,0,0,0,0,0,0,0,0,0,0,0,0,0,0,0
3541,163555,2022,USA,Argentina,1,5,7,13,10/07/2022,0,0,4,4,5,3,8,16,0,1,0,1,8,1,20,29,4,2,0,6
3542,163555,2022,France,Argentina,2,6,12,20,09/07/2022,0,1,5,6,15,5,11,31,0,4,5,9,6,1,21,28,8,1,2,11
3543,163555,2022,Argentina,Australia,0,2,11,13,08/07/2022,0,0,2,2,7,4,4,15,1,0,0,1,8,0,5,13,5,0,1,6
3544,163555,2022,Canada,Argentina,0,1,7,8,05/07/2022,0,0,2,2,2,1,4,7,0,0,1,1,4,1,7,12,5,1,0,6
3545,163555,2022,Argentina,Netherlands,0,2,15,17,25/06/2022,0,0,1,1,11,7,7,25,3,7,3,13,8,2,24,34,5,2,2,9
3546,163555,2022,Argentina,China,0,5,10,15,24/06/2022,0,0,2,2,10,6,5,21,1,3,2,6,3,1,8,12,4,4,1,9
3547,163555,2022,Argentina,Slovenia,2,2,11,15,23/06/2022,0,0,2,2,10,7,14,31,1,1,3,5,7,1,20,28,4,1,0,5
3548,163555,2022,Argentina,Japan,0,0,1,1,21/06/2022,0,0,0,0,3,0,2,5,0,0,0,0,0,0,3,3,1,0,0,1
3549,163555,2022,Argentina,Italy,0,0,0,0,12/06/2022,0,0,0,0,0,0,0,0,0,0,0,0,0,0,0,0,0,0,0,0
3550,163555,2022,Serbia,Argentina,0,0,1,1,10/06/2022,0,0,0,0,0,1,0,1,0,0,0,0,0,0,0,0,0,0,0,0
3551,163555,2022,Germany,Argentina,0,0,0,0,09/06/2022,0,0,0,0,0,0,0,0,0,0,0,0,0,0,0,0,0,0,0,0
3552,163555,2022,Poland,Argentina,0,0,0,0,08/06/2022,0,0,0,0,0,0,0,0,0,0,0,0,0,0,0,0,0,0,0,0
3553,125047,2022,USA,Argentina,0,0,0,0,10/07/2022,0,0,0,0,0,0,0,0,0,0,0,0,0,0,0,0,1,0,0,1
3554,125047,2022,France,Argentina,0,0,9,9,09/07/2022,0,0,1,1,3,0,1,4,0,1,0,1,0,0,0,0,1,0,1,2
3555,125047,2022,Argentina,Australia,1,1,7,9,08/07/2022,1,0,1,2,3,0,4,7,3,1,3,7,0,0,0,0,0,1,0,1
3556,125047,2022,Canada,Argentina,0,0,0,0,05/07/2022,0,0,0,0,0,0,0,0,0,0,0,0,0,0,0,0,0,0,0,0
3557,125047,2022,Argentina,Netherlands,0,0,0,0,25/06/2022,0,0,0,0,0,0,0,0,0,0,0,0,0,0,0,0,0,0,0,0
3558,125047,2022,Argentina,China,0,3,6,9,24/06/2022,0,0,0,0,4,2,1,7,1,5,7,13,0,0,0,0,0,1,2,3
3559,125047,2022,Argentina,Slovenia,0,0,6,6,23/06/2022,0,0,0,0,1,0,1,2,0,0,2,2,0,0,0,0,0,1,0,1
3560,125047,2022,Argentina,Japan,0,0,0,0,21/06/2022,0,0,0,0,0,0,0,0,0,0,0,0,0,0,0,0,0,0,0,0
3561,125047,2022,Argentina,Italy,0,0,0,0,12/06/2022,0,0,0,0,0,0,0,0,0,0,0,0,0,0,0,0,0,0,0,0
3562,125047,2022,Serbia,Argentina,0,1,11,12,10/06/2022,0,0,3,3,7,2,6,15,1,3,6,10,0,0,3,3,3,1,2,6
3563,125047,2022,Germany,Argentina,0,0,0,0,09/06/2022,0,0,0,0,0,0,0,0,0,0,0,0,0,0,0,0,0,0,0,0
3564,125047,2022,Poland,Argentina,0,1,7,8,08/06/2022,0,0,0,0,2,0,2,4,1,1,2,4,0,0,0,0,3,0,2,5
3565,135349,2022,USA,Argentina,0,0,0,0,10/07/2022,0,0,0,0,0,0,0,0,0,0,0,0,0,0,0,0,0,0,0,0
3566,135349,2022,France,Argentina,0,0,0,0,09/07/2022,0,0,0,0,0,0,0,0,0,0,0,0,0,0,0,0,1,0,0,1
3567,135349,2022,Argentina,Australia,0,0,0,0,08/07/2022,0,0,0,0,0,0,0,0,0,0,0,0,0,0,0,0,0,0,0,0
3568,135349,2022,Canada,Argentina,0,0,0,0,05/07/2022,0,0,0,0,0,0,0,0,0,0,0,0,0,0,0,0,0,0,0,0
3569,135349,2022,Argentina,Netherlands,0,0,0,0,25/06/2022,0,0,0,0,0,0,0,0,0,0,0,0,0,0,0,0,0,0,0,0
3570,135349,2022,Argentina,China,0,0,0,0,24/06/2022,0,0,0,0,0,0,0,0,0,0,0,0,0,0,0,0,0,0,0,0
3571,135349,2022,Argentina,Slovenia,0,0,0,0,23/06/2022,0,0,0,0,0,0,0,0,0,0,0,0,0,0,0,0,0,0,0,0
3572,135349,2022,Argentina,Japan,0,0,0,0,21/06/2022,0,0,0,0,0,0,0,0,0,0,0,0,0,0,0,0,0,0,0,0
3573,135349,2022,Argentina,Italy,0,0,0,0,12/06/2022,0,0,0,0,0,0,0,0,0,0,0,0,0,0,0,0,0,0,0,0
3574,135349,2022,Serbia,Argentina,0,0,0,0,10/06/2022,0,0,0,0,0,0,0,0,0,0,0,0,0,0,0,0,0,0,0,0
3575,135349,2022,Germany,Argentina,0,0,0,0,09/06/2022,0,0,0,0,0,0,0,0,0,0,0,0,0,0,0,0,0,0,0,0
3576,135349,2022,Poland,Argentina,0,0,0,0,08/06/2022,0,0,0,0,0,0,0,0,0,0,0,0,0,0,0,0,0,0,0,0
3577,160816,2022,,,-,-,-,-,-,-,-,-,-,-,-,-,-,-,-,-,-,-,-,-,-,-,-,-,-
3578,162543,2022,USA,Argentina,0,0,0,0,10/07/2022,0,0,0,0,0,0,0,0,0,0,0,0,0,0,0,0,0,0,0,0
3579,162543,2022,France,Argentina,0,0,0,0,09/07/2022,0,0,0,0,0,0,0,0,0,0,0,0,0,0,0,0,0,0,0,0
3580,162543,2022,Argentina,Australia,0,0,0,0,08/07/2022,0,0,0,0,0,0,0,0,0,0,0,0,0,0,0,0,0,0,0,0
3581,162543,2022,Canada,Argentina,2,1,14,17,05/07/2022,0,0,1,1,6,1,5,12,2,9,8,19,0,0,0,0,1,0,2,3
3582,162543,2022,Argentina,Netherlands,0,0,19,19,25/06/2022,1,0,0,1,6,1,3,10,0,3,6,9,0,0,0,0,2,1,1,4
3583,162543,2022,Argentina,China,0,0,3,3,24/06/2022,0,0,0,0,1,1,2,4,0,0,2,2,0,0,0,0,1,0,0,1
3584,162543,2022,Argentina,Slovenia,0,1,3,4,23/06/2022,0,0,0,0,4,2,2,8,1,6,4,11,0,0,1,1,0,0,0,0
3585,162543,2022,Argentina,Japan,0,1,5,6,21/06/2022,0,0,0,0,0,0,2,2,0,2,6,8,0,0,1,1,1,0,0,1
3586,162543,2022,Argentina,Italy,0,0,2,2,12/06/2022,0,0,0,0,0,2,1,3,0,0,1,1,0,0,2,2,0,0,0,0
3587,162543,2022,Serbia,Argentina,1,1,14,16,10/06/2022,0,0,0,0,6,0,1,7,2,4,10,16,0,0,0,0,2,2,0,4
3588,162543,2022,Germany,Argentina,0,1,7,8,09/06/2022,0,0,0,0,2,1,0,3,1,3,11,15,1,0,0,1,0,1,4,5
3589,162543,2022,Poland,Argentina,0,1,2,3,08/06/2022,0,0,1,1,1,1,2,4,2,4,2,8,0,0,2,2,0,1,2,3
3590,162542,2022,,,-,-,-,-,-,-,-,-,-,-,-,-,-,-,-,-,-,-,-,-,-,-,-,-,-
3591,152699,2022,,,-,-,-,-,-,-,-,-,-,-,-,-,-,-,-,-,-,-,-,-,-,-,-,-,-
3592,163557,2022,,,-,-,-,-,-,-,-,-,-,-,-,-,-,-,-,-,-,-,-,-,-,-,-,-,-
3593,142420,2022,Argentina,Netherlands,0,0,1,1,25/06/2022,0,0,4,4,0,1,0,1,0,0,0,0,0,0,0,0,0,0,0,0
3594,142420,2022,Argentina,China,0,0,0,0,24/06/2022,0,0,7,7,1,0,0,1,0,0,0,0,0,0,0,0,0,0,0,0
3595,142420,2022,Argentina,Slovenia,0,0,4,4,23/06/2022,6,0,31,37,1,0,0,1,0,0,1,1,0,0,0,0,3,0,0,3
3596,142420,2022,Argentina,Japan,0,1,0,1,21/06/2022,3,0,8,11,0,0,0,0,0,0,0,0,0,0,0,0,0,0,0,0
3597,142420,2022,Argentina,Italy,0,1,3,4,12/06/2022,11,0,5,16,0,0,0,0,0,1,0,1,0,0,0,0,1,2,2,5
3598,142420,2022,Serbia,Argentina,3,3,7,13,10/06/2022,29,0,17,46,2,0,0,2,1,1,1,3,0,0,0,0,5,1,2,8
3599,142420,2022,Germany,Argentina,0,3,0,3,09/06/2022,3,0,9,12,0,0,1,1,1,0,0,1,0,0,0,0,1,2,1,4
3600,142420,2022,Poland,Argentina,0,1,0,1,08/06/2022,0,0,6,6,0,0,0,0,0,0,2,2,0,0,0,0,0,0,0,0
3601,144457,2022,Australia,France,0,3,4,7,10/07/2022,0,0,0,0,4,0,0,4,2,1,4,7,1,0,0,1,0,0,0,0
3602,144457,2022,Argentina,Australia,0,1,12,13,08/07/2022,0,0,1,1,7,1,4,12,2,4,4,10,0,0,0,0,1,0,2,3
3603,144457,2022,Germany,Australia,2,3,11,16,07/07/2022,0,0,2,2,4,2,0,6,1,2,4,7,1,0,3,4,2,4,1,7
3604,144457,2022,Japan,Australia,0,3,11,14,06/07/2022,0,0,2,2,4,1,4,9,1,3,2,6,1,0,0,1,0,1,0,1
3605,144457,2022,Serbia,Australia,0,1,6,7,26/06/2022,0,0,0,0,2,0,1,3,0,2,0,2,0,0,0,0,1,2,0,3
3606,144457,2022,Poland,Australia,0,0,5,5,25/06/2022,0,0,0,0,1,3,3,7,2,2,0,4,0,0,0,0,0,0,0,0
3607,144457,2022,Australia,Bulgaria,1,0,10,11,24/06/2022,1,0,0,1,11,0,4,15,1,3,1,5,0,0,0,0,1,1,0,2
3608,144457,2022,Australia,Canada,1,1,13,15,21/06/2022,0,0,0,0,9,1,1,11,1,2,4,7,2,0,0,2,0,1,1,2
3609,144457,2022,Netherlands,Australia,0,1,9,10,12/06/2022,2,0,0,2,0,0,1,1,0,2,3,5,0,1,0,1,0,1,0,1
3610,144457,2022,Iran,Australia,1,2,9,12,12/06/2022,1,0,0,1,7,1,7,15,3,3,5,11,0,0,4,4,1,0,0,1
3611,144457,2022,Australia,Slovenia,0,1,8,9,11/06/2022,1,0,0,1,4,0,6,10,0,1,1,2,0,0,1,1,2,1,0,3
3612,144457,2022,Brazil,Australia,0,2,3,5,09/06/2022,0,0,0,0,3,1,3,7,0,2,4,6,2,1,1,4,0,0,0,0
3613,144456,2022,Australia,France,1,0,4,5,10/07/2022,9,1,20,30,0,0,2,2,0,1,0,1,0,0,0,0,1,2,0,3
3614,144456,2022,Argentina,Australia,0,0,0,0,08/07/2022,0,0,0,0,0,0,0,0,0,0,0,0,0,0,0,0,0,0,0,0
3615,144456,2022,Germany,Australia,0,1,13,14,07/07/2022,25,1,40,66,2,0,2,4,0,2,4,6,0,0,2,2,7,1,2,10
3616,144456,2022,Japan,Australia,0,1,10,11,06/07/2022,21,1,45,67,2,0,3,5,1,2,3,6,0,1,0,1,3,2,0,5
3617,144456,2022,Serbia,Australia,0,2,5,7,26/06/2022,14,0,45,59,1,1,1,3,1,6,1,8,0,0,0,0,1,0,0,1
3618,144456,2022,Poland,Australia,0,0,0,0,25/06/2022,0,0,0,0,0,0,0,0,0,0,0,0,0,0,0,0,0,0,0,0
3619,144456,2022,Australia,Bulgaria,2,2,20,24,24/06/2022,19,2,91,112,2,1,1,4,3,2,2,7,0,0,0,0,1,4,1,6
3620,144456,2022,Australia,Canada,1,3,8,12,21/06/2022,18,2,78,98,5,0,1,6,1,4,1,6,0,0,0,0,1,3,0,4
3621,144456,2022,Netherlands,Australia,0,0,8,8,12/06/2022,12,1,15,28,1,1,0,2,0,1,1,2,0,0,0,0,3,0,1,4
3622,144456,2022,Iran,Australia,0,0,0,0,12/06/2022,0,0,0,0,0,0,0,0,0,0,0,0,0,0,0,0,0,0,0,0
3623,144456,2022,Australia,Slovenia,0,1,9,10,11/06/2022,25,2,42,69,3,1,1,5,0,1,0,1,0,1,0,1,1,1,0,2
3624,144456,2022,Brazil,Australia,0,3,4,7,09/06/2022,20,2,51,73,4,1,2,7,0,0,4,4,0,1,1,2,8,1,2,11
3625,174192,2022,Australia,France,0,0,0,0,10/07/2022,0,0,0,0,0,0,0,0,0,0,0,0,0,0,0,0,0,0,0,0
3626,174192,2022,Argentina,Australia,1,2,15,18,08/07/2022,0,0,0,0,11,4,5,20,0,4,1,5,12,4,15,31,6,3,3,12
3627,174192,2022,Germany,Australia,0,5,11,16,07/07/2022,1,0,4,5,16,3,7,26,1,3,3,7,10,3,23,36,3,0,3,6
3628,174192,2022,Japan,Australia,0,4,8,12,06/07/2022,0,0,2,2,21,5,6,32,1,2,2,5,13,4,19,36,5,2,0,7
3629,174192,2022,Serbia,Australia,0,3,6,9,26/06/2022,0,0,0,0,11,4,4,19,2,0,2,4,10,1,16,27,0,2,0,2
3630,174192,2022,Poland,Australia,0,0,0,0,25/06/2022,0,0,0,0,0,0,0,0,0,0,0,0,0,0,0,0,0,0,0,0
3631,174192,2022,Australia,Bulgaria,1,2,14,17,24/06/2022,0,1,1,2,20,7,8,35,0,2,1,3,8,3,20,31,8,4,0,12
3632,174192,2022,Australia,Canada,0,3,11,14,21/06/2022,0,0,1,1,13,5,17,35,2,1,2,5,6,2,12,20,4,4,1,9
3633,174192,2022,Netherlands,Australia,1,4,6,11,12/06/2022,1,0,2,3,16,2,5,23,1,6,0,7,1,5,8,14,3,0,0,3
3634,174192,2022,Iran,Australia,0,0,0,0,12/06/2022,0,0,0,0,0,0,0,0,0,0,0,0,0,0,0,0,0,0,0,0
3635,174192,2022,Australia,Slovenia,0,3,9,12,11/06/2022,0,0,0,0,11,2,8,21,1,0,0,1,14,0,13,27,5,4,1,10
3636,174192,2022,Brazil,Australia,0,4,5,9,09/06/2022,0,0,1,1,15,6,10,31,3,0,2,5,1,1,10,12,1,1,0,2
3637,160879,2022,Australia,France,0,0,0,0,10/07/2022,0,0,7,7,0,0,0,0,0,0,0,0,2,1,13,16,4,5,0,9
3638,160879,2022,Argentina,Australia,0,0,0,0,08/07/2022,0,0,1,1,0,0,0,0,0,0,0,0,13,1,17,31,7,2,1,10
3639,160879,2022,Germany,Australia,0,0,0,0,07/07/2022,0,0,7,7,0,0,0,0,0,0,0,0,7,1,8,16,4,5,3,12
3640,160879,2022,Japan,Australia,0,0,0,0,06/07/2022,0,0,3,3,0,0,0,0,0,0,0,0,8,4,9,21,6,3,1,10
3641,160879,2022,Serbia,Australia,0,0,0,0,26/06/2022,0,0,0,0,0,0,0,0,0,0,0,0,0,0,0,0,0,0,0,0
3642,160879,2022,Poland,Australia,0,0,0,0,25/06/2022,0,0,0,0,0,0,0,0,0,0,0,0,0,2,3,5,0,0,0,0
3643,160879,2022,Australia,Bulgaria,0,0,0,0,24/06/2022,0,0,0,0,0,0,0,0,0,0,0,0,0,0,0,0,0,0,0,0
3644,160879,2022,Australia,Canada,0,0,0,0,21/06/2022,0,0,0,0,0,0,0,0,0,0,0,0,0,0,0,0,0,0,0,0
3645,160879,2022,Netherlands,Australia,0,0,0,0,12/06/2022,0,0,0,0,0,0,0,0,0,0,0,0,0,0,0,0,0,0,0,0
3646,160879,2022,Iran,Australia,0,0,0,0,12/06/2022,0,0,0,0,0,0,0,0,0,0,0,0,0,0,0,0,0,0,0,0
3647,160879,2022,Australia,Slovenia,0,0,0,0,11/06/2022,0,0,0,0,0,0,0,0,0,0,0,0,0,0,0,0,0,0,0,0
3648,160879,2022,Brazil,Australia,0,0,0,0,09/06/2022,0,0,0,0,0,0,0,0,0,0,0,0,0,0,0,0,0,0,0,0
3649,139052,2022,Australia,France,0,1,1,2,10/07/2022,0,0,3,3,0,1,2,3,0,0,0,0,0,1,3,4,1,0,1,2
3650,139052,2022,Argentina,Australia,0,3,8,11,08/07/2022,1,0,0,1,13,4,13,30,3,3,2,8,4,3,11,18,4,2,4,10
3651,139052,2022,Germany,Australia,0,2,6,8,07/07/2022,0,0,1,1,5,1,4,10,0,0,1,1,3,0,7,10,1,2,0,3
3652,139052,2022,Japan,Australia,0,2,11,13,06/07/2022,0,0,2,2,8,2,5,15,1,2,1,4,3,1,11,15,4,0,1,5
3653,125036,2022,,,-,-,-,-,-,-,-,-,-,-,-,-,-,-,-,-,-,-,-,-,-,-,-,-,-
3654,162077,2022,Serbia,Australia,0,2,9,11,26/06/2022,0,0,0,0,8,0,4,12,1,5,4,10,0,0,0,0,0,1,0,1
3655,162077,2022,Poland,Australia,0,1,1,2,25/06/2022,0,0,0,0,0,1,3,4,1,1,1,3,0,0,0,0,0,1,0,1
3656,162077,2022,Australia,Bulgaria,1,2,16,19,24/06/2022,0,0,0,0,11,0,5,16,3,2,7,12,0,1,3,4,2,0,1,3
3657,162077,2022,Australia,Canada,2,1,10,13,21/06/2022,0,0,2,2,10,1,6,17,2,3,4,9,0,0,1,1,0,1,0,1
3658,162077,2022,Netherlands,Australia,0,3,6,9,12/06/2022,0,0,0,0,5,1,2,8,2,5,3,10,0,0,0,0,0,0,0,0
3659,162077,2022,Iran,Australia,0,0,0,0,12/06/2022,0,0,0,0,0,0,0,0,0,0,0,0,0,0,0,0,0,0,0,0
3660,162077,2022,Australia,Slovenia,1,2,6,9,11/06/2022,0,0,1,1,5,1,4,10,1,1,2,4,0,0,0,0,1,0,0,1
3661,162077,2022,Brazil,Australia,0,2,4,6,09/06/2022,0,0,1,1,7,0,4,11,0,1,7,8,2,0,0,2,2,0,0,2
3662,144464,2022,Australia,France,1,1,8,10,10/07/2022,0,0,3,3,3,0,2,5,1,3,1,5,0,0,2,2,0,1,2,3
3663,144464,2022,Argentina,Australia,0,0,13,13,08/07/2022,0,0,4,4,4,1,4,9,1,3,3,7,1,0,0,1,1,0,2,3
3664,144464,2022,Germany,Australia,1,2,12,15,07/07/2022,0,0,5,5,7,3,1,11,3,1,4,8,0,0,2,2,2,2,0,4
3665,144464,2022,Japan,Australia,0,0,11,11,06/07/2022,2,0,1,3,6,0,6,12,0,6,2,8,0,0,1,1,0,3,0,3
3666,144464,2022,Serbia,Australia,0,1,3,4,26/06/2022,0,0,1,1,2,0,1,3,0,3,1,4,0,0,1,1,0,0,0,0
3667,144464,2022,Poland,Australia,0,0,9,9,25/06/2022,0,0,1,1,5,2,3,10,1,1,1,3,2,0,2,4,0,0,0,0
3668,144464,2022,Australia,Bulgaria,0,0,0,0,24/06/2022,0,0,0,0,0,0,0,0,0,0,0,0,0,0,0,0,0,0,0,0
3669,144464,2022,Australia,Canada,0,0,0,0,21/06/2022,0,0,0,0,0,0,0,0,0,0,0,0,0,0,0,0,0,0,0,0
3670,144464,2022,Netherlands,Australia,0,0,0,0,12/06/2022,0,0,0,0,0,0,0,0,0,0,0,0,0,0,0,0,0,0,0,0
3671,144464,2022,Iran,Australia,0,1,14,15,12/06/2022,0,1,0,1,4,1,9,14,2,2,4,8,0,0,0,0,4,0,0,4
3672,144464,2022,Australia,Slovenia,0,0,1,1,11/06/2022,0,0,0,0,1,0,0,1,0,0,0,0,0,0,0,0,0,0,0,0
3673,144464,2022,Brazil,Australia,0,0,4,4,09/06/2022,0,0,0,0,0,0,0,0,0,0,0,0,0,0,0,0,0,0,0,0
3674,135532,2022,Serbia,Australia,1,3,4,8,26/06/2022,0,0,0,0,3,1,8,12,2,3,1,6,4,1,9,14,0,2,0,2
3675,135532,2022,Poland,Australia,0,0,0,0,25/06/2022,0,0,0,0,0,0,0,0,0,0,0,0,0,0,0,0,0,0,0,0
3676,135532,2022,Australia,Bulgaria,1,4,14,19,24/06/2022,0,0,2,2,10,9,14,33,1,3,0,4,5,2,17,24,0,2,1,3
3677,135532,2022,Australia,Canada,0,5,12,17,21/06/2022,0,0,1,1,9,2,8,19,1,2,0,3,9,3,11,23,5,0,1,6
3678,151041,2022,,,-,-,-,-,-,-,-,-,-,-,-,-,-,-,-,-,-,-,-,-,-,-,-,-,-
3679,144578,2022,Serbia,Australia,0,0,0,0,26/06/2022,0,0,2,2,0,0,0,0,0,0,0,0,6,0,10,16,0,2,0,2
3680,144578,2022,Poland,Australia,0,0,0,0,25/06/2022,0,0,4,4,0,0,0,0,0,0,0,0,6,0,2,8,6,3,3,12
3681,144578,2022,Australia,Bulgaria,0,0,0,0,24/06/2022,1,0,3,4,0,0,0,0,0,0,0,0,6,1,16,23,5,4,1,10
3682,144578,2022,Australia,Canada,0,0,0,0,21/06/2022,0,0,6,6,0,0,0,0,0,0,0,0,12,2,11,25,11,4,4,19
3683,144578,2022,Netherlands,Australia,0,0,0,0,12/06/2022,5,0,1,6,0,0,0,0,0,0,0,0,2,0,12,14,6,3,1,10
3684,144578,2022,Iran,Australia,0,0,0,0,12/06/2022,7,0,2,9,0,0,0,0,0,0,0,0,8,0,8,16,12,3,2,17
3685,144578,2022,Australia,Slovenia,0,0,0,0,11/06/2022,5,0,0,5,0,0,0,0,0,0,0,0,2,0,7,9,13,1,2,16
3686,144578,2022,Brazil,Australia,0,0,0,0,09/06/2022,6,0,3,9,0,0,0,0,0,0,0,0,8,1,10,19,11,3,3,17
3687,144461,2022,,,-,-,-,-,-,-,-,-,-,-,-,-,-,-,-,-,-,-,-,-,-,-,-,-,-
3688,168641,2022,Australia,France,0,2,7,9,10/07/2022,0,1,3,4,5,2,5,12,0,0,1,1,0,0,4,4,4,1,0,5
3689,168641,2022,Argentina,Australia,0,1,0,1,08/07/2022,0,0,0,0,0,1,0,1,0,0,0,0,0,0,0,0,0,1,0,1
3690,168641,2022,Germany,Australia,0,3,2,5,07/07/2022,0,0,0,0,3,1,3,7,0,1,0,1,0,0,0,0,0,1,0,1
3691,168641,2022,Japan,Australia,1,1,13,15,06/07/2022,1,0,1,2,9,3,3,15,0,1,1,2,1,2,0,3,2,3,3,8
3692,168641,2022,Serbia,Australia,0,1,13,14,26/06/2022,0,0,0,0,9,3,1,13,0,1,1,2,0,0,3,3,0,1,0,1
3693,168641,2022,Poland,Australia,0,1,6,7,25/06/2022,0,0,0,0,8,3,13,24,0,0,0,0,0,0,3,3,2,1,0,3
3694,168641,2022,Australia,Bulgaria,1,4,12,17,24/06/2022,0,0,1,1,7,5,11,23,0,2,0,2,0,0,4,4,3,1,2,6
3695,168641,2022,Australia,Canada,4,2,14,20,21/06/2022,0,0,0,0,6,6,5,17,0,0,1,1,2,0,3,5,1,1,0,2
3696,168641,2022,Netherlands,Australia,0,1,1,2,12/06/2022,1,0,0,1,1,0,2,3,0,0,2,2,0,0,0,0,4,0,0,4
3697,168641,2022,Iran,Australia,0,3,8,11,12/06/2022,0,0,0,0,2,2,7,11,2,3,1,6,1,1,8,10,3,2,0,5
3698,168641,2022,Australia,Slovenia,0,1,3,4,11/06/2022,0,0,0,0,5,2,1,8,0,2,0,2,0,0,0,0,1,1,1,3
3699,168641,2022,Brazil,Australia,1,4,4,9,09/06/2022,1,0,0,1,3,5,5,13,2,1,4,7,0,0,1,1,5,1,0,6
3700,162264,2022,Serbia,Australia,0,0,0,0,26/06/2022,0,0,0,0,0,0,0,0,0,0,0,0,0,0,0,0,0,0,0,0
3701,162264,2022,Poland,Australia,0,0,0,0,25/06/2022,0,0,0,0,0,0,0,0,0,0,0,0,0,0,0,0,0,0,0,0
3702,162264,2022,Australia,Bulgaria,0,0,0,0,24/06/2022,0,0,0,0,0,0,0,0,0,0,0,0,0,0,0,0,0,0,0,0
3703,162264,2022,Australia,Canada,0,0,0,0,21/06/2022,0,0,0,0,0,0,0,0,0,0,0,0,0,0,0,0,0,0,0,0
3704,162264,2022,Netherlands,Australia,0,4,3,7,12/06/2022,0,0,0,0,6,3,3,12,1,3,2,6,0,0,0,0,0,0,0,0
3705,162264,2022,Iran,Australia,1,4,10,15,12/06/2022,0,0,1,1,15,8,9,32,1,3,2,6,0,0,0,0,3,3,1,7
3706,162264,2022,Australia,Slovenia,0,2,2,4,11/06/2022,0,0,0,0,3,3,4,10,0,1,2,3,0,0,0,0,3,1,0,4
3707,162264,2022,Brazil,Australia,0,0,0,0,09/06/2022,0,0,0,0,0,0,0,0,0,0,0,0,0,0,0,0,0,0,0,0
3708,172376,2022,Australia,France,0,0,0,0,10/07/2022,0,0,0,0,0,0,0,0,0,0,0,0,0,0,0,0,0,0,0,0
3709,172376,2022,Argentina,Australia,0,0,0,0,08/07/2022,0,0,0,0,0,0,0,0,0,0,0,0,0,0,0,0,0,0,0,0
3710,172376,2022,Germany,Australia,0,0,0,0,07/07/2022,0,0,0,0,0,0,0,0,0,0,0,0,0,0,0,0,0,0,0,0
3711,172376,2022,Japan,Australia,0,0,0,0,06/07/2022,0,0,0,0,0,0,0,0,0,0,0,0,0,0,0,0,0,0,0,0
3712,172376,2022,Netherlands,Australia,0,0,0,0,12/06/2022,0,0,0,0,0,0,0,0,0,0,0,0,0,0,0,0,0,0,0,0
3713,172376,2022,Iran,Australia,0,0,0,0,12/06/2022,0,0,0,0,0,0,0,0,0,0,0,0,0,0,0,0,0,0,0,0
3714,172376,2022,Australia,Slovenia,0,0,0,0,11/06/2022,0,0,0,0,0,0,0,0,0,0,0,0,0,0,0,0,0,0,0,0
3715,172376,2022,Brazil,Australia,0,0,0,0,09/06/2022,0,0,0,0,0,0,0,0,0,0,0,0,0,0,0,0,0,0,0,0
3716,181281,2022,Australia,France,0,0,0,0,10/07/2022,,,,,0,0,0,0,0,0,0,0,0,0,0,0,0,0,0,0
3717,181281,2022,Argentina,Australia,0,0,0,0,08/07/2022,,,,,0,0,0,0,0,0,0,0,0,0,0,0,0,0,0,0
3718,181281,2022,Germany,Australia,0,0,0,0,07/07/2022,,,,,0,0,0,0,0,0,0,0,0,0,0,0,0,0,0,0
3719,181281,2022,Japan,Australia,0,0,0,0,06/07/2022,,,,,0,0,0,0,0,0,0,0,0,0,0,0,0,0,0,0
3720,132958,2022,,,-,-,-,-,-,-,-,-,-,-,-,-,-,-,-,-,-,-,-,-,-,-,-,-,-
3721,186917,2022,,,-,-,-,-,-,-,-,-,-,-,-,-,-,-,-,-,-,-,-,-,-,-,-,-,-
3722,158841,2022,Australia,France,0,2,4,6,10/07/2022,4,0,9,13,1,0,0,1,0,1,0,1,0,0,1,1,2,0,0,2
3723,158841,2022,Argentina,Australia,2,4,9,15,08/07/2022,32,1,51,84,0,0,1,1,0,2,2,4,0,0,0,0,0,3,1,4
3724,158841,2022,Germany,Australia,0,0,0,0,07/07/2022,0,0,0,0,0,0,0,0,0,0,0,0,0,0,0,0,0,0,0,0
3725,158841,2022,Japan,Australia,0,0,0,0,06/07/2022,1,0,1,2,0,0,0,0,0,0,0,0,0,0,0,0,0,0,1,1
3726,158841,2022,Serbia,Australia,0,0,0,0,26/06/2022,0,0,0,0,0,0,0,0,0,0,0,0,0,0,0,0,0,0,0,0
3727,158841,2022,Poland,Australia,1,2,4,7,25/06/2022,20,0,55,75,0,0,2,2,0,1,0,1,0,0,0,0,1,2,0,3
3728,158841,2022,Australia,Bulgaria,0,0,0,0,24/06/2022,0,0,0,0,0,0,0,0,0,0,0,0,0,0,0,0,0,0,0,0
3729,158841,2022,Australia,Canada,0,0,0,0,21/06/2022,0,0,0,0,0,0,0,0,0,0,0,0,0,0,0,0,0,0,0,0
3730,158841,2022,Netherlands,Australia,0,2,3,5,12/06/2022,8,1,13,22,0,0,0,0,0,1,1,2,0,1,0,1,1,1,0,2
3731,158841,2022,Iran,Australia,0,2,12,14,12/06/2022,44,0,46,90,1,0,1,2,0,2,4,6,0,0,0,0,3,1,1,5
3732,158841,2022,Australia,Slovenia,0,1,0,1,11/06/2022,0,0,1,1,0,0,0,0,0,0,0,0,0,0,0,0,0,0,0,0
3733,158841,2022,Brazil,Australia,0,0,0,0,09/06/2022,0,0,0,0,0,0,0,0,0,0,0,0,0,0,0,0,0,0,0,0
3734,178207,2022,Australia,France,0,3,5,8,10/07/2022,0,0,4,4,4,7,3,14,0,1,0,1,0,1,9,10,3,3,1,7
3735,178207,2022,Argentina,Australia,0,0,0,0,08/07/2022,0,0,0,0,0,0,0,0,0,0,0,0,0,0,0,0,0,0,0,0
3736,178207,2022,Germany,Australia,0,0,0,0,07/07/2022,0,0,0,0,0,0,0,0,0,0,0,0,0,0,0,0,0,0,0,0
3737,178207,2022,Japan,Australia,0,0,0,0,06/07/2022,0,0,0,0,0,0,0,0,0,0,0,0,0,0,0,0,0,0,0,0
3738,178207,2022,Serbia,Australia,0,0,0,0,26/06/2022,0,0,0,0,0,0,0,0,0,0,0,0,0,0,0,0,0,0,0,0
3739,178207,2022,Poland,Australia,0,0,1,1,25/06/2022,0,0,0,0,0,2,0,2,0,0,0,0,0,0,0,0,0,0,0,0
3740,178207,2022,Australia,Bulgaria,0,0,1,1,24/06/2022,0,0,0,0,0,0,0,0,0,0,0,0,0,0,0,0,0,0,0,0
3741,178207,2022,Australia,Canada,0,1,0,1,21/06/2022,0,0,0,0,0,0,0,0,0,0,0,0,0,0,0,0,0,0,0,0
3742,178207,2022,Netherlands,Australia,0,0,0,0,12/06/2022,0,0,0,0,0,0,0,0,0,0,0,0,0,0,0,0,0,0,0,0
3743,178207,2022,Iran,Australia,0,0,1,1,12/06/2022,0,0,0,0,0,0,0,0,0,0,0,0,0,0,0,0,0,0,0,0
3744,178207,2022,Australia,Slovenia,0,1,0,1,11/06/2022,0,0,0,0,0,0,0,0,0,0,0,0,0,0,0,0,0,0,0,0
3745,178207,2022,Brazil,Australia,0,1,2,3,09/06/2022,0,0,0,0,0,0,0,0,0,0,0,0,0,0,0,0,0,0,0,0
3746,172333,2022,,,-,-,-,-,-,-,-,-,-,-,-,-,-,-,-,-,-,-,-,-,-,-,-,-,-
3747,162870,2022,Australia,France,0,0,2,2,10/07/2022,0,0,0,0,2,1,1,4,0,2,1,3,1,3,4,8,1,0,2,3
3748,162870,2022,Argentina,Australia,0,0,1,1,08/07/2022,0,0,0,0,0,1,0,1,0,0,0,0,0,0,0,0,0,0,0,0
3749,162870,2022,Germany,Australia,0,1,4,5,07/07/2022,0,0,0,0,3,2,1,6,0,0,1,1,2,1,4,7,1,1,0,2
3750,162870,2022,Japan,Australia,0,0,1,1,06/07/2022,0,0,0,0,1,0,0,1,0,0,1,1,2,1,0,3,0,1,0,1
3751,162870,2022,Serbia,Australia,0,0,1,1,26/06/2022,0,0,0,0,1,0,0,1,0,0,1,1,0,0,2,2,0,0,0,0
3752,162870,2022,Poland,Australia,0,0,10,10,25/06/2022,0,1,0,1,6,4,9,19,0,0,0,0,4,1,14,19,0,1,0,1
3753,162870,2022,Australia,Bulgaria,0,0,0,0,24/06/2022,0,0,0,0,0,0,0,0,0,0,0,0,0,0,0,0,0,0,0,0
3754,162870,2022,Australia,Canada,0,0,1,1,21/06/2022,0,0,0,0,2,2,0,4,0,0,0,0,0,0,2,2,1,0,0,1
3755,162870,2022,Netherlands,Australia,0,0,6,6,12/06/2022,0,0,0,0,4,0,4,8,0,1,0,1,5,1,10,16,2,1,0,3
3756,162870,2022,Iran,Australia,0,2,3,5,12/06/2022,0,0,0,0,7,10,5,22,1,1,0,2,15,2,14,31,6,3,0,9
3757,162870,2022,Australia,Slovenia,0,0,4,4,11/06/2022,0,0,1,1,1,1,1,3,0,1,0,1,1,1,4,6,0,0,1,1
3758,162870,2022,Brazil,Australia,0,1,8,9,09/06/2022,1,0,1,2,3,6,6,15,0,3,0,3,3,1,20,24,8,1,1,10
3759,169335,2022,Australia,France,0,0,3,3,10/07/2022,0,0,3,3,2,1,2,5,0,2,2,4,0,0,9,9,1,1,0,2
3760,169335,2022,Argentina,Australia,0,0,0,0,08/07/2022,0,0,0,0,0,0,0,0,0,0,0,0,0,0,0,0,0,0,0,0
3761,169335,2022,Germany,Australia,0,0,0,0,07/07/2022,0,0,0,0,0,0,0,0,0,0,0,0,0,0,0,0,0,0,0,0
3762,169335,2022,Japan,Australia,0,0,0,0,06/07/2022,0,0,0,0,0,0,0,0,0,0,0,0,0,0,0,0,0,0,0,0
3763,169335,2022,Serbia,Australia,0,0,0,0,26/06/2022,0,0,0,0,0,0,0,0,0,0,0,0,0,0,0,0,0,0,0,0
3764,169335,2022,Poland,Australia,0,3,7,10,25/06/2022,0,0,0,0,7,3,5,15,0,1,2,3,5,1,20,26,0,0,1,1
3765,169335,2022,Australia,Bulgaria,0,0,0,0,24/06/2022,0,0,0,0,0,0,0,0,0,0,0,0,0,0,0,0,0,0,0,0
3766,169335,2022,Australia,Canada,0,0,0,0,21/06/2022,0,0,0,0,0,0,0,0,0,0,0,0,0,0,0,0,0,0,0,0
3767,169335,2022,Netherlands,Australia,0,0,2,2,12/06/2022,0,0,0,0,1,1,1,3,0,0,0,0,2,1,8,11,2,0,1,3
3768,169335,2022,Iran,Australia,0,1,3,4,12/06/2022,0,0,0,0,4,1,3,8,0,0,1,1,3,2,10,15,0,0,0,0
3769,169335,2022,Australia,Slovenia,1,1,7,9,11/06/2022,0,0,0,0,3,3,3,9,1,1,1,3,4,1,9,14,0,1,0,1
3770,169335,2022,Brazil,Australia,0,1,1,2,09/06/2022,0,0,0,0,0,1,5,6,0,1,0,1,0,0,2,2,0,1,0,1
3771,162265,2022,Australia,France,0,0,3,3,10/07/2022,0,0,1,1,2,3,3,8,0,2,1,3,0,0,0,0,1,2,0,3
3772,162265,2022,Argentina,Australia,0,4,7,11,08/07/2022,0,0,0,0,11,6,3,20,1,1,4,6,0,0,0,0,2,0,1,3
3773,162265,2022,Germany,Australia,1,4,3,8,07/07/2022,0,0,2,2,8,3,9,20,0,2,5,7,0,0,0,0,2,2,1,5
3774,162265,2022,Japan,Australia,0,0,1,1,06/07/2022,1,0,0,1,0,0,0,0,0,0,0,0,0,0,0,0,0,0,0,0
3775,189191,2022,,,-,-,-,-,-,-,-,-,-,-,-,-,-,-,-,-,-,-,-,-,-,-,-,-,-
3776,116099,2022,USA,Brazil,0,3,8,11,20/07/2022,29,0,63,92,0,0,0,0,0,3,1,4,0,0,0,0,3,1,1,5
3777,116099,2022,Brazil,Japan,1,2,12,15,10/07/2022,30,0,35,65,0,0,1,1,1,2,2,5,0,0,0,0,2,0,2,4
3778,116099,2022,France,Brazil,0,0,4,4,08/07/2022,2,0,9,11,0,0,1,1,0,0,0,0,0,0,1,1,1,0,0,1
3779,116099,2022,Canada,Brazil,0,1,9,10,07/07/2022,11,0,50,61,1,0,0,1,0,1,2,3,0,0,0,0,6,2,1,9
3780,116099,2022,Brazil,Germany,0,2,16,18,06/07/2022,37,1,44,82,1,0,0,1,1,1,2,4,0,0,0,0,8,0,4,12
3781,116099,2022,Bulgaria,Brazil,1,0,11,12,26/06/2022,20,0,40,60,1,0,0,1,1,4,1,6,0,0,0,0,0,1,0,1
3782,116099,2022,Iran,Brazil,3,1,13,17,24/06/2022,23,0,38,61,1,0,0,1,0,3,1,4,0,0,1,1,0,3,0,3
3783,116099,2022,Serbia,Brazil,2,1,10,13,23/06/2022,21,1,47,69,0,0,0,0,0,0,0,0,0,0,0,0,2,2,0,4
3784,116099,2022,Brazil,Poland,0,0,8,8,22/06/2022,21,0,52,73,0,0,1,1,0,2,1,3,0,0,1,1,4,1,3,8
3785,116099,2022,Brazil,China,1,2,8,11,12/06/2022,33,1,38,72,0,0,0,0,0,2,2,4,0,0,0,0,3,2,0,5
3786,116099,2022,USA,Brazil,0,2,9,11,11/06/2022,28,1,38,67,1,0,0,1,0,2,4,6,0,0,1,1,4,4,1,9
3787,116099,2022,Brazil,Slovenia,0,1,13,14,10/06/2022,43,0,28,71,0,0,0,0,0,5,3,8,0,0,1,1,4,1,2,7
3788,116099,2022,Brazil,Australia,0,0,11,11,09/06/2022,30,1,31,62,0,0,1,1,0,0,5,5,0,0,0,0,10,1,1,12
3789,174334,2022,Brazil,Japan,0,0,0,0,10/07/2022,0,0,0,0,0,0,0,0,0,0,0,0,0,0,0,0,0,0,0,0
3790,174334,2022,France,Brazil,0,0,0,0,08/07/2022,0,0,0,0,0,0,0,0,0,0,0,0,0,0,0,0,0,0,0,0
3791,174334,2022,Canada,Brazil,0,0,0,0,07/07/2022,0,0,0,0,0,0,0,0,0,0,0,0,0,0,0,0,0,0,0,0
3792,174334,2022,Brazil,Germany,0,0,0,0,06/07/2022,0,0,0,0,0,0,0,0,0,0,0,0,0,0,0,0,0,0,0,0
3793,136955,2022,,,-,-,-,-,-,-,-,-,-,-,-,-,-,-,-,-,-,-,-,-,-,-,-,-,-
3794,124456,2022,Brazil,China,0,0,0,0,12/06/2022,1,0,1,2,0,0,2,2,0,1,0,1,0,0,0,0,0,0,0,0
3795,124456,2022,USA,Brazil,0,0,0,0,11/06/2022,0,0,0,0,3,1,1,5,0,0,2,2,0,0,0,0,0,0,0,0
3796,124456,2022,Brazil,Slovenia,0,0,0,0,10/06/2022,0,0,0,0,0,0,0,0,0,1,0,1,0,0,0,0,0,0,0,0
3797,124456,2022,Brazil,Australia,0,0,0,0,09/06/2022,0,0,0,0,0,0,0,0,0,0,0,0,0,0,0,0,0,0,0,0
3798,161942,2022,,,-,-,-,-,-,-,-,-,-,-,-,-,-,-,-,-,-,-,-,-,-,-,-,-,-
3799,174908,2022,USA,Brazil,0,0,5,5,20/07/2022,0,0,0,0,1,1,3,5,0,1,0,1,0,0,0,0,2,0,0,2
3800,174908,2022,Brazil,Japan,0,0,1,1,10/07/2022,0,0,0,0,3,0,2,5,0,1,0,1,3,0,4,7,0,0,0,0
3801,174908,2022,France,Brazil,1,1,8,10,08/07/2022,0,0,4,4,6,0,4,10,0,3,1,4,3,6,4,13,4,2,1,7
3802,174908,2022,Canada,Brazil,0,0,0,0,07/07/2022,0,0,0,0,0,0,0,0,0,0,0,0,0,0,2,2,0,0,0,0
3803,174908,2022,Brazil,Germany,0,0,0,0,06/07/2022,0,0,1,1,0,0,0,0,0,0,1,1,0,0,0,0,0,0,0,0
3804,174908,2022,Bulgaria,Brazil,0,0,0,0,26/06/2022,0,0,0,0,0,0,0,0,0,0,0,0,0,1,1,2,0,0,0,0
3805,174908,2022,Iran,Brazil,0,0,0,0,24/06/2022,0,0,0,0,0,1,0,1,0,0,0,0,1,0,0,1,1,0,0,1
3806,174908,2022,Serbia,Brazil,0,0,0,0,23/06/2022,0,0,0,0,1,0,0,1,0,0,0,0,2,0,3,5,0,0,0,0
3807,174908,2022,Brazil,Poland,0,0,0,0,22/06/2022,0,0,0,0,0,1,0,1,0,0,0,0,0,0,1,1,0,0,0,0
3808,174908,2022,Brazil,China,0,2,7,9,12/06/2022,3,0,1,4,8,2,3,13,0,1,2,3,13,1,17,31,3,1,0,4
3809,174908,2022,USA,Brazil,0,3,9,12,11/06/2022,1,0,0,1,2,2,6,10,0,1,0,1,6,2,10,18,2,1,1,4
3810,174908,2022,Brazil,Slovenia,3,3,13,19,10/06/2022,0,0,0,0,8,0,6,14,2,1,0,3,4,2,16,22,3,1,2,6
3811,174908,2022,Brazil,Australia,1,2,11,14,09/06/2022,3,0,1,4,5,2,4,11,0,4,0,4,5,0,6,11,6,3,4,13
3812,135380,2022,,,-,-,-,-,-,-,-,-,-,-,-,-,-,-,-,-,-,-,-,-,-,-,-,-,-
3813,112869,2022,,,-,-,-,-,-,-,-,-,-,-,-,-,-,-,-,-,-,-,-,-,-,-,-,-,-
3814,118928,2022,USA,Brazil,0,4,7,11,20/07/2022,0,0,1,1,18,7,12,37,0,1,0,1,10,1,19,30,6,2,1,9
3815,118928,2022,Brazil,Japan,0,3,5,8,10/07/2022,0,0,1,1,7,2,4,13,0,4,0,4,3,1,8,12,2,2,0,4
3816,118928,2022,France,Brazil,0,1,10,11,08/07/2022,0,0,5,5,5,3,11,19,0,4,2,6,3,3,12,18,1,1,2,4
3817,118928,2022,Canada,Brazil,1,3,11,15,07/07/2022,0,0,1,1,13,0,6,19,1,2,1,4,2,5,6,13,0,0,1,1
3818,118928,2022,Brazil,Germany,1,3,12,16,06/07/2022,0,0,6,6,19,2,8,29,1,6,4,11,2,0,17,19,3,4,0,7
3819,118928,2022,Bulgaria,Brazil,1,2,7,10,26/06/2022,0,0,1,1,11,2,4,17,0,3,0,3,3,2,16,21,1,2,0,3
3820,118928,2022,Iran,Brazil,1,1,13,15,24/06/2022,0,0,0,0,11,3,5,19,1,3,0,4,1,2,10,13,4,1,0,5
3821,118928,2022,Serbia,Brazil,1,2,9,12,23/06/2022,0,0,1,1,8,0,7,15,2,4,1,7,1,1,13,15,0,2,1,3
3822,118928,2022,Brazil,Poland,1,2,15,18,22/06/2022,0,0,2,2,8,5,9,22,1,3,1,5,3,5,23,31,4,2,2,8
3823,164313,2022,,,-,-,-,-,-,-,-,-,-,-,-,-,-,-,-,-,-,-,-,-,-,-,-,-,-
3824,142721,2022,USA,Brazil,0,0,0,0,20/07/2022,0,0,0,0,0,0,0,0,0,0,0,0,1,0,1,2,0,0,0,0
3825,142721,2022,Brazil,Japan,0,0,0,0,10/07/2022,0,0,1,1,0,0,0,0,0,0,0,0,0,0,1,1,1,0,0,1
3826,142721,2022,France,Brazil,0,1,2,3,08/07/2022,0,0,1,1,3,1,1,5,0,0,1,1,1,0,2,3,4,1,1,6
3827,142721,2022,Canada,Brazil,0,0,0,0,07/07/2022,0,0,0,0,0,0,0,0,0,0,0,0,0,0,0,0,0,0,0,0
3828,142721,2022,Brazil,Germany,1,0,0,1,06/07/2022,0,0,0,0,0,0,0,0,0,0,0,0,0,0,0,0,0,0,0,0
3829,142721,2022,Bulgaria,Brazil,0,0,0,0,26/06/2022,0,0,0,0,0,0,0,0,0,0,0,0,0,0,0,0,0,0,0,0
3830,142721,2022,Iran,Brazil,0,0,0,0,24/06/2022,0,0,0,0,0,0,0,0,0,0,0,0,0,0,2,2,0,0,0,0
3831,142721,2022,Serbia,Brazil,0,0,0,0,23/06/2022,0,0,0,0,0,0,0,0,0,0,0,0,0,0,0,0,0,0,0,0
3832,142721,2022,Brazil,Poland,0,1,5,6,22/06/2022,0,0,1,1,6,2,7,15,0,0,0,0,1,2,2,5,1,0,0,1
3833,142721,2022,Brazil,China,0,4,7,11,12/06/2022,0,0,0,0,4,4,4,12,0,4,2,6,8,1,8,17,1,2,3,6
3834,142721,2022,USA,Brazil,2,3,9,14,11/06/2022,2,0,1,3,10,2,7,19,1,2,4,7,17,1,13,31,4,1,3,8
3835,142721,2022,Brazil,Slovenia,4,3,11,18,10/06/2022,0,0,1,1,9,2,6,17,2,3,0,5,3,1,13,17,5,1,0,6
3836,142721,2022,Brazil,Australia,1,1,7,9,09/06/2022,2,0,1,3,3,1,10,14,3,1,2,6,4,1,9,14,5,0,1,6
3837,119872,2022,USA,Brazil,0,2,5,7,20/07/2022,0,0,0,0,1,0,6,7,0,1,1,2,0,0,0,0,3,1,0,4
3838,119872,2022,Brazil,Japan,2,3,12,17,10/07/2022,0,0,0,0,4,1,5,10,2,7,7,16,0,0,1,1,2,0,0,2
3839,119872,2022,France,Brazil,2,0,10,12,08/07/2022,0,0,0,0,1,0,2,3,1,4,5,10,0,0,0,0,2,1,1,4
3840,119872,2022,Canada,Brazil,3,0,17,20,07/07/2022,0,0,1,1,7,0,2,9,0,3,6,9,1,0,0,1,4,1,1,6
3841,119872,2022,Brazil,Germany,1,1,16,18,06/07/2022,0,0,1,1,10,0,3,13,1,10,5,16,1,0,0,1,2,0,0,2
3842,119872,2022,Bulgaria,Brazil,1,4,9,14,26/06/2022,0,0,0,0,8,1,1,10,2,1,2,5,0,0,2,2,0,1,2,3
3843,119872,2022,Iran,Brazil,1,3,8,12,24/06/2022,0,0,1,1,9,0,2,11,4,3,5,12,0,0,0,0,0,0,0,0
3844,119872,2022,Serbia,Brazil,0,0,0,0,23/06/2022,0,0,0,0,0,0,0,0,0,0,0,0,0,0,0,0,0,0,0,0
3845,119872,2022,Brazil,Poland,0,2,1,3,22/06/2022,0,0,0,0,3,1,2,6,0,1,1,2,0,0,0,0,0,0,0,0
3846,119872,2022,Brazil,China,0,0,0,0,12/06/2022,0,0,0,0,0,0,0,0,0,0,0,0,0,0,0,0,0,0,0,0
3847,119872,2022,USA,Brazil,0,2,3,5,11/06/2022,0,0,0,0,4,1,1,6,0,1,1,2,0,0,0,0,0,0,0,0
3848,119872,2022,Brazil,Slovenia,0,0,0,0,10/06/2022,0,0,0,0,0,0,0,0,0,0,0,0,0,0,0,0,0,0,0,0
3849,119872,2022,Brazil,Australia,0,0,0,0,09/06/2022,0,0,0,0,0,0,0,0,0,0,0,0,0,0,0,0,0,0,0,0
3850,151789,2022,Brazil,China,0,0,0,0,12/06/2022,0,0,0,0,0,0,0,0,0,0,0,0,0,0,0,0,0,0,0,0
3851,151789,2022,USA,Brazil,0,1,4,5,11/06/2022,0,0,0,0,7,2,5,14,0,0,1,1,1,0,9,10,0,1,0,1
3852,151789,2022,Brazil,Slovenia,0,0,0,0,10/06/2022,0,0,1,1,0,0,0,0,0,0,0,0,0,0,0,0,0,0,0,0
3853,151789,2022,Brazil,Australia,0,1,0,1,09/06/2022,0,0,0,0,0,1,0,1,0,0,0,0,0,0,0,0,0,0,0,0
3854,142744,2022,USA,Brazil,0,0,4,4,20/07/2022,3,0,18,21,0,0,0,0,0,2,1,3,0,0,0,0,0,0,0,0
3855,142744,2022,Brazil,Japan,0,0,1,1,10/07/2022,0,0,0,0,0,0,0,0,0,0,0,0,0,0,0,0,0,1,0,1
3856,142744,2022,France,Brazil,0,1,5,6,08/07/2022,10,0,33,43,1,1,0,2,0,0,0,0,0,0,0,0,4,0,0,4
3857,142744,2022,Canada,Brazil,0,0,0,0,07/07/2022,0,0,1,1,0,0,0,0,0,0,0,0,0,0,0,0,0,0,0,0
3858,142744,2022,Brazil,Germany,1,0,2,3,06/07/2022,2,0,3,5,0,0,0,0,0,0,0,0,0,0,0,0,1,1,0,2
3859,142744,2022,Bulgaria,Brazil,0,0,2,2,26/06/2022,2,0,1,3,0,0,0,0,0,0,0,0,0,0,0,0,0,0,0,0
3860,142744,2022,Iran,Brazil,0,1,1,2,24/06/2022,5,0,9,14,0,0,0,0,0,0,0,0,0,0,0,0,0,0,0,0
3861,142744,2022,Serbia,Brazil,0,0,0,0,23/06/2022,0,0,0,0,0,0,0,0,0,0,0,0,0,0,0,0,0,0,0,0
3862,142744,2022,Brazil,Poland,0,0,4,4,22/06/2022,8,0,17,25,0,0,0,0,0,1,2,3,0,0,0,0,1,0,0,1
3863,142744,2022,Brazil,China,0,0,1,1,12/06/2022,1,1,1,3,0,0,0,0,0,0,0,0,0,0,0,0,1,1,0,2
3864,142744,2022,USA,Brazil,0,1,4,5,11/06/2022,11,0,15,26,0,0,0,0,0,0,2,2,0,0,0,0,1,1,0,2
3865,142744,2022,Brazil,Slovenia,0,0,0,0,10/06/2022,1,0,5,6,0,0,0,0,0,0,0,0,0,0,0,0,0,0,0,0
3866,142744,2022,Brazil,Australia,0,0,2,2,09/06/2022,1,0,0,1,0,0,0,0,0,0,0,0,0,0,0,0,0,0,0,0
3867,161939,2022,USA,Brazil,0,0,0,0,20/07/2022,0,0,2,2,0,0,0,0,0,0,0,0,0,0,0,0,1,3,0,4
3868,161939,2022,Brazil,Japan,0,0,0,0,10/07/2022,0,0,0,0,0,0,0,0,0,0,0,0,0,0,0,0,3,1,0,4
3869,161939,2022,France,Brazil,0,0,0,0,08/07/2022,0,0,0,0,0,0,0,0,0,0,0,0,0,0,0,0,1,0,0,1
3870,161939,2022,Canada,Brazil,0,0,0,0,07/07/2022,0,0,0,0,0,0,0,0,0,0,0,0,0,0,0,0,0,0,0,0
3871,161939,2022,Brazil,Germany,0,0,0,0,06/07/2022,0,0,0,0,0,0,0,0,0,0,0,0,0,0,0,0,0,0,0,0
3872,161939,2022,Bulgaria,Brazil,0,0,0,0,26/06/2022,0,0,0,0,0,0,0,0,0,0,0,0,0,0,1,1,0,0,1,1
3873,161939,2022,Iran,Brazil,0,0,0,0,24/06/2022,0,0,0,0,0,0,0,0,0,0,0,0,0,0,0,0,0,0,0,0
3874,161939,2022,Serbia,Brazil,0,0,0,0,23/06/2022,0,0,0,0,0,0,0,0,0,0,0,0,0,0,0,0,0,0,0,0
3875,161939,2022,Brazil,Poland,0,0,0,0,22/06/2022,1,1,1,3,0,0,0,0,0,0,0,0,1,3,11,15,4,5,1,10
3876,161939,2022,Brazil,China,0,0,0,0,12/06/2022,1,0,0,1,0,0,0,0,0,0,0,0,0,0,0,0,3,3,0,6
3877,161939,2022,USA,Brazil,0,0,0,0,11/06/2022,2,0,1,3,0,0,0,0,0,0,0,0,1,0,5,6,7,1,2,10
3878,161939,2022,Brazil,Slovenia,0,0,0,0,10/06/2022,1,0,0,1,0,0,0,0,0,0,0,0,0,0,1,1,7,2,1,10
3879,161939,2022,Brazil,Australia,0,0,0,0,09/06/2022,2,0,0,2,0,0,0,0,0,0,0,0,0,0,0,0,1,1,0,2
3880,116081,2022,USA,Brazil,0,2,6,8,20/07/2022,0,0,0,0,8,0,2,10,0,4,2,6,0,0,1,1,0,2,0,2
3881,116081,2022,Iran,Brazil,0,0,0,0,24/06/2022,0,0,0,0,0,0,0,0,0,0,0,0,0,0,0,0,0,0,0,0
3882,116081,2022,Serbia,Brazil,0,4,3,7,23/06/2022,0,0,0,0,2,0,6,8,1,5,3,9,0,0,0,0,0,1,0,1
3883,116081,2022,Brazil,Poland,0,3,9,12,22/06/2022,0,0,0,0,3,0,1,4,2,3,3,8,0,0,0,0,1,0,1,2
3884,116081,2022,Brazil,China,3,2,18,23,12/06/2022,0,0,1,1,8,2,0,10,1,3,1,5,0,0,0,0,1,1,1,3
3885,116081,2022,USA,Brazil,0,5,9,14,11/06/2022,0,0,0,0,5,2,2,9,4,4,4,12,0,0,0,0,1,0,0,1
3886,116081,2022,Brazil,Slovenia,1,4,14,19,10/06/2022,0,0,0,0,9,2,5,16,2,2,3,7,0,0,0,0,2,0,4,6
3887,116081,2022,Brazil,Australia,1,3,15,19,09/06/2022,0,0,0,0,3,1,5,9,1,5,2,8,0,0,0,0,4,1,0,5
3888,118916,2022,USA,Brazil,0,0,0,0,20/07/2022,1,0,1,2,0,0,0,0,0,0,0,0,16,0,7,23,6,2,1,9
3889,118916,2022,Brazil,Japan,0,0,0,0,10/07/2022,1,0,0,1,0,0,0,0,0,0,0,0,4,0,6,10,2,2,2,6
3890,118916,2022,France,Brazil,0,0,0,0,08/07/2022,0,0,7,7,0,0,0,0,0,0,0,0,3,1,10,14,5,2,0,7
3891,118916,2022,Canada,Brazil,0,0,0,0,07/07/2022,0,0,1,1,0,0,0,0,0,0,0,0,3,0,10,13,11,2,1,14
3892,118916,2022,Brazil,Germany,0,0,0,0,06/07/2022,0,0,5,5,0,0,0,0,0,0,0,0,5,2,8,15,13,3,1,17
3893,118916,2022,Bulgaria,Brazil,0,0,0,0,26/06/2022,0,0,1,1,0,0,0,0,0,0,0,0,4,0,6,10,5,4,0,9
3894,118916,2022,Iran,Brazil,0,0,0,0,24/06/2022,1,0,3,4,0,0,0,0,0,0,0,0,4,2,9,15,3,0,0,3
3895,118916,2022,Serbia,Brazil,0,0,0,0,23/06/2022,1,0,3,4,0,0,0,0,0,0,0,0,5,0,4,9,5,2,1,8
3896,118916,2022,Brazil,Poland,0,0,0,0,22/06/2022,0,0,4,4,0,0,0,0,0,0,0,0,3,1,2,6,1,1,1,3
3897,118916,2022,Brazil,China,0,0,0,0,12/06/2022,1,0,0,1,0,0,0,0,0,0,0,0,5,1,11,17,3,1,0,4
3898,118916,2022,USA,Brazil,0,0,0,0,11/06/2022,2,0,0,2,0,0,0,0,0,0,0,0,4,2,9,15,4,0,0,4
3899,118916,2022,Brazil,Slovenia,0,0,0,0,10/06/2022,0,0,0,0,0,0,0,0,0,0,0,0,8,3,8,19,5,1,0,6
3900,118916,2022,Brazil,Australia,0,0,0,0,09/06/2022,2,0,0,2,0,0,0,0,0,0,0,0,7,0,4,11,5,0,0,5
3901,136468,2022,USA,Brazil,1,1,16,18,20/07/2022,0,0,0,0,15,4,8,27,0,3,1,4,12,3,9,24,8,4,2,14
3902,136468,2022,Brazil,Japan,1,4,9,14,10/07/2022,0,0,6,6,7,4,3,14,1,1,2,4,9,2,13,24,10,1,3,14
3903,136468,2022,France,Brazil,0,0,0,0,08/07/2022,0,0,0,0,0,0,0,0,0,0,0,0,0,0,0,0,0,0,0,0
3904,136468,2022,Canada,Brazil,0,1,8,9,07/07/2022,0,0,6,6,4,1,10,15,0,1,2,3,3,0,12,15,4,2,2,8
3905,136468,2022,Brazil,Germany,2,3,14,19,06/07/2022,0,0,4,4,13,5,6,24,0,3,5,8,11,1,17,29,4,4,0,8
3906,136468,2022,Bulgaria,Brazil,1,3,10,14,26/06/2022,0,0,1,1,8,3,1,12,2,0,2,4,1,0,11,12,3,4,1,8
3907,136468,2022,Iran,Brazil,0,3,6,9,24/06/2022,0,0,2,2,15,2,5,22,0,2,2,4,11,0,15,26,1,1,1,3
3908,136468,2022,Serbia,Brazil,2,1,10,13,23/06/2022,1,0,0,1,10,2,7,19,2,2,0,4,4,2,10,16,2,3,1,6
3909,136468,2022,Brazil,Poland,0,2,7,9,22/06/2022,0,0,2,2,3,2,8,13,1,0,0,1,3,1,16,20,1,1,0,2
3910,136954,2022,USA,Brazil,0,0,0,0,20/07/2022,0,0,0,0,0,0,0,0,0,0,0,0,0,0,0,0,0,0,0,0
3911,136954,2022,Brazil,Japan,0,0,0,0,10/07/2022,0,0,0,0,0,0,0,0,0,0,0,0,0,0,0,0,0,0,0,0
3912,136954,2022,France,Brazil,0,0,4,4,08/07/2022,0,0,0,0,1,0,0,1,0,1,0,1,0,0,0,0,0,0,0,0
3913,136954,2022,Canada,Brazil,0,0,0,0,07/07/2022,0,0,0,0,0,0,0,0,0,0,0,0,0,0,0,0,0,0,0,0
3914,136954,2022,Brazil,Germany,0,0,0,0,06/07/2022,0,0,0,0,0,0,0,0,0,0,0,0,0,0,0,0,0,0,0,0
3915,136954,2022,Bulgaria,Brazil,0,0,0,0,26/06/2022,0,0,0,0,0,0,0,0,0,0,0,0,0,0,0,0,0,0,0,0
3916,136954,2022,Iran,Brazil,0,0,0,0,24/06/2022,0,0,0,0,0,0,0,0,0,0,0,0,0,0,0,0,0,0,0,0
3917,136954,2022,Serbia,Brazil,0,0,2,2,23/06/2022,0,0,0,0,0,0,0,0,1,1,0,2,0,0,0,0,0,0,0,0
3918,136954,2022,Brazil,Poland,0,0,0,0,22/06/2022,0,0,0,0,0,0,0,0,0,0,0,0,0,0,0,0,0,0,0,0
3919,136954,2022,Brazil,China,0,0,0,0,12/06/2022,0,0,0,0,0,0,0,0,0,0,0,0,0,0,0,0,0,0,0,0
3920,136954,2022,USA,Brazil,0,0,0,0,11/06/2022,0,0,0,0,0,0,0,0,0,0,0,0,0,0,0,0,0,0,0,0
3921,136954,2022,Brazil,Slovenia,0,0,0,0,10/06/2022,0,0,0,0,0,0,0,0,0,0,0,0,0,0,0,0,0,0,0,0
3922,136954,2022,Brazil,Australia,0,0,0,0,09/06/2022,0,0,0,0,0,0,0,0,0,0,0,0,0,0,0,0,0,0,0,0
3923,161930,2022,USA,Brazil,0,0,0,0,20/07/2022,0,0,0,0,0,0,0,0,0,0,0,0,0,0,0,0,0,0,0,0
3924,161930,2022,Brazil,Japan,0,0,0,0,10/07/2022,0,0,0,0,0,0,0,0,0,0,0,0,0,0,0,0,0,0,0,0
3925,161930,2022,France,Brazil,0,0,2,2,08/07/2022,0,0,1,1,0,0,0,0,0,0,0,0,0,0,0,0,0,0,0,0
3926,161930,2022,Canada,Brazil,0,0,3,3,07/07/2022,0,0,0,0,0,0,0,0,0,0,0,0,0,0,0,0,0,0,0,0
3927,161930,2022,Brazil,Germany,0,0,0,0,06/07/2022,0,0,1,1,0,0,0,0,0,0,0,0,0,0,2,2,0,0,0,0
3928,136947,2022,Iran,Brazil,0,2,1,3,24/06/2022,0,0,1,1,3,1,2,6,0,2,0,2,0,0,0,0,1,1,0,2
3929,136947,2022,Serbia,Brazil,3,3,11,17,23/06/2022,0,0,0,0,10,3,9,22,0,0,1,1,0,0,0,0,2,1,0,3
3930,136947,2022,Brazil,Poland,0,6,5,11,22/06/2022,0,0,1,1,19,4,11,34,0,3,2,5,0,1,0,1,1,2,2,5
3931,136947,2022,Brazil,China,0,3,9,12,12/06/2022,0,0,1,1,16,5,8,29,3,1,4,8,0,0,0,0,4,2,0,6
3932,136947,2022,USA,Brazil,1,4,11,16,11/06/2022,2,0,0,2,21,4,9,34,1,5,2,8,0,0,0,0,5,2,2,9
3933,136947,2022,Brazil,Slovenia,0,2,11,13,10/06/2022,1,0,0,1,16,3,9,28,2,6,3,11,0,0,0,0,5,0,0,5
3934,136947,2022,Brazil,Australia,2,1,8,11,09/06/2022,0,0,0,0,13,2,11,26,3,3,3,9,0,0,0,0,4,0,0,4
3935,161911,2022,,,-,-,-,-,-,-,-,-,-,-,-,-,-,-,-,-,-,-,-,-,-,-,-,-,-
3936,136956,2022,USA,Brazil,0,3,9,12,20/07/2022,0,0,1,1,7,1,2,10,2,3,3,8,1,0,0,1,1,2,1,4
3937,136956,2022,Brazil,Japan,0,0,9,9,10/07/2022,0,0,0,0,4,1,3,8,1,5,6,12,0,0,1,1,0,0,1,1
3938,136956,2022,France,Brazil,1,0,6,7,08/07/2022,0,0,1,1,6,2,4,12,1,6,3,10,0,1,2,3,2,1,2,5
3939,136956,2022,Canada,Brazil,0,0,7,7,07/07/2022,0,0,1,1,7,0,1,8,3,4,6,13,0,0,1,1,3,2,0,5
3940,136956,2022,Brazil,Germany,0,3,10,13,06/07/2022,0,0,1,1,7,1,4,12,3,2,8,13,1,0,1,2,3,1,1,5
3941,136956,2022,Bulgaria,Brazil,0,0,11,11,26/06/2022,0,0,0,0,6,0,3,9,4,0,2,6,1,0,2,3,0,0,0,0
3942,136956,2022,Iran,Brazil,0,3,10,13,24/06/2022,0,0,0,0,6,1,0,7,2,2,1,5,1,0,0,1,1,2,1,4
3943,136956,2022,Serbia,Brazil,0,2,9,11,23/06/2022,0,0,0,0,5,1,0,6,1,3,4,8,0,0,1,1,0,0,0,0
3944,136956,2022,Brazil,Poland,0,1,8,9,22/06/2022,0,0,0,0,6,0,7,13,1,6,5,12,0,0,0,0,1,1,0,2
3945,136956,2022,Brazil,China,0,0,9,9,12/06/2022,1,1,0,2,11,3,2,16,2,0,2,4,0,0,0,0,1,0,0,1
3946,136956,2022,USA,Brazil,0,1,8,9,11/06/2022,0,0,0,0,3,0,2,5,2,3,3,8,0,0,0,0,2,0,0,2
3947,136956,2022,Brazil,Slovenia,0,1,11,12,10/06/2022,1,0,1,2,5,1,3,9,3,2,6,11,0,0,0,0,2,0,0,2
3948,136956,2022,Brazil,Australia,0,0,7,7,09/06/2022,0,0,0,0,5,0,6,11,4,5,10,19,0,0,0,0,2,0,1,3
3949,161946,2022,Brazil,China,0,0,1,1,12/06/2022,0,0,0,0,0,1,0,1,0,0,0,0,1,1,1,3,0,0,1,1
3950,161946,2022,USA,Brazil,0,0,0,0,11/06/2022,0,0,0,0,0,0,0,0,0,0,0,0,0,0,0,0,0,0,0,0
3951,161946,2022,Brazil,Slovenia,0,0,0,0,10/06/2022,0,0,0,0,0,0,0,0,0,0,0,0,0,0,0,0,0,0,0,0
3952,161946,2022,Brazil,Australia,0,0,0,0,09/06/2022,0,0,0,0,0,0,0,0,0,0,0,0,0,0,0,0,0,0,0,0
3953,174902,2022,USA,Brazil,1,4,7,12,20/07/2022,0,0,0,0,11,3,7,21,1,2,5,8,0,0,0,0,5,3,0,8
3954,174902,2022,Brazil,Japan,0,1,7,8,10/07/2022,0,0,2,2,17,4,5,26,2,1,2,5,0,0,0,0,0,0,2,2
3955,174902,2022,France,Brazil,1,2,4,7,08/07/2022,0,0,0,0,8,2,7,17,0,4,5,9,0,0,0,0,1,1,0,2
3956,174902,2022,Canada,Brazil,0,1,8,9,07/07/2022,0,0,1,1,11,3,8,22,1,3,3,7,0,0,0,0,3,2,1,6
3957,174902,2022,Brazil,Germany,0,2,9,11,06/07/2022,0,0,0,0,13,5,5,23,0,3,5,8,0,0,1,1,4,2,1,7
3958,174902,2022,Bulgaria,Brazil,0,2,8,10,26/06/2022,0,0,0,0,10,4,5,19,0,1,3,4,0,0,1,1,0,1,0,1
3959,174902,2022,Iran,Brazil,0,5,3,8,24/06/2022,0,0,0,0,5,2,5,12,0,1,1,2,0,0,0,0,1,0,0,1
3960,174902,2022,Serbia,Brazil,0,0,0,0,23/06/2022,0,0,0,0,0,0,0,0,0,0,0,0,0,0,0,0,0,0,0,0
3961,174902,2022,Brazil,Poland,0,0,0,0,22/06/2022,0,0,0,0,0,1,0,1,0,0,0,0,0,0,0,0,0,0,0,0
3962,174445,2022,China,Bulgaria,0,4,13,17,09/07/2022,0,0,0,0,15,6,1,22,0,0,0,0,0,0,0,0,0,0,1,1
3963,174445,2022,Bulgaria,Netherlands,2,3,8,13,08/07/2022,0,0,2,2,10,4,4,18,0,1,0,1,0,0,0,0,4,0,0,4
3964,174445,2022,Bulgaria,Slovenia,0,0,0,0,07/07/2022,0,0,0,0,0,0,0,0,0,0,0,0,0,0,0,0,0,0,0,0
3965,174445,2022,Bulgaria,Italy,0,2,0,2,05/07/2022,0,0,0,0,2,2,2,6,0,0,0,0,0,0,0,0,0,0,0,0
3966,174445,2022,Bulgaria,Brazil,0,0,2,2,26/06/2022,0,0,0,0,1,0,1,2,0,0,1,1,0,0,0,0,0,0,0,0
3967,174445,2022,USA,Bulgaria,0,0,0,0,25/06/2022,0,0,0,0,0,0,0,0,0,0,0,0,0,0,0,0,0,0,0,0
3968,174445,2022,Australia,Bulgaria,0,0,1,1,24/06/2022,0,0,0,0,1,2,2,5,0,0,0,0,0,0,0,0,0,0,0,0
3969,174445,2022,Iran,Bulgaria,0,0,0,0,21/06/2022,0,0,0,0,0,0,0,0,0,0,0,0,0,0,0,0,0,0,0,0
3970,174445,2022,Bulgaria,Canada,0,0,0,0,12/06/2022,0,0,0,0,0,0,0,0,0,0,0,0,0,0,0,0,0,0,0,0
3971,174445,2022,Bulgaria,Poland,0,2,1,3,11/06/2022,0,0,0,0,2,4,5,11,1,1,2,4,1,0,0,1,2,2,0,4
3972,174445,2022,Bulgaria,Germany,0,1,2,3,10/06/2022,0,0,2,2,5,4,8,17,0,2,1,3,0,0,0,0,1,0,0,1
3973,174445,2022,Bulgaria,Serbia,0,0,0,0,07/06/2022,0,0,0,0,1,0,0,1,0,0,0,0,0,0,0,0,0,0,0,0
3974,180588,2022,China,Bulgaria,1,1,8,10,09/07/2022,0,0,0,0,4,0,3,7,0,3,0,3,0,0,1,1,0,1,0,1
3975,180588,2022,Bulgaria,Netherlands,0,0,0,0,08/07/2022,0,0,0,0,0,0,0,0,0,0,0,0,0,0,0,0,0,0,0,0
3976,180588,2022,Bulgaria,Slovenia,0,2,0,2,07/07/2022,0,0,0,0,0,1,0,1,0,0,0,0,0,0,0,0,0,0,0,0
3977,180588,2022,Bulgaria,Italy,0,0,4,4,05/07/2022,0,0,0,0,3,2,3,8,0,0,1,1,0,0,1,1,1,0,0,1
3978,180588,2022,Bulgaria,Brazil,0,2,5,7,26/06/2022,0,0,0,0,6,0,1,7,1,1,3,5,0,0,0,0,0,2,1,3
3979,180588,2022,USA,Bulgaria,1,4,9,14,25/06/2022,0,0,0,0,3,0,2,5,1,2,3,6,0,0,1,1,1,0,0,1
3980,180588,2022,Australia,Bulgaria,1,1,7,9,24/06/2022,0,0,0,0,2,1,1,4,1,1,0,2,0,0,0,0,0,0,0,0
3981,180588,2022,Iran,Bulgaria,0,0,0,0,21/06/2022,0,0,0,0,0,0,0,0,0,0,0,0,0,0,0,0,0,0,0,0
3982,180588,2022,Bulgaria,Canada,0,0,0,0,12/06/2022,0,0,0,0,0,0,0,0,0,0,0,0,0,0,0,0,0,0,0,0
3983,180588,2022,Bulgaria,Poland,0,2,6,8,11/06/2022,0,0,0,0,3,0,1,4,0,1,2,3,0,0,1,1,1,1,2,4
3984,180588,2022,Bulgaria,Germany,0,0,0,0,10/06/2022,0,0,0,0,0,0,0,0,0,0,0,0,0,0,0,0,0,0,0,0
3985,180588,2022,Bulgaria,Serbia,0,0,0,0,07/06/2022,0,0,0,0,0,0,0,0,0,0,0,0,0,0,0,0,0,0,0,0
3986,173067,2022,China,Bulgaria,0,0,9,9,09/07/2022,0,0,0,0,5,0,1,6,2,2,0,4,0,0,1,1,0,0,0,0
3987,173067,2022,Bulgaria,Netherlands,0,0,17,17,08/07/2022,1,0,0,1,5,2,1,8,2,3,0,5,0,0,0,0,0,0,0,0
3988,173067,2022,Bulgaria,Slovenia,0,0,12,12,07/07/2022,0,0,0,0,7,0,1,8,1,4,0,5,0,0,1,1,0,1,1,2
3989,173067,2022,Bulgaria,Italy,0,1,6,7,05/07/2022,0,0,0,0,2,1,0,3,0,0,0,0,0,0,0,0,1,1,0,2
3990,173067,2022,Bulgaria,Brazil,1,0,11,12,26/06/2022,0,0,0,0,1,1,3,5,3,2,2,7,1,0,3,4,2,0,0,2
3991,173067,2022,USA,Bulgaria,0,1,4,5,25/06/2022,0,0,0,0,4,0,1,5,0,1,1,2,0,0,2,2,0,0,0,0
3992,173067,2022,Australia,Bulgaria,0,0,6,6,24/06/2022,0,0,1,1,5,3,5,13,2,2,0,4,0,0,0,0,0,0,0,0
3993,173067,2022,Iran,Bulgaria,1,0,13,14,21/06/2022,0,0,0,0,5,3,2,10,1,5,3,9,0,0,2,2,1,0,0,1
3994,173067,2022,Bulgaria,Canada,1,1,14,16,12/06/2022,0,0,2,2,9,0,1,10,1,1,4,6,1,0,2,3,1,0,0,1
3995,173067,2022,Bulgaria,Poland,0,0,9,9,11/06/2022,1,0,2,3,9,0,2,11,4,4,7,15,0,0,1,1,3,2,0,5
3996,173067,2022,Bulgaria,Germany,0,0,13,13,10/06/2022,0,0,0,0,5,1,2,8,0,6,4,10,0,0,0,0,0,0,0,0
3997,173067,2022,Bulgaria,Serbia,0,0,1,1,07/06/2022,0,0,0,0,1,0,0,1,0,2,0,2,0,0,0,0,0,0,0,0
3998,156676,2022,China,Bulgaria,0,3,8,11,09/07/2022,0,1,2,3,10,3,4,17,0,2,0,2,2,1,21,24,0,2,0,2
3999,156676,2022,Bulgaria,Netherlands,2,1,7,10,08/07/2022,0,0,0,0,17,1,15,33,1,3,0,4,1,1,17,19,0,0,0,0
4000,156676,2022,Bulgaria,Slovenia,2,3,9,14,07/07/2022,0,1,0,1,12,2,11,25,1,3,0,4,6,2,21,29,1,2,0,3
4001,156676,2022,Bulgaria,Italy,1,3,8,12,05/07/2022,0,0,0,0,13,5,6,24,0,1,1,2,2,0,10,12,0,1,0,1
4002,156676,2022,Bulgaria,Brazil,0,1,7,8,26/06/2022,0,0,1,1,12,3,7,22,0,1,0,1,11,0,11,22,3,0,0,3
4003,156676,2022,USA,Bulgaria,2,4,11,17,25/06/2022,1,0,1,2,9,5,13,27,0,2,1,3,9,2,16,27,2,0,0,2
4004,156676,2022,Australia,Bulgaria,3,5,13,21,24/06/2022,0,0,0,0,11,6,11,28,0,3,0,3,13,1,15,29,3,2,0,5
4005,156676,2022,Iran,Bulgaria,4,2,11,17,21/06/2022,0,0,2,2,10,2,5,17,0,3,2,5,8,0,8,16,0,0,1,1
4006,156676,2022,Bulgaria,Canada,0,1,6,7,12/06/2022,0,0,0,0,4,4,5,13,0,1,0,1,3,1,10,14,0,1,0,1
4007,156676,2022,Bulgaria,Poland,0,2,1,3,11/06/2022,0,0,0,0,1,0,4,5,0,1,0,1,3,1,5,9,1,0,0,1
4008,156676,2022,Bulgaria,Germany,1,5,13,19,10/06/2022,0,0,3,3,13,4,9,26,4,2,2,8,3,1,20,24,7,2,1,10
4009,156676,2022,Bulgaria,Serbia,0,4,4,8,07/06/2022,0,0,0,0,5,5,8,18,1,3,0,4,3,0,11,14,1,1,0,2
4010,132035,2022,China,Bulgaria,0,1,11,12,09/07/2022,0,0,0,0,7,0,3,10,4,5,1,10,0,1,0,1,0,1,1,2
4011,132035,2022,Bulgaria,Netherlands,0,2,8,10,08/07/2022,0,0,0,0,6,0,4,10,6,5,0,11,0,0,0,0,2,1,0,3
4012,132035,2022,Bulgaria,Slovenia,1,2,8,11,07/07/2022,0,0,1,1,4,3,2,9,3,4,0,7,0,0,0,0,0,1,0,1
4013,132035,2022,Bulgaria,Italy,0,0,9,9,05/07/2022,0,0,0,0,2,0,2,4,2,1,0,3,0,0,1,1,2,1,0,3
4014,132035,2022,Bulgaria,Brazil,0,0,0,0,26/06/2022,0,0,0,0,0,0,0,0,0,0,0,0,0,0,0,0,0,0,0,0
4015,132035,2022,USA,Bulgaria,0,1,7,8,25/06/2022,1,0,0,1,4,0,3,7,2,4,3,9,0,0,1,1,1,0,0,1
4016,132035,2022,Australia,Bulgaria,0,1,10,11,24/06/2022,0,0,1,1,10,0,5,15,7,2,10,19,0,0,1,1,1,0,0,1
4017,132035,2022,Iran,Bulgaria,0,0,11,11,21/06/2022,0,0,0,0,4,1,1,6,6,8,2,16,1,1,0,2,3,0,0,3
4018,132035,2022,Bulgaria,Canada,0,0,0,0,12/06/2022,0,0,0,0,0,0,0,0,0,0,0,0,0,0,0,0,0,0,0,0
4019,132035,2022,Bulgaria,Poland,0,0,0,0,11/06/2022,0,0,0,0,0,0,0,0,0,0,0,0,0,0,0,0,0,0,0,0
4020,132035,2022,Bulgaria,Germany,0,1,9,10,10/06/2022,0,0,0,0,1,1,0,2,0,5,0,5,0,0,0,0,0,0,0,0
4021,132035,2022,Bulgaria,Serbia,2,1,18,21,07/06/2022,0,0,2,2,6,1,2,9,5,4,3,12,0,0,3,3,2,2,2,6
4022,162124,2022,,,-,-,-,-,-,-,-,-,-,-,-,-,-,-,-,-,-,-,-,-,-,-,-,-,-
4023,136489,2022,China,Bulgaria,1,1,5,7,09/07/2022,6,0,15,21,0,1,0,1,0,0,0,0,0,0,0,0,1,1,0,2
4024,136489,2022,Bulgaria,Netherlands,0,0,3,3,08/07/2022,0,0,0,0,0,0,0,0,0,0,0,0,0,0,0,0,0,0,0,0
4025,136489,2022,Bulgaria,Slovenia,0,0,4,4,07/07/2022,6,0,8,14,0,0,1,1,0,1,0,1,0,0,0,0,0,1,0,1
4026,136489,2022,Bulgaria,Italy,0,0,0,0,05/07/2022,0,0,0,0,0,0,0,0,0,0,0,0,0,0,0,0,0,0,0,0
4027,136489,2022,Bulgaria,Brazil,0,2,10,12,26/06/2022,19,2,51,72,2,1,0,3,0,3,0,3,0,0,0,0,1,1,0,2
4028,136489,2022,USA,Bulgaria,0,0,2,2,25/06/2022,1,0,9,10,0,0,0,0,0,0,0,0,0,0,0,0,0,0,0,0
4029,136489,2022,Australia,Bulgaria,1,1,5,7,24/06/2022,1,0,4,5,0,0,0,0,0,0,1,1,0,0,0,0,0,0,0,0
4030,136489,2022,Iran,Bulgaria,0,0,0,0,21/06/2022,0,0,0,0,0,0,0,0,0,0,0,0,0,0,0,0,0,0,0,0
4031,136489,2022,Bulgaria,Canada,0,0,1,1,12/06/2022,1,0,0,1,0,0,0,0,0,1,1,2,0,0,0,0,0,0,0,0
4032,136489,2022,Bulgaria,Poland,0,0,5,5,11/06/2022,13,0,6,19,0,0,0,0,0,0,0,0,0,0,0,0,0,2,0,2
4033,136489,2022,Bulgaria,Germany,0,0,1,1,10/06/2022,0,0,0,0,0,0,0,0,0,0,0,0,0,0,0,0,0,0,0,0
4034,136489,2022,Bulgaria,Serbia,0,0,1,1,07/06/2022,7,0,3,10,0,0,1,1,0,0,0,0,0,0,0,0,0,0,1,1
4035,137012,2022,China,Bulgaria,0,1,8,9,09/07/2022,13,0,49,62,0,2,0,2,0,2,0,2,0,0,0,0,1,0,0,1
4036,137012,2022,Bulgaria,Netherlands,1,0,15,16,08/07/2022,19,2,77,98,0,0,1,1,2,2,0,4,0,0,0,0,0,1,1,2
4037,137012,2022,Bulgaria,Slovenia,0,1,10,11,07/07/2022,16,0,64,80,1,0,0,1,1,1,0,2,0,0,0,0,0,1,0,1
4038,137012,2022,Bulgaria,Italy,0,1,8,9,05/07/2022,11,1,71,83,0,0,0,0,0,0,0,0,0,0,0,0,0,0,0,0
4039,137012,2022,Bulgaria,Brazil,0,0,0,0,26/06/2022,0,0,0,0,0,0,0,0,0,0,0,0,0,0,0,0,0,0,0,0
4040,137012,2022,USA,Bulgaria,0,1,11,12,25/06/2022,22,1,63,86,0,0,1,1,0,1,1,2,0,0,1,1,1,1,1,3
4041,137012,2022,Australia,Bulgaria,0,1,14,15,24/06/2022,40,1,61,102,2,1,1,4,2,4,3,9,0,0,0,0,1,1,1,3
4042,137012,2022,Iran,Bulgaria,0,3,10,13,21/06/2022,19,0,50,69,1,0,0,1,0,0,5,5,0,0,0,0,5,1,0,6
4043,137012,2022,Bulgaria,Canada,0,2,10,12,12/06/2022,54,0,36,90,1,0,2,3,1,7,3,11,0,0,1,1,8,4,4,16
4044,137012,2022,Bulgaria,Poland,0,2,7,9,11/06/2022,24,0,26,50,0,0,1,1,0,0,2,2,0,0,1,1,4,3,1,8
4045,137012,2022,Bulgaria,Germany,0,1,15,16,10/06/2022,37,2,59,98,3,0,1,4,1,3,1,5,0,0,0,0,6,4,3,13
4046,137012,2022,Bulgaria,Serbia,0,1,11,12,07/06/2022,46,1,31,78,1,0,0,1,1,0,1,2,0,0,1,1,2,5,4,11
4047,181285,2022,,,-,-,-,-,-,-,-,-,-,-,-,-,-,-,-,-,-,-,-,-,-,-,-,-,-
4048,152619,2022,Bulgaria,Canada,0,1,14,15,12/06/2022,0,0,1,1,4,1,6,11,2,6,6,14,2,0,0,2,3,3,1,7
4049,152619,2022,Bulgaria,Poland,1,0,3,4,11/06/2022,0,0,0,0,1,0,2,3,0,2,3,5,0,1,0,1,0,0,1,1
4050,152619,2022,Bulgaria,Germany,0,2,7,9,10/06/2022,0,0,2,2,5,1,3,9,1,4,8,13,1,0,0,1,2,0,1,3
4051,152619,2022,Bulgaria,Serbia,1,2,7,10,07/06/2022,0,0,1,1,5,1,5,11,5,8,11,24,0,0,0,0,1,1,1,3
4052,174484,2022,,,-,-,-,-,-,-,-,-,-,-,-,-,-,-,-,-,-,-,-,-,-,-,-,-,-
4053,180587,2022,,,-,-,-,-,-,-,-,-,-,-,-,-,-,-,-,-,-,-,-,-,-,-,-,-,-
4054,168269,2022,China,Bulgaria,0,1,1,2,09/07/2022,0,0,2,2,1,1,2,4,1,1,0,2,1,0,5,6,1,0,0,1
4055,168269,2022,Bulgaria,Netherlands,0,0,0,0,08/07/2022,0,0,0,0,0,0,0,0,0,0,0,0,0,0,0,0,0,0,0,0
4056,168269,2022,Bulgaria,Slovenia,0,2,5,7,07/07/2022,0,0,1,1,4,6,5,15,0,1,0,1,0,0,1,1,0,0,0,0
4057,168269,2022,Bulgaria,Italy,0,0,0,0,05/07/2022,0,0,0,0,0,2,1,3,0,0,0,0,0,0,1,1,0,0,0,0
4058,168269,2022,Bulgaria,Brazil,1,3,1,5,26/06/2022,0,0,0,0,6,3,5,14,2,2,1,5,5,0,10,15,0,1,0,1
4059,168269,2022,USA,Bulgaria,0,0,0,0,25/06/2022,0,0,0,0,0,0,0,0,0,0,0,0,0,0,0,0,0,0,0,0
4060,168269,2022,Australia,Bulgaria,0,2,7,9,24/06/2022,0,0,0,0,4,0,4,8,2,3,1,6,0,0,0,0,2,0,0,2
4061,168269,2022,Iran,Bulgaria,0,0,0,0,21/06/2022,0,0,0,0,0,0,0,0,0,0,0,0,0,0,0,0,0,0,0,0
4062,168269,2022,Bulgaria,Canada,3,1,6,10,12/06/2022,1,0,1,2,12,3,7,22,0,5,2,7,1,0,12,13,0,0,1,1
4063,168269,2022,Bulgaria,Poland,1,1,3,5,11/06/2022,1,0,0,1,2,2,6,10,1,0,1,2,1,2,4,7,1,0,1,2
4064,168269,2022,Bulgaria,Germany,0,0,0,0,10/06/2022,0,0,0,0,0,0,0,0,0,0,0,0,0,0,0,0,0,0,0,0
4065,168269,2022,Bulgaria,Serbia,0,1,5,6,07/06/2022,0,0,0,0,8,0,2,10,0,0,0,0,0,2,13,15,0,0,1,1
4066,150277,2022,China,Bulgaria,0,0,0,0,09/07/2022,0,0,0,0,0,0,0,0,0,0,0,0,0,0,0,0,0,0,0,0
4067,150277,2022,Bulgaria,Netherlands,0,2,7,9,08/07/2022,0,0,1,1,1,2,5,8,1,1,0,2,0,0,1,1,0,0,0,0
4068,150277,2022,Bulgaria,Slovenia,1,2,3,6,07/07/2022,0,0,1,1,6,3,7,16,0,1,0,1,0,0,1,1,1,0,0,1
4069,150277,2022,Bulgaria,Italy,1,2,5,8,05/07/2022,0,0,0,0,4,5,9,18,0,1,0,1,0,1,2,3,0,0,0,0
4070,150277,2022,Bulgaria,Brazil,0,4,5,9,26/06/2022,0,0,0,0,6,3,7,16,2,2,0,4,1,0,2,3,2,2,0,4
4071,150277,2022,USA,Bulgaria,0,2,9,11,25/06/2022,0,0,0,0,13,6,8,27,2,3,3,8,1,0,1,2,3,1,0,4
4072,150277,2022,Australia,Bulgaria,0,1,4,5,24/06/2022,0,0,0,0,5,7,3,15,0,1,4,5,0,0,0,0,2,1,0,3
4073,150277,2022,Iran,Bulgaria,1,2,8,11,21/06/2022,1,0,0,1,4,3,5,12,1,2,0,3,0,0,0,0,1,0,0,1
4074,150277,2022,Bulgaria,Canada,1,4,15,20,12/06/2022,0,0,2,2,9,6,7,22,3,4,5,12,1,0,2,3,5,2,1,8
4075,150277,2022,Bulgaria,Poland,0,2,2,4,11/06/2022,0,0,2,2,6,2,2,10,0,2,5,7,0,0,0,0,2,1,0,3
4076,150277,2022,Bulgaria,Germany,0,2,6,8,10/06/2022,0,0,0,0,5,5,3,13,1,3,3,7,0,0,2,2,1,2,0,3
4077,150277,2022,Bulgaria,Serbia,0,3,8,11,07/06/2022,0,0,2,2,13,2,7,22,2,6,2,10,0,0,1,1,2,9,1,12
4078,118484,2022,China,Bulgaria,0,0,0,0,09/07/2022,0,0,5,5,0,0,0,0,0,0,0,0,4,3,9,16,5,2,2,9
4079,118484,2022,Bulgaria,Netherlands,0,0,0,0,08/07/2022,0,0,1,1,0,0,0,0,0,0,0,0,5,2,13,20,4,3,2,9
4080,118484,2022,Bulgaria,Slovenia,0,0,0,0,07/07/2022,0,0,1,1,0,0,0,0,0,0,0,0,1,0,22,23,2,0,0,2
4081,118484,2022,Bulgaria,Italy,0,0,0,0,05/07/2022,0,0,1,1,0,0,0,0,0,0,0,0,3,3,10,16,2,0,2,4
4082,118484,2022,Bulgaria,Brazil,0,0,0,0,26/06/2022,0,0,2,2,0,0,0,0,0,0,0,0,2,1,7,10,2,0,0,2
4083,118484,2022,USA,Bulgaria,0,0,0,0,25/06/2022,0,0,2,2,0,0,0,0,0,0,0,0,1,1,12,14,2,4,0,6
4084,118484,2022,Australia,Bulgaria,0,0,0,0,24/06/2022,2,0,5,7,0,0,0,0,0,0,0,0,6,1,14,21,4,2,5,11
4085,118484,2022,Iran,Bulgaria,0,0,0,0,21/06/2022,1,0,3,4,0,0,0,0,0,0,0,0,9,0,9,18,3,2,0,5
4086,174444,2022,China,Bulgaria,0,0,0,0,09/07/2022,0,0,0,0,0,0,0,0,0,0,0,0,0,0,0,0,0,0,0,0
4087,174444,2022,Bulgaria,Netherlands,0,0,0,0,08/07/2022,0,0,0,0,0,0,0,0,0,0,0,0,0,0,0,0,0,0,0,0
4088,174444,2022,Bulgaria,Slovenia,0,0,0,0,07/07/2022,0,0,0,0,0,0,0,0,0,0,0,0,0,0,0,0,0,0,0,0
4089,174444,2022,Bulgaria,Italy,0,0,0,0,05/07/2022,0,0,0,0,0,0,0,0,0,0,0,0,0,0,0,0,0,0,0,0
4090,174444,2022,Bulgaria,Canada,0,0,0,0,12/06/2022,0,0,0,0,0,0,0,0,0,0,0,0,0,0,0,0,0,0,0,0
4091,174444,2022,Bulgaria,Poland,0,0,0,0,11/06/2022,0,0,0,0,0,0,0,0,0,0,0,0,0,0,0,0,0,0,0,0
4092,174444,2022,Bulgaria,Germany,0,0,0,0,10/06/2022,0,0,0,0,0,0,0,0,0,0,0,0,0,0,0,0,0,0,0,0
4093,174444,2022,Bulgaria,Serbia,0,0,0,0,07/06/2022,0,0,0,0,0,0,0,0,0,0,0,0,0,0,0,0,0,0,0,0
4094,164812,2022,China,Bulgaria,1,1,3,5,09/07/2022,0,0,0,0,2,1,1,4,0,1,0,1,0,0,8,8,1,0,0,1
4095,164812,2022,Bulgaria,Netherlands,0,0,0,0,08/07/2022,0,0,0,0,0,0,0,0,0,0,0,0,0,0,2,2,0,0,1,1
4096,164812,2022,Bulgaria,Slovenia,0,0,0,0,07/07/2022,0,0,0,0,1,0,0,1,0,0,0,0,0,0,3,3,0,1,0,1
4097,164812,2022,Bulgaria,Italy,0,0,0,0,05/07/2022,0,0,0,0,0,0,0,0,0,0,0,0,0,0,0,0,0,0,0,0
4098,164812,2022,Bulgaria,Brazil,0,0,2,2,26/06/2022,0,0,0,0,0,0,0,0,0,0,0,0,0,0,1,1,0,0,0,0
4099,164812,2022,USA,Bulgaria,0,0,0,0,25/06/2022,0,0,0,0,0,0,0,0,0,0,0,0,1,0,1,2,0,0,0,0
4100,164812,2022,Australia,Bulgaria,0,0,0,0,24/06/2022,0,0,0,0,1,0,0,1,0,0,1,1,2,0,2,4,0,0,0,0
4101,164812,2022,Iran,Bulgaria,0,0,0,0,21/06/2022,0,0,0,0,0,0,0,0,0,0,0,0,0,0,0,0,0,0,0,0
4102,164812,2022,Bulgaria,Canada,0,0,0,0,12/06/2022,0,0,0,0,0,0,0,0,0,0,0,0,0,0,0,0,0,0,0,0
4103,164812,2022,Bulgaria,Poland,0,2,2,4,11/06/2022,0,0,2,2,4,4,2,10,1,1,1,3,7,1,9,17,1,0,0,1
4104,164812,2022,Bulgaria,Germany,0,0,0,0,10/06/2022,0,0,0,0,0,0,0,0,0,0,0,0,1,0,1,2,1,1,0,2
4105,164812,2022,Bulgaria,Serbia,0,0,0,0,07/06/2022,0,0,0,0,0,0,0,0,0,0,0,0,0,0,1,1,0,0,0,0
4106,136483,2022,,,-,-,-,-,-,-,-,-,-,-,-,-,-,-,-,-,-,-,-,-,-,-,-,-,-
4107,168268,2022,China,Bulgaria,0,0,0,0,09/07/2022,0,0,0,0,0,0,0,0,0,0,0,0,0,0,0,0,0,0,0,0
4108,168268,2022,Bulgaria,Netherlands,0,0,0,0,08/07/2022,0,0,0,0,0,0,0,0,0,0,0,0,0,0,0,0,0,0,0,0
4109,168268,2022,Bulgaria,Slovenia,0,0,0,0,07/07/2022,0,0,0,0,0,0,0,0,0,0,0,0,0,0,0,0,0,0,0,0
4110,168268,2022,Bulgaria,Italy,0,0,0,0,05/07/2022,0,0,0,0,0,0,0,0,0,0,0,0,0,0,0,0,0,0,0,0
4111,168268,2022,Bulgaria,Brazil,0,0,0,0,26/06/2022,0,0,0,0,0,0,0,0,0,0,0,0,0,0,0,0,0,0,0,0
4112,168268,2022,USA,Bulgaria,0,0,0,0,25/06/2022,0,0,0,0,0,0,0,0,0,0,0,0,0,0,0,0,0,0,0,0
4113,168268,2022,Australia,Bulgaria,0,0,0,0,24/06/2022,0,0,0,0,0,0,0,0,0,0,0,0,0,0,0,0,0,0,0,0
4114,168268,2022,Iran,Bulgaria,0,0,0,0,21/06/2022,0,0,0,0,0,0,0,0,0,0,0,0,0,0,0,0,0,0,0,0
4115,162123,2022,,,-,-,-,-,-,-,-,-,-,-,-,-,-,-,-,-,-,-,-,-,-,-,-,-,-
4116,180586,2022,China,Bulgaria,0,0,10,10,09/07/2022,0,0,1,1,11,2,7,20,0,2,0,2,1,2,24,27,2,0,0,2
4117,180586,2022,Bulgaria,Netherlands,0,4,14,18,08/07/2022,0,0,1,1,14,3,7,24,0,3,0,3,4,3,24,31,0,2,0,2
4118,180586,2022,Bulgaria,Slovenia,0,6,9,15,07/07/2022,0,0,0,0,10,6,7,23,3,3,0,6,2,1,22,25,1,0,0,1
4119,180586,2022,Bulgaria,Italy,0,2,6,8,05/07/2022,0,0,0,0,11,2,5,18,0,0,0,0,5,2,24,31,0,1,0,1
4120,180586,2022,Bulgaria,Brazil,1,0,6,7,26/06/2022,0,0,0,0,4,2,2,8,0,1,0,1,1,3,3,7,0,0,0,0
4121,180586,2022,USA,Bulgaria,3,3,10,16,25/06/2022,0,0,0,0,14,4,14,32,0,4,0,4,10,5,12,27,2,3,0,5
4122,180586,2022,Australia,Bulgaria,2,2,12,16,24/06/2022,2,0,0,2,12,4,9,25,3,3,3,9,9,5,25,39,4,2,1,7
4123,180586,2022,Iran,Bulgaria,0,4,5,9,21/06/2022,0,0,1,1,20,4,7,31,0,2,1,3,6,0,13,19,0,1,1,2
4124,180586,2022,Bulgaria,Canada,2,3,12,17,12/06/2022,0,0,7,7,13,6,13,32,2,5,3,10,5,3,22,30,8,1,1,10
4125,180586,2022,Bulgaria,Poland,0,0,8,8,11/06/2022,0,0,2,2,8,0,11,19,1,2,1,4,4,0,13,17,5,0,1,6
4126,180586,2022,Bulgaria,Germany,1,6,10,17,10/06/2022,0,0,0,0,21,4,8,33,3,3,4,10,10,4,21,35,3,2,1,6
4127,180586,2022,Bulgaria,Serbia,0,1,16,17,07/06/2022,0,0,1,1,12,6,7,25,1,4,0,5,5,3,27,35,1,2,5,8
4128,173009,2022,Bulgaria,Brazil,0,0,0,0,26/06/2022,0,0,0,0,0,0,0,0,0,0,0,0,0,0,0,0,0,0,0,0
4129,173009,2022,USA,Bulgaria,0,0,0,0,25/06/2022,0,0,0,0,0,0,0,0,0,0,0,0,0,0,0,0,0,0,0,0
4130,173009,2022,Australia,Bulgaria,0,0,0,0,24/06/2022,0,0,0,0,0,0,0,0,0,0,0,0,0,0,0,0,0,0,0,0
4131,173009,2022,Iran,Bulgaria,0,0,0,0,21/06/2022,0,0,0,0,0,0,0,0,0,0,0,0,0,0,0,0,0,0,0,0
4132,173009,2022,Bulgaria,Canada,0,0,0,0,12/06/2022,1,1,5,7,0,0,0,0,0,0,0,0,8,3,12,23,3,3,3,9
4133,173009,2022,Bulgaria,Poland,0,0,0,0,11/06/2022,0,0,5,5,0,0,0,0,0,0,0,0,3,1,5,9,3,1,2,6
4134,173009,2022,Bulgaria,Germany,0,0,0,0,10/06/2022,0,0,2,2,0,0,0,0,0,0,0,0,5,0,22,27,7,2,0,9
4135,173009,2022,Bulgaria,Serbia,0,0,0,0,07/06/2022,0,1,3,4,0,0,0,0,0,0,0,0,2,3,10,15,1,7,4,12
4136,181806,2022,,,-,-,-,-,-,-,-,-,-,-,-,-,-,-,-,-,-,-,-,-,-,-,-,-,-
4137,174446,2022,,,-,-,-,-,-,-,-,-,-,-,-,-,-,-,-,-,-,-,-,-,-,-,-,-,-
4138,135372,2022,,,-,-,-,-,-,-,-,-,-,-,-,-,-,-,-,-,-,-,-,-,-,-,-,-,-
4139,168941,2022,,,-,-,-,-,-,-,-,-,-,-,-,-,-,-,-,-,-,-,-,-,-,-,-,-,-
4140,168922,2022,,,-,-,-,-,-,-,-,-,-,-,-,-,-,-,-,-,-,-,-,-,-,-,-,-,-
4141,162249,2022,Bulgaria,Canada,0,0,0,0,12/06/2022,0,0,0,0,0,0,0,0,0,0,0,0,0,0,0,0,0,0,0,0
4142,162249,2022,Canada,Italy,0,0,0,0,11/06/2022,0,0,0,0,0,0,0,0,0,0,0,0,0,0,0,0,0,0,0,0
4143,162249,2022,France,Canada,0,0,0,0,10/06/2022,0,2,2,4,0,0,0,0,0,0,0,0,2,4,12,18,6,2,2,10
4144,162249,2022,Canada,Germany,0,0,0,0,07/06/2022,0,0,0,0,0,0,0,0,0,0,0,0,0,0,0,0,0,0,0,0
4145,136291,2022,Canada,USA,0,0,0,0,09/07/2022,0,0,0,0,0,0,0,0,0,0,0,0,0,0,0,0,0,0,0,0
4146,136291,2022,Japan,Canada,0,0,0,0,08/07/2022,0,0,0,0,0,0,0,0,0,0,0,0,0,0,0,0,0,0,0,0
4147,136291,2022,Canada,Brazil,0,0,0,0,07/07/2022,0,0,0,0,0,0,0,0,0,0,0,0,0,0,0,0,0,0,0,0
4148,136291,2022,Canada,Argentina,0,0,5,5,05/07/2022,0,0,0,0,0,0,0,0,0,0,0,0,0,0,0,0,0,1,0,1
4149,136291,2022,Australia,Canada,0,2,3,5,21/06/2022,0,0,0,0,4,1,8,13,0,1,0,1,7,2,8,17,0,0,1,1
4150,136291,2022,Bulgaria,Canada,0,5,13,18,12/06/2022,1,0,8,9,14,6,2,22,1,1,3,5,1,2,25,28,4,0,4,8
4151,136291,2022,Canada,Italy,0,1,10,11,11/06/2022,0,0,5,5,5,4,9,18,1,0,0,1,2,0,10,12,4,0,0,4
4152,136291,2022,France,Canada,0,0,4,4,10/06/2022,0,0,0,0,0,0,0,0,0,0,0,0,0,0,0,0,0,0,0,0
4153,136291,2022,Canada,Germany,2,4,10,16,07/06/2022,0,0,6,6,10,2,3,15,0,2,1,3,4,2,11,17,3,1,0,4
4154,157327,2022,Canada,USA,0,0,0,0,09/07/2022,0,0,0,0,1,0,0,1,0,0,0,0,0,1,2,3,0,0,1,1
4155,157327,2022,Japan,Canada,0,3,3,6,08/07/2022,2,0,4,6,4,3,5,12,0,0,0,0,3,1,5,9,2,0,2,4
4156,157327,2022,Canada,Brazil,2,3,6,11,07/07/2022,0,0,3,3,8,9,8,25,1,3,2,6,3,2,14,19,6,1,4,11
4157,157327,2022,Canada,Argentina,0,3,14,17,05/07/2022,0,1,1,2,19,5,13,37,1,3,2,6,4,0,18,22,3,1,3,7
4158,157327,2022,Canada,Iran,1,5,6,12,25/06/2022,0,0,3,3,11,3,11,25,1,0,0,1,1,2,13,16,3,1,0,4
4159,157327,2022,Serbia,Canada,4,6,9,19,24/06/2022,0,0,3,3,14,5,7,26,1,2,0,3,2,1,26,29,0,2,0,2
4160,157327,2022,Poland,Canada,0,1,2,3,23/06/2022,0,0,0,0,0,0,0,0,0,0,0,0,0,0,0,0,0,0,0,0
4161,157327,2022,Australia,Canada,2,3,6,11,21/06/2022,0,0,0,0,3,2,10,15,0,1,0,1,4,1,16,21,1,1,1,3
4162,140042,2022,,,-,-,-,-,-,-,-,-,-,-,-,-,-,-,-,-,-,-,-,-,-,-,-,-,-
4163,140061,2022,Canada,USA,0,2,7,9,09/07/2022,1,0,4,5,7,4,15,26,0,3,1,4,5,1,8,14,2,1,1,4
4164,140061,2022,Japan,Canada,2,2,9,13,08/07/2022,1,0,4,5,17,6,14,37,1,3,4,8,10,2,22,34,11,4,1,16
4165,140061,2022,Canada,Brazil,0,0,0,0,07/07/2022,0,0,0,0,0,0,0,0,0,0,0,0,0,0,0,0,0,0,0,0
4166,140061,2022,Canada,Argentina,2,6,5,13,05/07/2022,0,0,1,1,10,9,12,31,0,5,3,8,6,1,25,32,11,2,1,14
4167,140061,2022,Canada,Iran,2,4,8,14,25/06/2022,0,0,2,2,14,2,11,27,2,3,0,5,4,1,16,21,4,3,0,7
4168,140061,2022,Serbia,Canada,3,1,14,18,24/06/2022,0,0,2,2,18,5,13,36,1,7,2,10,5,1,16,22,0,1,0,1
4169,140061,2022,Poland,Canada,0,0,0,0,23/06/2022,0,0,0,0,0,0,0,0,0,0,0,0,0,0,1,1,0,0,0,0
4170,140061,2022,Australia,Canada,1,1,14,16,21/06/2022,0,0,0,0,19,0,16,35,3,1,3,7,3,2,12,17,2,1,2,5
4171,140061,2022,Bulgaria,Canada,2,1,20,23,12/06/2022,0,0,2,2,21,4,16,41,2,5,1,8,4,1,32,37,7,0,6,13
4172,140061,2022,Canada,Italy,0,2,7,9,11/06/2022,0,0,4,4,6,3,16,25,0,4,0,4,5,1,12,18,4,0,1,5
4173,140061,2022,France,Canada,2,2,8,12,10/06/2022,0,0,0,0,10,7,7,24,0,3,2,5,2,1,10,13,6,2,3,11
4174,140061,2022,Canada,Germany,1,1,9,11,07/06/2022,0,0,3,3,17,8,9,34,0,3,2,5,1,1,10,12,3,0,3,6
4175,143745,2022,Canada,Iran,1,2,4,7,25/06/2022,16,0,24,40,0,0,1,1,0,2,0,2,0,0,0,0,1,0,0,1
4176,143745,2022,Serbia,Canada,0,1,14,15,24/06/2022,24,2,64,90,0,1,1,2,0,1,0,1,0,0,0,0,2,1,0,3
4177,143745,2022,Poland,Canada,1,1,7,9,23/06/2022,9,1,58,68,0,0,0,0,0,2,1,3,0,0,0,0,1,1,0,2
4178,143745,2022,Australia,Canada,0,0,12,12,21/06/2022,29,0,59,88,1,0,0,1,0,1,3,4,0,0,0,0,1,0,0,1
4179,143745,2022,Bulgaria,Canada,0,3,11,14,12/06/2022,53,2,44,99,3,0,3,6,3,2,8,13,0,0,0,0,6,1,0,7
4180,143745,2022,Canada,Italy,0,0,2,2,11/06/2022,0,0,25,25,0,0,0,0,0,1,0,1,0,0,0,0,0,0,0,0
4181,143745,2022,France,Canada,1,1,7,9,10/06/2022,28,0,31,59,1,0,2,3,2,2,2,6,0,0,0,0,5,1,1,7
4182,143745,2022,Canada,Germany,1,0,2,3,07/06/2022,2,0,8,10,0,0,0,0,0,0,0,0,0,0,0,0,0,1,0,1
4183,124553,2022,Canada,USA,0,0,1,1,09/07/2022,0,0,5,5,0,0,0,0,0,0,0,0,0,0,0,0,0,2,1,3
4184,124553,2022,Japan,Canada,0,1,8,9,08/07/2022,26,1,26,53,2,0,1,3,0,2,1,3,0,0,0,0,7,1,1,9
4185,124553,2022,Canada,Brazil,2,1,7,10,07/07/2022,24,2,40,66,0,0,1,1,0,0,5,5,0,0,0,0,3,1,1,5
4186,124553,2022,Canada,Argentina,0,0,0,0,05/07/2022,0,0,0,0,0,0,0,0,0,0,0,0,0,0,0,0,0,0,0,0
4187,124553,2022,Bulgaria,Canada,0,0,0,0,12/06/2022,0,0,0,0,0,0,0,0,0,0,0,0,0,0,0,0,0,0,0,0
4188,124553,2022,Canada,Italy,0,0,3,3,11/06/2022,0,0,40,40,0,0,0,0,0,0,1,1,0,0,2,2,4,2,0,6
4189,124553,2022,France,Canada,0,0,0,0,10/06/2022,0,0,0,0,0,0,0,0,0,0,0,0,0,0,0,0,0,0,0,0
4190,124553,2022,Canada,Germany,0,1,3,4,07/06/2022,18,1,34,53,0,0,0,0,0,3,1,4,0,0,0,0,5,2,1,8
4191,140428,2022,Canada,USA,0,0,3,3,09/07/2022,0,0,0,0,7,2,6,15,0,0,2,2,0,0,2,2,5,1,1,7
4192,140428,2022,Japan,Canada,0,3,3,6,08/07/2022,0,0,1,1,4,0,6,10,1,1,4,6,0,0,3,3,4,1,0,5
4193,140428,2022,Canada,Brazil,0,0,2,2,07/07/2022,0,0,0,0,0,0,0,0,0,0,0,0,0,0,0,0,0,1,0,1
4194,140428,2022,Canada,Argentina,1,8,7,16,05/07/2022,0,0,2,2,13,0,7,20,2,5,8,15,0,1,2,3,4,0,1,5
4195,140428,2022,Canada,Iran,0,3,6,9,25/06/2022,0,0,0,0,8,2,3,13,0,0,0,0,0,0,2,2,3,1,0,4
4196,140428,2022,Serbia,Canada,1,5,13,19,24/06/2022,1,0,0,1,13,2,6,21,3,3,0,6,0,1,6,7,4,1,2,7
4197,140428,2022,Poland,Canada,0,0,0,0,23/06/2022,0,0,0,0,0,0,0,0,0,0,0,0,0,0,0,0,0,0,0,0
4198,140428,2022,Australia,Canada,2,2,14,18,21/06/2022,0,0,0,0,13,4,7,24,1,2,3,6,0,0,2,2,2,0,0,2
4199,140428,2022,Bulgaria,Canada,4,4,11,19,12/06/2022,0,0,1,1,11,4,9,24,2,3,2,7,0,1,0,1,6,2,0,8
4200,140428,2022,Canada,Italy,0,3,3,6,11/06/2022,0,0,2,2,3,5,8,16,0,2,0,2,2,0,4,6,4,0,0,4
4201,140428,2022,France,Canada,1,2,9,12,10/06/2022,0,1,3,4,5,1,4,10,1,0,5,6,0,0,8,8,4,1,2,7
4202,140428,2022,Canada,Germany,0,0,13,13,07/06/2022,0,0,0,0,6,3,5,14,0,2,4,6,0,1,3,4,6,2,2,10
4203,157324,2022,Canada,USA,0,0,6,6,09/07/2022,0,0,1,1,2,1,1,4,0,6,3,9,0,0,0,0,1,2,2,5
4204,157324,2022,Japan,Canada,0,3,5,8,08/07/2022,0,0,0,0,7,3,2,12,0,5,2,7,4,2,4,10,0,0,0,0
4205,157324,2022,Canada,Brazil,0,0,0,0,07/07/2022,0,0,0,0,0,0,0,0,0,0,0,0,0,0,0,0,0,0,0,0
4206,157324,2022,Canada,Argentina,0,1,10,11,05/07/2022,0,0,0,0,3,2,1,6,0,6,5,11,0,0,0,0,1,2,0,3
4207,157324,2022,Canada,Iran,0,1,8,9,25/06/2022,0,0,1,1,3,2,5,10,0,6,2,8,0,0,0,0,1,0,0,1
4208,157324,2022,Serbia,Canada,0,0,0,0,24/06/2022,0,0,0,0,0,0,0,0,0,0,0,0,0,0,0,0,0,0,0,0
4209,157324,2022,Poland,Canada,0,2,4,6,23/06/2022,0,0,0,0,3,0,2,5,1,3,2,6,2,0,0,2,0,0,0,0
4210,157324,2022,Australia,Canada,1,2,5,8,21/06/2022,0,0,0,0,2,1,3,6,2,2,0,4,0,0,1,1,0,0,1,1
4211,157324,2022,Bulgaria,Canada,0,0,0,0,12/06/2022,0,0,0,0,0,0,0,0,0,0,0,0,0,0,0,0,0,0,0,0
4212,157324,2022,Canada,Italy,0,0,7,7,11/06/2022,0,0,0,0,2,0,1,3,5,0,1,6,0,1,1,2,1,1,0,2
4213,157324,2022,France,Canada,1,3,3,7,10/06/2022,0,0,0,0,4,1,4,9,3,4,2,9,0,0,2,2,0,0,1,1
4214,157324,2022,Canada,Germany,0,3,2,5,07/06/2022,0,0,0,0,0,1,0,1,1,2,3,6,1,0,1,2,0,0,1,1
4215,136296,2022,Canada,USA,0,0,9,9,09/07/2022,1,0,0,1,2,0,2,4,0,8,1,9,0,0,4,4,3,0,2,5
4216,136296,2022,Japan,Canada,0,0,0,0,08/07/2022,0,0,0,0,0,0,0,0,0,0,0,0,0,0,0,0,0,0,0,0
4217,136296,2022,Canada,Brazil,0,0,9,9,07/07/2022,0,0,3,3,1,2,3,6,0,5,1,6,1,0,3,4,1,1,0,2
4218,136296,2022,Canada,Argentina,0,0,2,2,05/07/2022,0,0,0,0,2,0,0,2,0,1,1,2,0,0,1,1,1,0,0,1
4219,136296,2022,Canada,Iran,0,0,0,0,25/06/2022,0,0,0,0,0,0,0,0,0,0,0,0,0,0,0,0,0,0,0,0
4220,136296,2022,Serbia,Canada,0,1,5,6,24/06/2022,0,0,0,0,2,0,1,3,2,2,6,10,0,0,2,2,0,0,0,0
4221,136296,2022,Poland,Canada,0,0,2,2,23/06/2022,0,0,0,0,2,0,2,4,0,5,0,5,1,0,1,2,0,1,0,1
4222,136296,2022,Australia,Canada,0,1,5,6,21/06/2022,0,0,0,0,4,1,0,5,0,3,0,3,0,0,0,0,0,1,0,1
4223,136296,2022,Bulgaria,Canada,0,0,15,15,12/06/2022,1,0,1,2,9,2,1,12,2,8,7,17,0,1,2,3,5,0,1,6
4224,136296,2022,Canada,Italy,0,0,1,1,11/06/2022,0,0,0,0,0,0,0,0,0,0,0,0,0,0,0,0,0,0,0,0
4225,136296,2022,France,Canada,0,1,5,6,10/06/2022,0,0,0,0,2,3,2,7,0,3,6,9,0,0,0,0,0,0,0,0
4226,136296,2022,Canada,Germany,0,0,5,5,07/06/2022,0,0,0,0,1,0,1,2,1,2,5,8,0,0,0,0,0,0,0,0
4227,157588,2022,,,-,-,-,-,-,-,-,-,-,-,-,-,-,-,-,-,-,-,-,-,-,-,-,-,-
4228,168918,2022,,,-,-,-,-,-,-,-,-,-,-,-,-,-,-,-,-,-,-,-,-,-,-,-,-,-
4229,153661,2022,Canada,Iran,0,0,0,0,25/06/2022,0,0,0,0,0,0,0,0,0,0,0,0,0,0,0,0,0,0,0,0
4230,153661,2022,Serbia,Canada,0,0,0,0,24/06/2022,0,0,0,0,0,0,0,0,0,0,0,0,0,0,0,0,0,0,0,0
4231,153661,2022,Poland,Canada,0,0,4,4,23/06/2022,0,0,0,0,0,0,0,0,0,1,0,1,0,0,0,0,0,1,0,1
4232,153661,2022,Australia,Canada,0,0,0,0,21/06/2022,0,0,0,0,0,0,0,0,0,0,0,0,0,0,0,0,0,0,0,0
4233,153661,2022,Bulgaria,Canada,0,0,0,0,12/06/2022,0,0,0,0,0,0,0,0,0,0,0,0,0,0,0,0,0,0,0,0
4234,153661,2022,Canada,Italy,0,1,3,4,11/06/2022,0,0,0,0,2,1,1,4,0,1,0,1,0,0,1,1,0,0,0,0
4235,153661,2022,France,Canada,0,1,1,2,10/06/2022,0,0,1,1,2,0,1,3,1,1,2,4,0,0,0,0,0,0,0,0
4236,153661,2022,Canada,Germany,0,0,0,0,07/06/2022,0,0,0,0,0,0,0,0,0,0,0,0,0,0,0,0,0,0,0,0
4237,183276,2022,,,-,-,-,-,-,-,-,-,-,-,-,-,-,-,-,-,-,-,-,-,-,-,-,-,-
4238,140057,2022,Canada,USA,0,0,0,0,09/07/2022,0,0,0,0,0,0,0,0,0,0,0,0,0,0,0,0,0,0,0,0
4239,140057,2022,Japan,Canada,0,0,0,0,08/07/2022,0,0,0,0,0,0,0,0,0,0,0,0,1,2,7,10,2,2,0,4
4240,140057,2022,Canada,Brazil,0,0,0,0,07/07/2022,0,0,0,0,0,0,0,0,0,0,0,0,0,0,0,0,0,0,0,0
4241,140057,2022,Canada,Argentina,0,0,0,0,05/07/2022,1,0,3,4,0,0,0,0,0,0,0,0,2,2,14,18,4,4,3,11
4242,140057,2022,Canada,Iran,0,0,0,0,25/06/2022,0,0,2,2,0,0,0,0,0,0,0,0,5,1,17,23,1,5,2,8
4243,140057,2022,Serbia,Canada,0,0,0,0,24/06/2022,1,0,3,4,0,0,0,0,0,0,0,0,7,0,13,20,3,1,0,4
4244,140057,2022,Poland,Canada,0,5,4,9,23/06/2022,0,0,1,1,9,5,9,23,0,3,1,4,1,0,11,12,0,2,0,2
4245,140057,2022,Australia,Canada,0,0,0,0,21/06/2022,2,0,0,2,0,0,0,0,0,0,0,0,2,1,4,7,5,1,0,6
4246,140057,2022,Bulgaria,Canada,0,0,0,0,12/06/2022,0,0,0,0,0,0,0,0,0,0,0,0,0,0,0,0,0,0,0,0
4247,140057,2022,Canada,Italy,0,0,0,0,11/06/2022,0,0,0,0,0,0,0,0,0,0,0,0,0,0,0,0,0,0,0,0
4248,140057,2022,France,Canada,0,2,2,4,10/06/2022,0,0,0,0,3,3,5,11,0,2,0,2,0,0,7,7,1,1,2,4
4249,140057,2022,Canada,Germany,0,0,0,0,07/06/2022,0,0,0,0,0,0,0,0,0,0,0,0,0,0,0,0,0,0,0,0
4250,168925,2022,Canada,USA,0,0,0,0,09/07/2022,0,0,5,5,0,0,0,0,0,0,0,0,7,1,12,20,5,3,0,8
4251,168925,2022,Japan,Canada,0,0,0,0,08/07/2022,0,0,2,2,0,0,0,0,0,0,0,0,1,0,3,4,3,1,1,5
4252,168925,2022,Canada,Brazil,0,0,0,0,07/07/2022,0,0,5,5,0,0,0,0,0,0,0,0,4,0,11,15,7,3,4,14
4253,168925,2022,Canada,Argentina,0,0,0,0,05/07/2022,1,0,0,1,0,0,0,0,0,0,0,0,0,0,1,1,5,3,0,8
4254,168925,2022,Canada,Iran,0,0,0,0,25/06/2022,0,0,0,0,0,0,0,0,0,0,0,0,0,0,0,0,0,0,0,0
4255,168925,2022,Serbia,Canada,0,0,0,0,24/06/2022,0,0,0,0,0,0,0,0,0,0,0,0,0,0,0,0,0,0,0,0
4256,168925,2022,Poland,Canada,0,0,0,0,23/06/2022,0,0,1,1,0,0,0,0,0,0,0,0,1,1,11,13,3,1,0,4
4257,168925,2022,Australia,Canada,0,0,0,0,21/06/2022,0,0,0,0,0,0,0,0,0,0,0,0,3,1,3,7,0,0,1,1
4258,168925,2022,Bulgaria,Canada,0,0,0,0,12/06/2022,0,1,1,2,0,0,0,0,0,0,0,0,1,2,12,15,7,2,6,15
4259,168925,2022,Canada,Italy,0,0,0,0,11/06/2022,0,0,4,4,0,0,0,0,0,0,0,0,2,0,14,16,4,2,0,6
4260,168925,2022,France,Canada,0,0,0,0,10/06/2022,0,0,0,0,0,0,0,0,0,0,0,0,0,0,0,0,0,0,0,0
4261,168925,2022,Canada,Germany,0,0,0,0,07/06/2022,0,1,3,4,0,0,0,0,0,0,0,0,3,4,17,24,5,3,1,9
4262,168914,2022,Canada,USA,1,0,5,6,09/07/2022,0,0,0,0,7,3,4,14,0,0,1,1,0,0,1,1,0,1,0,1
4263,168914,2022,Japan,Canada,5,2,6,13,08/07/2022,0,0,1,1,5,3,4,12,0,1,2,3,0,0,1,1,2,2,1,5
4264,168914,2022,Canada,Brazil,1,2,7,10,07/07/2022,0,0,2,2,12,2,3,17,0,2,1,3,1,1,3,5,2,0,2,4
4265,168914,2022,Canada,Argentina,0,0,0,0,05/07/2022,0,0,0,0,0,0,0,0,0,0,0,0,0,0,0,0,0,0,0,0
4266,168914,2022,Canada,Iran,0,2,1,3,25/06/2022,0,0,0,0,0,0,0,0,0,0,0,0,0,0,0,0,0,0,0,0
4267,168914,2022,Serbia,Canada,0,2,7,9,24/06/2022,0,0,0,0,0,0,0,0,0,0,0,0,0,0,0,0,1,0,0,1
4268,168914,2022,Poland,Canada,2,3,5,10,23/06/2022,0,0,0,0,2,1,10,13,0,1,0,1,0,0,4,4,2,1,0,3
4269,168914,2022,Australia,Canada,0,1,2,3,21/06/2022,0,0,0,0,2,2,0,4,0,1,0,1,0,0,1,1,0,0,0,0
4270,168914,2022,Bulgaria,Canada,0,2,2,4,12/06/2022,0,0,0,0,0,0,0,0,0,0,0,0,0,0,0,0,1,0,0,1
4271,168914,2022,Canada,Italy,0,0,4,4,11/06/2022,0,0,0,0,1,0,1,2,1,1,0,2,0,0,0,0,2,0,0,2
4272,168914,2022,France,Canada,0,1,0,1,10/06/2022,0,0,0,0,0,0,0,0,0,0,0,0,0,0,0,0,0,0,0,0
4273,168914,2022,Canada,Germany,0,1,2,3,07/06/2022,0,0,0,0,1,0,3,4,0,1,0,1,0,0,0,0,0,1,0,1
4274,157332,2022,Canada,USA,0,4,8,12,09/07/2022,18,0,42,60,1,0,2,3,1,2,0,3,0,0,1,1,4,2,2,8
4275,157332,2022,Japan,Canada,0,0,3,3,08/07/2022,18,0,17,35,0,0,0,0,0,2,2,4,0,0,0,0,3,3,2,8
4276,157332,2022,Canada,Brazil,0,0,0,0,07/07/2022,1,0,6,7,0,0,0,0,0,0,0,0,0,0,0,0,0,0,1,1
4277,157332,2022,Canada,Argentina,0,3,13,16,05/07/2022,32,1,64,97,1,1,0,2,0,1,5,6,0,0,0,0,5,3,0,8
4278,157332,2022,Canada,Iran,0,2,1,3,25/06/2022,6,0,26,32,0,0,0,0,0,1,0,1,0,0,0,0,1,0,1,2
4279,157332,2022,Australia,Canada,0,0,0,0,21/06/2022,7,0,7,14,0,0,0,0,0,0,0,0,0,0,0,0,0,0,0,0
4280,169578,2022,Canada,USA,0,0,0,0,09/07/2022,0,0,0,0,0,0,0,0,0,0,0,0,0,0,0,0,0,0,0,0
4281,169578,2022,Japan,Canada,1,1,9,11,08/07/2022,0,0,0,0,2,1,6,9,1,5,5,11,2,0,0,2,1,0,1,2
4282,169578,2022,Canada,Brazil,0,1,5,6,07/07/2022,0,0,0,0,7,2,3,12,0,5,4,9,0,0,0,0,1,0,1,2
4283,169578,2022,Canada,Argentina,0,0,10,10,05/07/2022,0,0,0,0,5,3,2,10,1,3,5,9,0,0,0,0,1,1,0,2
4284,169578,2022,Canada,Iran,0,0,6,6,25/06/2022,0,0,0,0,3,1,1,5,0,2,0,2,0,0,0,0,0,0,0,0
4285,169578,2022,Serbia,Canada,0,6,8,14,24/06/2022,0,0,0,0,7,2,3,12,2,7,2,11,0,0,3,3,0,1,0,1
4286,169578,2022,Poland,Canada,0,0,0,0,23/06/2022,0,0,0,0,0,0,0,0,0,0,0,0,0,0,0,0,0,0,0,0
4287,169578,2022,Australia,Canada,1,3,8,12,21/06/2022,0,0,0,0,5,2,2,9,1,4,1,6,3,1,0,4,0,1,0,1
4288,169578,2022,Bulgaria,Canada,0,3,6,9,12/06/2022,0,0,1,1,8,0,3,11,4,9,3,16,0,0,1,1,0,1,1,2
4289,169578,2022,Canada,Italy,0,1,5,6,11/06/2022,0,0,0,0,6,0,1,7,2,4,0,6,0,1,2,3,0,0,0,0
4290,169578,2022,France,Canada,0,0,0,0,10/06/2022,0,0,0,0,0,0,0,0,0,0,0,0,0,0,0,0,0,0,0,0
4291,169578,2022,Canada,Germany,0,1,5,6,07/06/2022,0,0,1,1,2,2,0,4,2,4,3,9,1,0,2,3,1,0,0,1
4292,148397,2022,,,-,-,-,-,-,-,-,-,-,-,-,-,-,-,-,-,-,-,-,-,-,-,-,-,-
4293,162251,2022,,,-,-,-,-,-,-,-,-,-,-,-,-,-,-,-,-,-,-,-,-,-,-,-,-,-
4294,168908,2022,Canada,USA,0,0,0,0,09/07/2022,0,0,0,0,0,0,0,0,0,0,0,0,0,0,0,0,0,0,0,0
4295,168908,2022,Japan,Canada,0,2,11,13,08/07/2022,0,0,2,2,9,2,5,16,1,0,1,2,0,0,8,8,1,1,1,3
4296,168908,2022,Canada,Brazil,0,2,4,6,07/07/2022,0,0,3,3,8,0,8,16,0,2,3,5,6,1,16,23,3,3,0,6
4297,168908,2022,Canada,Argentina,0,0,2,2,05/07/2022,0,0,0,0,0,0,0,0,0,0,0,0,0,0,0,0,0,0,0,0
4298,168908,2022,Canada,Iran,0,1,0,1,25/06/2022,0,0,0,0,0,0,0,0,0,0,0,0,0,0,0,0,0,0,0,0
4299,168908,2022,Serbia,Canada,0,3,2,5,24/06/2022,0,0,0,0,0,0,0,0,0,0,0,0,0,0,0,0,0,0,0,0
4300,168908,2022,Poland,Canada,0,1,3,4,23/06/2022,0,0,0,0,6,5,3,14,1,0,0,1,2,2,11,15,0,0,0,0
4301,168908,2022,Australia,Canada,0,2,2,4,21/06/2022,0,0,0,0,0,0,0,0,0,0,0,0,0,0,0,0,0,0,0,0
4302,168908,2022,Bulgaria,Canada,1,2,4,7,12/06/2022,0,0,0,0,0,0,0,0,0,0,0,0,0,0,0,0,0,0,0,0
4303,168908,2022,Canada,Italy,0,0,7,7,11/06/2022,0,0,2,2,2,1,3,6,0,2,0,2,0,0,1,1,0,1,0,1
4304,168908,2022,France,Canada,0,1,4,5,10/06/2022,0,0,1,1,1,0,2,3,0,1,0,1,2,1,6,9,0,1,0,1
4305,168908,2022,Canada,Germany,0,0,3,3,07/06/2022,0,0,0,0,0,0,0,0,0,0,0,0,0,0,0,0,1,0,0,1
4306,182679,2022,Canada,USA,1,3,4,8,09/07/2022,1,0,4,5,7,3,6,16,0,2,0,2,5,2,9,16,2,1,4,7
4307,182679,2022,Japan,Canada,0,0,0,0,08/07/2022,0,0,0,0,0,0,0,0,0,0,1,1,0,0,0,0,0,0,0,0
4308,182679,2022,Canada,Brazil,0,1,0,1,07/07/2022,1,0,1,2,0,1,2,3,0,1,3,4,0,0,1,1,0,0,0,0
4309,182679,2022,Canada,Argentina,0,0,0,0,05/07/2022,0,0,0,0,0,0,0,0,0,0,0,0,0,0,0,0,0,0,0,0
4310,182679,2022,Canada,Iran,0,2,0,2,25/06/2022,0,0,0,0,1,0,1,2,0,1,0,1,0,0,0,0,0,0,1,1
4311,182679,2022,Serbia,Canada,0,1,0,1,24/06/2022,0,0,0,0,0,0,0,0,0,0,0,0,0,0,0,0,0,0,0,0
4312,182679,2022,Poland,Canada,0,2,3,5,23/06/2022,0,0,0,0,6,1,3,10,0,0,0,0,1,1,9,11,1,0,0,1
4313,122004,2022,,,-,-,-,-,-,-,-,-,-,-,-,-,-,-,-,-,-,-,-,-,-,-,-,-,-
4314,142855,2022,,,-,-,-,-,-,-,-,-,-,-,-,-,-,-,-,-,-,-,-,-,-,-,-,-,-
4315,174158,2022,,,-,-,-,-,-,-,-,-,-,-,-,-,-,-,-,-,-,-,-,-,-,-,-,-,-
4316,174295,2022,China,Serbia,0,0,0,0,10/07/2022,0,0,0,0,0,0,0,0,0,0,0,0,8,4,23,35,2,0,1,3
4317,174295,2022,China,Bulgaria,0,0,0,0,09/07/2022,0,0,1,1,0,0,0,0,0,0,0,0,1,1,10,12,1,2,0,3
4318,174295,2022,Poland,China,0,0,0,0,07/07/2022,0,0,0,0,0,0,0,0,0,0,0,0,4,5,8,17,1,1,0,2
4319,174295,2022,Netherlands,China,0,0,0,0,06/07/2022,0,0,3,3,0,0,0,0,0,0,0,0,2,5,9,16,3,2,1,6
4320,174295,2022,Italy,China,0,0,0,0,26/06/2022,1,0,5,6,0,0,0,0,0,0,0,0,1,1,4,6,6,2,1,9
4321,174295,2022,Argentina,China,0,0,0,0,24/06/2022,0,0,7,7,0,0,0,0,0,0,0,0,7,1,23,31,13,2,2,17
4322,174295,2022,China,Germany,0,0,0,0,23/06/2022,0,0,0,0,0,0,0,0,0,0,0,0,0,0,0,0,0,0,0,0
4323,174295,2022,Brazil,China,0,0,0,0,12/06/2022,1,0,0,1,0,0,0,0,0,0,0,0,6,1,14,21,6,1,1,8
4324,174295,2022,Slovenia,China,0,0,0,0,11/06/2022,3,0,2,5,0,0,0,0,0,0,0,0,3,0,12,15,3,3,1,7
4325,174295,2022,Japan,China,0,0,0,0,09/06/2022,3,0,1,4,0,0,0,0,0,0,0,0,5,1,12,18,3,2,0,5
4326,174295,2022,China,Iran,0,0,0,0,07/06/2022,0,0,0,0,0,0,0,0,0,0,0,0,0,0,0,0,0,0,0,0
4327,153610,2022,China,Serbia,0,5,3,8,10/07/2022,0,0,0,0,11,5,5,21,0,0,0,0,1,1,18,20,1,1,2,4
4328,153610,2022,China,Bulgaria,0,1,1,2,09/07/2022,0,0,0,0,0,0,0,0,0,0,0,0,0,0,0,0,0,0,0,0
4329,153610,2022,Poland,China,1,2,3,6,07/07/2022,0,0,0,0,0,0,0,0,0,0,0,0,0,0,0,0,0,0,0,0
4330,153610,2022,Netherlands,China,0,0,2,2,06/07/2022,0,0,1,1,0,2,0,2,0,1,0,1,4,2,6,12,0,0,0,0
4331,153610,2022,Italy,China,0,0,0,0,26/06/2022,0,0,0,0,0,0,0,0,0,0,0,0,0,0,0,0,0,0,0,0
4332,153610,2022,Argentina,China,0,1,6,7,24/06/2022,0,0,0,0,0,0,1,1,0,0,0,0,0,0,0,0,0,0,0,0
4333,153610,2022,China,Germany,0,0,0,0,23/06/2022,0,0,0,0,0,0,0,0,0,0,0,0,0,0,0,0,0,0,0,0
4334,153610,2022,Brazil,China,0,0,0,0,12/06/2022,0,0,0,0,0,0,0,0,0,0,0,0,0,0,0,0,0,0,0,0
4335,153610,2022,Slovenia,China,0,0,1,1,11/06/2022,0,0,0,0,0,0,0,0,0,0,0,0,0,0,0,0,0,0,0,0
4336,153610,2022,Japan,China,0,0,1,1,09/06/2022,0,0,0,0,0,0,0,0,0,0,0,0,0,0,0,0,0,0,0,0
4337,153610,2022,China,Iran,0,0,0,0,07/06/2022,0,0,0,0,0,0,0,0,0,0,0,0,0,0,0,0,0,0,0,0
4338,152518,2022,China,Serbia,0,4,9,13,10/07/2022,0,0,0,0,8,2,5,15,0,2,0,2,1,1,20,22,4,0,2,6
4339,152518,2022,China,Bulgaria,0,2,10,12,09/07/2022,0,0,1,1,9,1,3,13,1,1,0,2,1,1,22,24,3,1,1,5
4340,152518,2022,Poland,China,0,4,5,9,07/07/2022,0,0,1,1,5,1,5,11,0,0,0,0,1,6,7,14,0,1,0,1
4341,152518,2022,Netherlands,China,0,1,5,6,06/07/2022,0,0,0,0,1,1,2,4,0,1,0,1,1,0,5,6,1,0,0,1
4342,152518,2022,Italy,China,0,1,8,9,26/06/2022,0,0,2,2,1,1,6,8,0,1,1,2,3,3,15,21,9,3,0,12
4343,152518,2022,Argentina,China,0,1,11,12,24/06/2022,0,0,1,1,9,2,6,17,0,2,0,2,5,0,5,10,7,2,0,9
4344,152518,2022,China,Germany,0,0,0,0,23/06/2022,0,0,0,0,0,0,0,0,0,0,0,0,0,0,0,0,0,0,0,0
4345,152518,2022,Brazil,China,1,2,11,14,12/06/2022,2,0,0,2,4,2,2,8,1,1,0,2,4,1,11,16,4,0,0,4
4346,152518,2022,Slovenia,China,0,2,10,12,11/06/2022,0,0,2,2,4,1,4,9,2,1,1,4,5,1,19,25,5,0,1,6
4347,152518,2022,Japan,China,0,3,11,14,09/06/2022,1,0,0,1,3,5,8,16,1,3,1,5,6,3,9,18,1,0,0,1
4348,152518,2022,China,Iran,2,1,12,15,07/06/2022,0,0,3,3,13,5,8,26,1,1,0,2,3,3,4,10,2,2,2,6
4349,142593,2022,China,Serbia,0,0,14,14,10/07/2022,14,1,63,78,0,0,0,0,0,2,0,2,0,0,0,0,0,1,2,3
4350,142593,2022,China,Bulgaria,1,0,13,14,09/07/2022,23,0,61,84,2,0,1,3,1,2,0,3,1,0,0,1,2,1,0,3
4351,142593,2022,Poland,China,1,3,3,7,07/07/2022,15,0,41,56,1,0,0,1,1,1,0,2,0,0,0,0,0,2,0,2
4352,142593,2022,Netherlands,China,0,1,8,9,06/07/2022,12,1,46,59,3,0,1,4,2,4,0,6,0,0,1,1,2,3,1,6
4353,142593,2022,Italy,China,1,1,9,11,26/06/2022,5,0,47,52,1,0,0,1,0,0,3,3,0,0,0,0,4,2,2,8
4354,142593,2022,Argentina,China,0,3,7,10,24/06/2022,12,0,59,71,0,0,0,0,2,2,0,4,0,0,1,1,2,2,2,6
4355,142593,2022,China,Germany,0,0,0,0,23/06/2022,0,0,0,0,0,0,0,0,0,0,0,0,0,0,0,0,0,0,0,0
4356,142593,2022,Brazil,China,0,1,13,14,12/06/2022,26,0,46,72,1,0,0,1,3,2,3,8,0,0,0,0,2,1,1,4
4357,142593,2022,Slovenia,China,0,3,8,11,11/06/2022,17,1,30,48,0,0,2,2,0,2,2,4,0,0,0,0,2,0,2,4
4358,142593,2022,Japan,China,0,2,7,9,09/06/2022,8,1,24,33,0,0,0,0,0,2,2,4,0,0,0,0,2,1,0,3
4359,142593,2022,China,Iran,0,2,6,8,07/06/2022,18,1,20,39,0,0,0,0,0,2,1,3,0,0,0,0,4,1,0,5
4360,168272,2022,China,Serbia,0,0,0,0,10/07/2022,0,0,0,0,0,0,0,0,0,0,0,0,0,0,0,0,1,0,0,1
4361,168272,2022,China,Bulgaria,0,0,0,0,09/07/2022,0,0,0,0,0,0,0,0,0,0,0,0,4,0,3,7,2,2,1,5
4362,168272,2022,Poland,China,0,0,0,0,07/07/2022,0,0,1,1,0,0,0,0,0,0,0,0,2,0,7,9,2,0,0,2
4363,168272,2022,Netherlands,China,0,0,0,0,06/07/2022,0,0,0,0,0,0,0,0,0,0,0,0,0,0,0,0,0,0,0,0
4364,168272,2022,Italy,China,0,0,0,0,26/06/2022,0,0,0,0,0,0,0,0,0,0,0,0,0,0,0,0,0,0,0,0
4365,168272,2022,Argentina,China,0,0,0,0,24/06/2022,0,0,0,0,0,0,0,0,0,0,0,0,0,0,0,0,0,0,0,0
4366,168272,2022,China,Germany,0,0,0,0,23/06/2022,0,0,0,0,0,0,0,0,0,0,0,0,0,0,0,0,0,0,0,0
4367,168272,2022,Brazil,China,0,0,0,0,12/06/2022,1,0,0,1,0,0,0,0,0,0,0,0,0,0,0,0,0,0,0,0
4368,168272,2022,Slovenia,China,0,0,0,0,11/06/2022,0,0,0,0,0,0,0,0,0,0,0,0,0,0,0,0,0,0,0,0
4369,168272,2022,Japan,China,0,0,0,0,09/06/2022,3,0,0,3,0,0,0,0,0,0,0,0,0,0,0,0,2,2,0,4
4370,168272,2022,China,Iran,0,0,0,0,07/06/2022,0,1,2,3,0,0,0,0,0,0,0,0,6,5,16,27,3,1,2,6
4371,181103,2022,China,Serbia,1,1,11,13,10/07/2022,0,0,0,0,5,4,2,11,5,5,1,11,0,0,0,0,0,0,0,0
4372,181103,2022,China,Bulgaria,2,3,15,20,09/07/2022,0,0,1,1,9,0,1,10,2,7,0,9,0,0,2,2,0,0,0,0
4373,181103,2022,Poland,China,0,0,0,0,07/07/2022,0,0,0,0,0,0,0,0,0,0,0,0,0,0,0,0,0,0,0,0
4374,181103,2022,Netherlands,China,0,0,0,0,06/07/2022,0,0,0,0,0,0,0,0,0,0,0,0,0,0,0,0,0,0,0,0
4375,181103,2022,Italy,China,0,1,7,8,26/06/2022,0,0,2,2,4,2,2,8,2,5,1,8,0,0,1,1,1,0,0,1
4376,181103,2022,Argentina,China,1,3,9,13,24/06/2022,0,0,3,3,4,1,3,8,1,4,4,9,0,0,0,0,0,0,0,0
4377,181103,2022,China,Germany,0,0,0,0,23/06/2022,0,0,0,0,0,0,0,0,0,0,0,0,0,0,0,0,0,0,0,0
4378,181103,2022,Brazil,China,0,2,7,9,12/06/2022,0,0,0,0,4,1,0,5,3,4,3,10,0,0,0,0,1,1,0,2
4379,181103,2022,Slovenia,China,0,3,9,12,11/06/2022,0,1,0,1,6,3,1,10,2,7,4,13,0,0,0,0,1,0,0,1
4380,181103,2022,Japan,China,0,4,9,13,09/06/2022,0,0,0,0,6,2,3,11,3,10,2,15,0,1,0,1,1,0,0,1
4381,181103,2022,China,Iran,0,4,10,14,07/06/2022,0,2,0,2,5,1,1,7,3,5,2,10,0,0,1,1,0,0,1,1
4382,158965,2022,Brazil,China,0,0,0,0,12/06/2022,0,0,0,0,0,0,0,0,0,0,0,0,0,0,0,0,0,0,0,0
4383,158965,2022,Slovenia,China,0,0,0,0,11/06/2022,0,0,0,0,0,0,0,0,0,0,0,0,0,0,0,0,0,0,0,0
4384,158965,2022,Japan,China,0,2,2,4,09/06/2022,13,0,15,28,1,0,2,3,0,0,0,0,0,0,0,0,2,0,0,2
4385,158965,2022,China,Iran,1,1,1,3,07/06/2022,3,0,4,7,0,0,0,0,0,0,0,0,0,0,0,0,0,0,0,0
4386,152526,2022,China,Serbia,0,0,0,0,10/07/2022,0,0,0,0,0,0,0,0,0,0,0,0,0,0,0,0,0,0,0,0
4387,152526,2022,China,Bulgaria,0,0,0,0,09/07/2022,0,0,0,0,0,0,0,0,0,1,0,1,0,0,0,0,0,0,0,0
4388,152526,2022,Poland,China,0,1,7,8,07/07/2022,0,0,1,1,4,0,0,4,4,1,0,5,0,0,1,1,0,0,0,0
4389,152526,2022,Netherlands,China,0,0,8,8,06/07/2022,0,0,0,0,3,0,1,4,1,4,0,5,0,0,0,0,0,1,0,1
4390,152526,2022,Italy,China,0,0,2,2,26/06/2022,0,0,0,0,0,0,0,0,0,0,1,1,0,0,0,0,1,0,0,1
4391,152526,2022,Argentina,China,0,2,8,10,24/06/2022,0,0,1,1,5,1,4,10,3,2,4,9,0,0,0,0,2,1,0,3
4392,152526,2022,China,Germany,0,0,0,0,23/06/2022,0,0,0,0,0,0,0,0,0,0,0,0,0,0,0,0,0,0,0,0
4393,152526,2022,Brazil,China,0,0,0,0,12/06/2022,0,0,0,0,0,0,0,0,0,0,0,0,0,0,0,0,0,0,0,0
4394,152526,2022,Slovenia,China,0,0,0,0,11/06/2022,0,0,0,0,0,0,0,0,0,0,0,0,0,0,0,0,0,0,0,0
4395,152526,2022,Japan,China,0,0,0,0,09/06/2022,0,0,0,0,0,0,0,0,0,0,0,0,0,0,0,0,0,0,0,0
4396,152526,2022,China,Iran,0,0,0,0,07/06/2022,0,0,0,0,0,0,0,0,0,0,0,0,0,0,0,0,0,0,0,0
4397,142581,2022,,,-,-,-,-,-,-,-,-,-,-,-,-,-,-,-,-,-,-,-,-,-,-,-,-,-
4398,152511,2022,,,-,-,-,-,-,-,-,-,-,-,-,-,-,-,-,-,-,-,-,-,-,-,-,-,-
4399,173184,2022,,,-,-,-,-,-,-,-,-,-,-,-,-,-,-,-,-,-,-,-,-,-,-,-,-,-
4400,168175,2022,China,Serbia,0,4,9,13,10/07/2022,0,0,1,1,7,0,2,9,2,1,0,3,0,0,0,0,0,1,0,1
4401,168175,2022,China,Bulgaria,3,3,12,18,09/07/2022,0,0,1,1,10,1,2,13,1,6,0,7,0,1,1,2,0,0,0,0
4402,168175,2022,Poland,China,0,1,9,10,07/07/2022,0,0,0,0,5,0,1,6,3,3,0,6,0,0,0,0,1,0,0,1
4403,168175,2022,Netherlands,China,0,1,8,9,06/07/2022,0,0,0,0,3,2,4,9,1,3,0,4,0,0,3,3,2,1,0,3
4404,168175,2022,Italy,China,2,1,8,11,26/06/2022,0,0,0,0,2,3,4,9,0,2,3,5,0,0,0,0,1,0,0,1
4405,168175,2022,China,Germany,0,0,0,0,23/06/2022,0,0,0,0,0,0,0,0,0,0,0,0,0,0,0,0,0,0,0,0
4406,168175,2022,Brazil,China,1,1,16,18,12/06/2022,0,0,0,0,3,2,2,7,1,3,1,5,0,0,0,0,0,0,1,1
4407,168175,2022,Slovenia,China,0,1,12,13,11/06/2022,0,0,0,0,6,3,3,12,4,6,1,11,0,0,0,0,1,0,0,1
4408,168175,2022,Japan,China,0,1,13,14,09/06/2022,0,0,0,0,7,1,0,8,3,5,7,15,0,0,1,1,1,0,0,1
4409,168175,2022,China,Iran,0,1,10,11,07/06/2022,0,0,3,3,2,0,3,5,1,2,3,6,0,0,1,1,2,0,0,2
4410,174297,2022,China,Serbia,0,1,3,4,10/07/2022,4,0,15,19,0,0,0,0,0,0,0,0,0,0,0,0,0,0,0,0
4411,174297,2022,China,Bulgaria,0,0,0,0,09/07/2022,0,0,0,0,0,0,0,0,0,0,0,0,0,0,0,0,0,0,0,0
4412,174297,2022,Poland,China,0,0,0,0,07/07/2022,0,0,0,0,0,0,0,0,0,0,0,0,0,0,0,0,0,0,0,0
4413,174297,2022,Netherlands,China,0,0,0,0,06/07/2022,0,0,3,3,0,0,0,0,0,0,0,0,0,0,0,0,0,0,0,0
4414,174297,2022,Italy,China,0,0,3,3,26/06/2022,4,0,12,16,0,0,0,0,1,0,0,1,0,0,0,0,1,0,0,1
4415,174297,2022,Argentina,China,0,1,1,2,24/06/2022,2,0,12,14,1,0,1,2,0,0,1,1,0,0,0,0,3,0,0,3
4416,174297,2022,China,Germany,0,0,0,0,23/06/2022,0,0,0,0,0,0,0,0,0,0,0,0,0,0,0,0,0,0,0,0
4417,174297,2022,Brazil,China,0,0,0,0,12/06/2022,0,0,0,0,0,0,0,0,0,0,0,0,0,0,0,0,0,0,0,0
4418,174297,2022,Slovenia,China,0,0,4,4,11/06/2022,17,2,16,35,0,0,0,0,0,2,3,5,0,0,0,0,3,0,0,3
4419,174297,2022,Japan,China,0,1,1,2,09/06/2022,4,0,5,9,0,0,0,0,0,0,0,0,0,0,0,0,0,0,0,0
4420,174297,2022,China,Iran,0,0,0,0,07/06/2022,0,0,0,0,0,0,0,0,0,0,0,0,0,0,0,0,0,0,0,0
4421,152513,2022,China,Serbia,0,2,2,4,10/07/2022,0,0,0,0,4,3,4,11,0,0,0,0,0,0,0,0,1,0,0,1
4422,152513,2022,China,Bulgaria,0,5,4,9,09/07/2022,0,0,0,0,14,3,2,19,1,1,0,2,0,0,0,0,2,0,0,2
4423,152513,2022,Poland,China,0,0,0,0,07/07/2022,0,0,0,0,0,0,0,0,0,0,0,0,0,0,0,0,0,0,0,0
4424,152513,2022,Netherlands,China,0,0,0,0,06/07/2022,0,0,0,0,0,0,0,0,0,0,0,0,0,0,0,0,0,0,0,0
4425,152513,2022,Italy,China,0,1,2,3,26/06/2022,0,0,1,1,2,4,4,10,0,0,0,0,0,0,0,0,0,0,1,1
4426,152513,2022,Argentina,China,0,3,8,11,24/06/2022,0,0,2,2,14,7,8,29,0,1,1,2,0,0,0,0,2,0,1,3
4427,152513,2022,China,Germany,0,0,0,0,23/06/2022,0,0,0,0,0,0,0,0,0,0,0,0,0,0,0,0,0,0,0,0
4428,162272,2022,China,Serbia,0,0,0,0,10/07/2022,0,0,0,0,0,0,0,0,0,0,0,0,0,0,0,0,0,0,0,0
4429,162272,2022,China,Bulgaria,0,0,0,0,09/07/2022,0,0,0,0,0,0,0,0,0,0,0,0,0,0,0,0,0,0,0,0
4430,162272,2022,Poland,China,0,0,0,0,07/07/2022,0,0,0,0,0,0,0,0,0,0,0,0,0,0,0,0,0,0,0,0
4431,162272,2022,Netherlands,China,0,0,4,4,06/07/2022,0,0,0,0,1,0,3,4,0,1,0,1,1,1,6,8,1,0,0,1
4432,162272,2022,Italy,China,0,0,0,0,26/06/2022,0,0,0,0,0,0,0,0,0,0,0,0,0,0,0,0,0,0,0,0
4433,162272,2022,Argentina,China,0,2,3,5,24/06/2022,0,0,1,1,0,0,1,1,0,1,0,1,1,1,3,5,0,1,0,1
4434,162272,2022,China,Germany,0,0,0,0,23/06/2022,0,0,0,0,0,0,0,0,0,0,0,0,0,0,0,0,0,0,0,0
4435,162272,2022,Brazil,China,0,0,0,0,12/06/2022,0,0,0,0,0,0,0,0,0,0,0,0,0,0,0,0,0,0,0,0
4436,162272,2022,Slovenia,China,0,0,0,0,11/06/2022,0,0,0,0,0,0,0,0,0,0,0,0,0,0,0,0,0,0,0,0
4437,162272,2022,Japan,China,0,0,0,0,09/06/2022,0,0,0,0,0,0,0,0,0,0,0,0,0,1,1,2,0,0,0,0
4438,162272,2022,China,Iran,0,0,0,0,07/06/2022,0,0,0,0,0,0,0,0,0,0,0,0,0,0,0,0,0,0,0,0
4439,182707,2022,China,Serbia,0,3,3,6,10/07/2022,0,0,1,1,5,4,5,14,0,0,1,1,0,0,0,0,0,1,1,2
4440,182707,2022,China,Bulgaria,0,1,3,4,09/07/2022,0,0,0,0,2,3,5,10,1,1,0,2,0,0,0,0,0,0,0,0
4441,182707,2022,Poland,China,0,2,7,9,07/07/2022,0,0,0,0,9,1,9,19,0,0,0,0,0,0,0,0,1,1,0,2
4442,182707,2022,Netherlands,China,0,2,5,7,06/07/2022,0,0,0,0,11,5,4,20,1,0,0,1,0,0,0,0,3,0,0,3
4443,182707,2022,Italy,China,0,0,5,5,26/06/2022,0,0,1,1,10,3,5,18,1,1,2,4,0,0,0,0,2,1,0,3
4444,182707,2022,Argentina,China,0,1,3,4,24/06/2022,0,0,0,0,4,1,4,9,0,2,0,2,0,0,0,0,0,0,0,0
4445,182707,2022,China,Germany,0,0,0,0,23/06/2022,0,0,0,0,0,0,0,0,0,0,0,0,0,0,0,0,0,0,0,0
4446,182707,2022,Brazil,China,0,3,8,11,12/06/2022,0,0,1,1,9,3,6,18,0,1,0,1,0,0,0,0,4,0,0,4
4447,182707,2022,Slovenia,China,1,2,14,17,11/06/2022,3,0,2,5,13,2,11,26,1,3,0,4,0,0,1,1,5,0,1,6
4448,182707,2022,Japan,China,0,2,10,12,09/06/2022,0,0,0,0,7,1,7,15,1,1,2,4,0,0,0,0,2,1,0,3
4449,182707,2022,China,Iran,0,3,9,12,07/06/2022,0,0,0,0,9,5,8,22,1,0,1,2,0,0,0,0,3,0,0,3
4450,189181,2022,,,-,-,-,-,-,-,-,-,-,-,-,-,-,-,-,-,-,-,-,-,-,-,-,-,-
4451,153096,2022,China,Serbia,0,0,0,0,10/07/2022,0,0,0,0,0,0,0,0,0,0,0,0,0,0,0,0,0,0,0,0
4452,153096,2022,China,Bulgaria,0,0,0,0,09/07/2022,0,0,0,0,0,0,0,0,0,0,0,0,0,0,0,0,0,0,0,0
4453,153096,2022,Poland,China,0,0,0,0,07/07/2022,0,0,0,0,0,0,0,0,0,0,0,0,0,0,0,0,0,0,0,0
4454,153096,2022,Netherlands,China,0,0,0,0,06/07/2022,0,0,0,0,0,0,0,0,0,0,0,0,0,0,0,0,0,0,0,0
4455,153096,2022,Italy,China,0,0,0,0,26/06/2022,0,0,0,0,0,0,0,0,0,0,0,0,0,0,0,0,0,0,0,0
4456,153096,2022,Argentina,China,0,0,2,2,24/06/2022,0,0,0,0,0,0,1,1,0,3,1,4,0,0,0,0,0,1,0,1
4457,153096,2022,China,Germany,0,0,0,0,23/06/2022,0,0,0,0,0,0,0,0,0,0,0,0,0,0,0,0,0,0,0,0
4458,153096,2022,Brazil,China,0,1,0,1,12/06/2022,0,0,0,0,0,0,0,0,0,0,0,0,0,0,0,0,0,0,0,0
4459,153096,2022,Slovenia,China,0,0,0,0,11/06/2022,0,0,0,0,0,0,0,0,0,0,0,0,0,0,0,0,0,0,0,0
4460,153096,2022,Japan,China,0,0,0,0,09/06/2022,0,0,0,0,0,0,0,0,0,0,0,0,0,0,0,0,0,0,0,0
4461,153096,2022,China,Iran,0,0,1,1,07/06/2022,0,0,0,0,1,0,1,2,0,1,1,2,0,0,0,0,0,0,0,0
4462,168271,2022,China,Serbia,1,1,5,7,10/07/2022,0,0,0,0,8,4,3,15,0,0,0,0,1,0,8,9,1,0,0,1
4463,168271,2022,China,Bulgaria,1,1,19,21,09/07/2022,0,0,3,3,16,6,4,26,1,5,0,6,5,0,26,31,2,1,1,4
4464,168271,2022,Poland,China,0,3,7,10,07/07/2022,0,0,0,0,10,6,3,19,0,0,0,0,5,1,18,24,1,1,1,3
4465,168271,2022,Netherlands,China,0,0,9,9,06/07/2022,0,0,1,1,11,9,8,28,1,2,0,3,6,2,12,20,3,0,0,3
4466,168271,2022,Italy,China,0,2,5,7,26/06/2022,0,0,0,0,11,3,10,24,0,6,3,9,6,3,22,31,1,1,0,2
4467,168271,2022,Argentina,China,1,1,14,16,24/06/2022,0,0,2,2,17,3,9,29,0,4,2,6,8,1,19,28,5,2,2,9
4468,168271,2022,China,Germany,0,0,0,0,23/06/2022,0,0,0,0,0,0,0,0,0,0,0,0,0,0,0,0,0,0,0,0
4469,168271,2022,Brazil,China,2,1,9,12,12/06/2022,0,0,0,0,22,5,13,40,1,7,3,11,5,2,20,27,5,0,0,5
4470,168271,2022,Slovenia,China,2,0,14,16,11/06/2022,0,0,1,1,18,7,11,36,0,6,1,7,11,1,26,38,4,4,0,8
4471,168271,2022,Japan,China,0,3,10,13,09/06/2022,0,0,0,0,13,3,10,26,2,2,1,5,7,2,20,29,5,1,2,8
4472,168271,2022,China,Iran,2,0,11,13,07/06/2022,0,0,2,2,14,3,2,19,0,1,0,1,5,6,28,39,4,2,1,7
4473,181102,2022,,,-,-,-,-,-,-,-,-,-,-,-,-,-,-,-,-,-,-,-,-,-,-,-,-,-
4474,162470,2022,,,-,-,-,-,-,-,-,-,-,-,-,-,-,-,-,-,-,-,-,-,-,-,-,-,-
4475,174159,2022,,,-,-,-,-,-,-,-,-,-,-,-,-,-,-,-,-,-,-,-,-,-,-,-,-,-
4476,152494,2022,France,USA,0,3,9,12,24/07/2022,0,0,0,0,5,1,2,8,1,2,4,7,0,0,1,1,0,0,1,1
4477,152494,2022,Italy,France,0,3,5,8,23/07/2022,0,0,0,0,5,0,0,5,3,1,2,6,1,0,0,1,1,0,0,1
4478,152494,2022,France,Japan,0,5,5,10,21/07/2022,0,0,0,0,5,0,1,6,1,3,0,4,1,0,1,2,2,0,0,2
4479,152494,2022,Australia,France,0,0,0,0,10/07/2022,0,0,0,0,0,0,0,0,0,0,0,0,0,0,0,0,0,0,0,0
4480,152494,2022,France,Argentina,0,0,0,0,09/07/2022,0,0,0,0,0,0,0,0,0,0,0,0,0,0,0,0,0,0,0,0
4481,152494,2022,France,Brazil,1,1,8,10,08/07/2022,0,0,0,0,7,0,6,13,3,4,6,13,0,0,2,2,2,0,1,3
4482,152494,2022,France,USA,2,9,6,17,07/07/2022,0,0,2,2,8,2,3,13,2,3,3,8,1,0,1,2,4,1,3,8
4483,152494,2022,Germany,France,0,0,0,0,26/06/2022,0,0,0,0,0,0,0,0,0,0,0,0,0,0,0,0,0,0,0,0
4484,152494,2022,Japan,France,1,3,7,11,25/06/2022,0,1,2,3,6,0,6,12,0,2,6,8,0,0,3,3,4,0,0,4
4485,152494,2022,France,Netherlands,1,2,4,7,23/06/2022,0,0,1,1,10,0,2,12,1,4,1,6,0,0,1,1,2,0,0,2
4486,152494,2022,France,Poland,1,3,6,10,12/06/2022,0,0,0,0,4,1,1,6,1,3,5,9,0,0,1,1,2,0,2,4
4487,152494,2022,France,Canada,0,4,3,7,10/06/2022,0,0,0,0,9,2,1,12,5,1,5,11,0,0,0,0,1,0,1,2
4488,152494,2022,Serbia,France,0,1,9,10,09/06/2022,0,0,1,1,9,1,2,12,0,9,8,17,0,0,0,0,1,2,0,3
4489,152494,2022,France,Italy,1,3,5,9,08/06/2022,0,0,0,0,7,0,6,13,3,3,7,13,0,1,2,3,1,1,0,2
4490,119792,2022,France,USA,0,0,0,0,24/07/2022,1,0,10,11,0,0,0,0,0,0,0,0,5,0,15,20,12,3,0,15
4491,119792,2022,Italy,France,0,0,0,0,23/07/2022,0,0,5,5,0,0,0,0,0,0,0,0,6,0,7,13,6,0,2,8
4492,119792,2022,France,Japan,0,0,0,0,21/07/2022,0,0,5,5,0,0,0,0,0,0,0,0,5,1,2,8,3,1,2,6
4493,119791,2022,Germany,France,3,7,12,22,26/06/2022,18,0,56,74,0,0,0,0,0,1,4,5,0,0,0,0,4,2,0,6
4494,119791,2022,Japan,France,0,0,0,0,25/06/2022,3,0,5,8,1,0,0,1,0,0,0,0,0,0,0,0,0,0,1,1
4495,119791,2022,France,Netherlands,0,0,0,0,23/06/2022,1,0,0,1,0,0,0,0,0,0,0,0,0,0,0,0,0,0,0,0
4496,119791,2022,France,Poland,0,1,1,2,12/06/2022,0,0,0,0,0,0,0,0,0,0,0,0,0,0,0,0,0,0,0,0
4497,119791,2022,France,Canada,0,2,11,13,10/06/2022,31,0,33,64,0,0,1,1,1,0,1,2,0,0,0,0,4,1,1,6
4498,119791,2022,Serbia,France,1,1,2,4,09/06/2022,0,0,0,0,0,0,0,0,0,0,0,0,0,0,0,0,0,0,0,0
4499,119791,2022,France,Italy,0,0,1,1,08/06/2022,0,0,0,0,0,0,0,0,0,0,0,0,0,0,0,0,0,1,0,1
4500,142694,2022,France,USA,0,0,16,16,24/07/2022,1,0,1,2,17,2,9,28,0,5,1,6,0,0,1,1,2,1,2,5
4501,142694,2022,Italy,France,3,4,6,13,23/07/2022,0,1,0,1,12,3,8,23,1,1,0,2,0,0,0,0,5,4,1,10
4502,142694,2022,France,Japan,0,2,9,11,21/07/2022,0,0,0,0,18,2,6,26,1,1,3,5,0,0,0,0,4,0,1,5
4503,142694,2022,Australia,France,0,0,0,0,10/07/2022,0,0,0,0,0,0,0,0,0,0,0,0,0,0,0,0,0,0,0,0
4504,142694,2022,France,Argentina,2,2,7,11,09/07/2022,0,0,2,2,8,2,10,20,1,1,3,5,0,0,0,0,1,1,1,3
4505,142694,2022,France,Brazil,3,6,4,13,08/07/2022,0,0,1,1,16,1,11,28,0,2,2,4,0,0,0,0,2,1,2,5
4506,142694,2022,France,USA,1,2,4,7,07/07/2022,0,0,0,0,4,4,2,10,0,2,1,3,0,0,0,0,0,1,0,1
4507,142694,2022,Germany,France,0,0,0,0,26/06/2022,0,0,0,0,0,0,0,0,0,0,0,0,0,0,0,0,0,0,0,0
4508,142694,2022,Japan,France,1,2,9,12,25/06/2022,0,0,2,2,10,1,14,25,3,1,1,5,0,0,0,0,6,2,0,8
4509,142694,2022,France,Netherlands,0,1,1,2,23/06/2022,0,0,0,0,0,0,0,0,0,0,0,0,0,0,0,0,0,0,0,0
4510,142694,2022,France,Poland,0,2,10,12,12/06/2022,0,0,3,3,16,5,16,37,2,2,1,5,0,0,0,0,1,3,0,4
4511,142694,2022,France,Canada,1,3,13,17,10/06/2022,0,0,0,0,7,2,12,21,0,2,0,2,0,0,0,0,2,0,6,8
4512,142694,2022,Serbia,France,0,0,0,0,09/06/2022,0,0,0,0,0,0,0,0,0,0,0,0,0,0,0,0,0,0,0,0
4513,142694,2022,France,Italy,0,0,12,12,08/06/2022,0,1,0,1,7,4,10,21,2,1,6,9,0,0,0,0,2,1,2,5
4514,142691,2022,Australia,France,0,0,0,0,10/07/2022,0,0,0,0,0,0,0,0,0,0,0,0,0,0,0,0,0,0,0,0
4515,142691,2022,France,Argentina,0,0,0,0,09/07/2022,0,0,0,0,0,0,0,0,0,0,0,0,8,0,21,29,6,7,3,16
4516,142691,2022,France,Brazil,0,0,0,0,08/07/2022,0,0,0,0,0,0,0,0,0,0,0,0,0,0,0,0,0,0,0,0
4517,142691,2022,France,USA,0,0,0,0,07/07/2022,0,0,0,0,0,0,0,0,0,0,0,0,0,0,0,0,0,0,1,1
4518,142691,2022,Germany,France,0,0,0,0,26/06/2022,0,0,2,2,0,0,0,0,0,0,0,0,2,1,13,16,4,1,0,5
4519,142691,2022,Japan,France,0,0,0,0,25/06/2022,0,0,0,0,0,0,0,0,0,0,0,0,0,0,0,0,0,0,0,0
4520,142691,2022,France,Netherlands,0,0,0,0,23/06/2022,0,0,0,0,0,0,0,0,0,0,0,0,0,0,0,0,0,0,0,0
4521,142691,2022,France,Poland,0,0,0,0,12/06/2022,0,0,0,0,0,0,0,0,0,0,0,0,0,0,0,0,0,0,0,0
4522,142691,2022,France,Canada,0,0,0,0,10/06/2022,0,0,5,5,0,0,0,0,0,0,0,0,2,0,9,11,8,4,1,13
4523,142691,2022,Serbia,France,0,0,0,0,09/06/2022,0,0,0,0,0,0,0,0,0,0,0,0,0,0,0,0,0,0,0,0
4524,142691,2022,France,Italy,0,0,0,0,08/06/2022,0,0,0,0,0,0,0,0,0,0,0,0,0,0,0,0,0,0,0,0
4525,119804,2022,France,USA,0,0,0,0,24/07/2022,1,1,7,9,0,0,0,0,0,0,0,0,0,0,0,0,0,0,0,0
4526,119804,2022,Italy,France,0,0,0,0,23/07/2022,0,0,0,0,0,0,0,0,0,0,0,0,0,0,0,0,0,0,0,0
4527,119804,2022,France,Japan,0,0,0,0,21/07/2022,0,0,0,0,0,0,0,0,0,0,0,0,0,0,0,0,0,0,0,0
4528,119804,2022,Australia,France,0,0,0,0,10/07/2022,0,0,0,0,0,0,0,0,0,0,0,0,0,0,0,0,0,0,0,0
4529,119804,2022,France,Argentina,0,1,6,7,09/07/2022,14,0,58,72,0,0,0,0,0,2,4,6,0,0,0,0,4,3,2,9
4530,119804,2022,France,Brazil,0,0,0,0,08/07/2022,0,0,0,0,0,0,0,0,0,0,0,0,0,0,0,0,0,0,0,0
4531,119804,2022,France,USA,0,0,9,9,07/07/2022,23,0,53,76,0,0,1,1,0,0,3,3,0,0,0,0,4,2,5,11
4532,119804,2022,Germany,France,0,0,0,0,26/06/2022,0,0,0,0,0,0,0,0,0,0,0,0,0,0,0,0,0,0,0,0
4533,119804,2022,Japan,France,0,0,7,7,25/06/2022,16,0,43,59,0,0,0,0,0,1,0,1,0,0,0,0,5,1,1,7
4534,119804,2022,France,Netherlands,0,1,13,14,23/06/2022,14,0,38,52,0,0,0,0,1,2,5,8,0,0,0,0,3,1,0,4
4535,124518,2022,France,Poland,0,0,0,0,12/06/2022,0,0,0,0,0,0,0,0,0,0,0,0,0,0,0,0,0,0,0,0
4536,124518,2022,France,Canada,0,0,0,0,10/06/2022,0,0,0,0,0,0,0,0,0,0,0,0,0,0,0,0,0,0,0,0
4537,124518,2022,Serbia,France,0,0,0,0,09/06/2022,0,0,0,0,0,0,0,0,0,0,0,0,0,0,0,0,0,0,0,0
4538,124518,2022,France,Italy,0,2,1,3,08/06/2022,0,0,0,0,2,2,3,7,0,2,0,2,0,0,4,4,2,2,0,4
4539,119800,2022,France,USA,0,6,12,18,24/07/2022,0,0,5,5,21,5,13,39,1,2,0,3,10,1,20,31,5,1,1,7
4540,119800,2022,Italy,France,4,4,5,13,23/07/2022,0,0,3,3,10,2,5,17,0,4,2,6,9,1,10,20,7,2,0,9
4541,119800,2022,France,Japan,0,0,0,0,21/07/2022,0,0,0,0,0,0,0,0,0,0,0,0,0,0,0,0,0,0,0,0
4542,119800,2022,Australia,France,0,2,7,9,10/07/2022,0,1,1,2,4,0,1,5,0,1,0,1,3,0,9,12,4,0,0,4
4543,119800,2022,France,Argentina,0,2,4,6,09/07/2022,0,0,1,1,0,0,0,0,0,0,0,0,0,0,0,0,3,0,0,3
4544,119800,2022,France,Brazil,2,5,4,11,08/07/2022,0,0,4,4,12,0,8,20,0,3,1,4,5,0,12,17,3,0,1,4
4545,119800,2022,France,USA,1,4,15,20,07/07/2022,0,1,17,18,16,3,9,28,2,1,0,3,3,2,16,21,11,4,2,17
4546,119800,2022,Germany,France,0,4,11,15,26/06/2022,1,0,2,3,16,4,7,27,2,1,0,3,4,0,4,8,9,1,2,12
4547,119800,2022,Japan,France,0,0,0,0,25/06/2022,0,0,0,0,0,0,0,0,0,0,0,0,0,0,0,0,0,0,0,0
4548,119800,2022,France,Netherlands,1,1,9,11,23/06/2022,0,0,4,4,7,1,5,13,0,1,1,2,5,0,4,9,4,0,0,4
4549,119800,2022,France,Poland,0,4,9,13,12/06/2022,0,1,4,5,8,6,8,22,0,6,1,7,4,0,10,14,7,0,3,10
4550,119800,2022,France,Canada,2,1,1,4,10/06/2022,0,0,0,0,0,0,1,1,0,0,0,0,0,0,0,0,1,0,0,1
4551,119800,2022,Serbia,France,3,6,8,17,09/06/2022,1,0,7,8,11,4,13,28,2,6,1,9,9,0,14,23,5,3,1,9
4552,119800,2022,France,Italy,1,2,15,18,08/06/2022,0,0,7,7,11,3,4,18,1,3,0,4,6,0,10,16,5,2,4,11
4553,136851,2022,France,USA,3,2,16,21,24/07/2022,14,0,64,78,2,0,0,2,0,5,3,8,0,0,0,0,5,2,0,7
4554,136851,2022,Italy,France,2,1,9,12,23/07/2022,15,0,46,61,1,0,0,1,0,1,2,3,0,0,0,0,5,3,0,8
4555,136851,2022,France,Japan,2,4,6,12,21/07/2022,18,1,37,56,2,0,1,3,0,0,2,2,0,0,0,0,6,3,0,9
4556,136851,2022,Australia,France,0,3,8,11,10/07/2022,18,0,42,60,2,0,3,5,3,1,3,7,0,0,0,0,0,3,2,5
4557,136851,2022,France,Argentina,0,1,1,2,09/07/2022,5,0,12,17,0,0,1,1,1,0,0,1,0,0,0,0,1,1,0,2
4558,136851,2022,France,Brazil,1,3,7,11,08/07/2022,24,1,50,75,1,1,0,2,1,1,2,4,0,0,1,1,1,1,2,4
4559,136851,2022,France,USA,0,0,0,0,07/07/2022,4,0,17,21,0,0,1,1,0,0,1,1,0,0,0,0,0,1,0,1
4560,136851,2022,France,Poland,6,3,9,18,12/06/2022,42,2,43,87,3,0,1,4,2,1,5,8,0,0,1,1,7,2,3,12
4561,136851,2022,France,Canada,0,0,0,0,10/06/2022,0,0,0,0,0,0,0,0,0,0,0,0,0,0,0,0,0,0,0,0
4562,136851,2022,Serbia,France,1,4,12,17,09/06/2022,53,0,38,91,3,0,1,4,2,1,5,8,0,0,0,0,2,1,2,5
4563,136851,2022,France,Italy,0,3,12,15,08/06/2022,48,0,25,73,3,0,2,5,0,2,1,3,0,0,0,0,4,2,3,9
4564,142710,2022,France,USA,0,0,0,0,24/07/2022,0,0,0,0,0,1,1,2,0,0,0,0,0,0,0,0,0,0,0,0
4565,142710,2022,Italy,France,0,0,0,0,23/07/2022,0,0,0,0,0,0,0,0,0,0,0,0,0,0,0,0,0,0,0,0
4566,142710,2022,France,Japan,0,0,0,0,21/07/2022,0,0,0,0,0,0,0,0,0,0,0,0,0,0,0,0,0,0,0,0
4567,142710,2022,Australia,France,2,3,13,18,10/07/2022,0,0,0,0,16,3,6,25,1,0,0,1,0,0,0,0,4,2,0,6
4568,142710,2022,France,Argentina,0,3,5,8,09/07/2022,0,0,2,2,13,1,7,21,0,4,1,5,0,0,0,0,5,2,2,9
4569,142710,2022,France,Brazil,0,0,0,0,08/07/2022,0,0,0,0,0,0,0,0,0,0,0,0,0,0,0,0,0,0,0,0
4570,142710,2022,France,USA,1,6,7,14,07/07/2022,0,0,1,1,13,6,12,31,0,0,5,5,0,0,1,1,7,1,4,12
4571,142710,2022,Germany,France,1,7,5,13,26/06/2022,0,0,0,0,14,6,7,27,1,5,1,7,0,0,0,0,6,2,1,9
4572,142710,2022,Japan,France,0,1,4,5,25/06/2022,0,0,1,1,3,0,3,6,0,1,0,1,0,0,0,0,3,0,0,3
4573,142710,2022,France,Netherlands,0,3,11,14,23/06/2022,0,0,0,0,11,1,5,17,4,2,4,10,0,0,0,0,3,1,0,4
4574,142710,2022,France,Poland,0,0,0,0,12/06/2022,0,0,0,0,0,0,0,0,0,0,0,0,0,0,0,0,0,0,0,0
4575,142710,2022,France,Canada,0,0,0,0,10/06/2022,0,0,0,0,0,0,0,0,0,0,0,0,0,0,0,0,0,0,0,0
4576,142710,2022,Serbia,France,2,2,14,18,09/06/2022,0,0,1,1,19,4,22,45,3,3,2,8,0,0,0,0,6,5,0,11
4577,142710,2022,France,Italy,0,0,0,0,08/06/2022,0,0,0,0,0,0,0,0,0,0,0,0,0,0,0,0,0,0,0,0
4578,164029,2022,,,-,-,-,-,-,-,-,-,-,-,-,-,-,-,-,-,-,-,-,-,-,-,-,-,-
4579,125073,2022,France,USA,1,3,5,9,24/07/2022,0,0,0,0,4,2,6,12,3,5,1,9,0,0,0,0,2,0,0,2
4580,125073,2022,Italy,France,0,1,6,7,23/07/2022,0,0,0,0,5,0,3,8,0,3,2,5,0,0,0,0,2,1,0,3
4581,125073,2022,France,Japan,0,3,10,13,21/07/2022,0,0,0,0,3,0,2,5,3,4,3,10,0,0,0,0,1,0,0,1
4582,125073,2022,Australia,France,0,4,7,11,10/07/2022,0,0,0,0,6,1,5,12,1,5,2,8,0,0,1,1,1,0,1,2
4583,125073,2022,France,Argentina,0,0,0,0,09/07/2022,0,0,0,0,0,0,0,0,0,0,0,0,0,0,0,0,0,0,0,0
4584,125073,2022,France,Brazil,2,1,8,11,08/07/2022,0,0,1,1,4,1,1,6,1,2,2,5,0,0,1,1,4,0,2,6
4585,125073,2022,France,USA,0,2,3,5,07/07/2022,0,0,1,1,4,1,7,12,1,0,4,5,0,0,0,0,0,1,1,2
4586,125073,2022,Germany,France,0,0,0,0,26/06/2022,0,0,0,0,0,0,0,0,0,0,0,0,0,0,0,0,0,0,0,0
4587,125073,2022,Japan,France,0,2,5,7,25/06/2022,0,0,1,1,4,0,2,6,3,5,6,14,0,0,0,0,2,0,0,2
4588,125073,2022,France,Netherlands,0,2,7,9,23/06/2022,0,0,0,0,4,0,1,5,6,4,1,11,0,0,0,0,1,1,1,3
4589,136855,2022,France,USA,0,0,0,0,24/07/2022,0,0,0,0,0,0,0,0,0,0,0,0,0,0,0,0,0,0,0,0
4590,136855,2022,Italy,France,0,0,0,0,23/07/2022,0,0,0,0,0,0,0,0,0,0,0,0,0,0,0,0,0,0,0,0
4591,136855,2022,France,Japan,0,0,0,0,21/07/2022,0,0,0,0,0,0,0,0,0,0,0,0,0,0,0,0,0,0,0,0
4592,136855,2022,Australia,France,0,0,0,0,10/07/2022,0,0,0,0,0,0,0,0,0,0,0,0,0,0,0,0,0,0,0,0
4593,136855,2022,France,Argentina,0,2,8,10,09/07/2022,0,0,2,2,3,1,4,8,0,5,7,12,0,0,0,0,3,0,0,3
4594,136855,2022,France,Brazil,0,0,0,0,08/07/2022,0,0,0,0,0,0,0,0,0,0,0,0,0,0,0,0,0,0,0,0
4595,136855,2022,France,USA,0,0,0,0,07/07/2022,0,0,0,0,0,0,0,0,0,0,0,0,0,0,0,0,0,0,0,0
4596,136855,2022,Germany,France,0,1,10,11,26/06/2022,0,0,1,1,1,2,2,5,3,2,3,8,0,1,1,2,5,0,0,5
4597,136855,2022,Japan,France,0,0,0,0,25/06/2022,0,0,0,0,0,0,0,0,1,0,1,2,0,0,0,0,0,0,0,0
4598,136855,2022,France,Netherlands,0,0,0,0,23/06/2022,0,0,0,0,0,0,0,0,0,0,0,0,0,0,0,0,0,0,0,0
4599,136855,2022,France,Poland,0,0,1,1,12/06/2022,0,0,0,0,1,0,0,1,0,1,0,1,0,0,0,0,0,0,0,0
4600,136855,2022,France,Canada,0,0,7,7,10/06/2022,0,0,1,1,5,0,5,10,0,4,8,12,0,0,0,0,2,1,0,3
4601,136855,2022,Serbia,France,0,0,0,0,09/06/2022,0,0,0,0,0,0,0,0,0,0,0,0,0,0,0,0,0,0,0,0
4602,136855,2022,France,Italy,0,0,0,0,08/06/2022,0,0,0,0,0,0,0,0,0,0,0,0,0,0,0,0,0,0,0,0
4603,142677,2022,,,-,-,-,-,-,-,-,-,-,-,-,-,-,-,-,-,-,-,-,-,-,-,-,-,-
4604,132948,2022,France,USA,0,3,13,16,24/07/2022,0,0,3,3,10,2,5,17,1,6,0,7,11,0,18,29,5,3,1,9
4605,132948,2022,Italy,France,2,3,12,17,23/07/2022,0,0,1,1,13,0,4,17,0,4,1,5,8,1,7,16,3,2,0,5
4606,132948,2022,France,Japan,0,2,8,10,21/07/2022,0,0,1,1,6,1,7,14,1,1,2,4,13,0,8,21,3,1,0,4
4607,132948,2022,Australia,France,3,5,7,15,10/07/2022,0,0,2,2,7,1,3,11,2,0,3,5,5,2,13,20,4,1,1,6
4608,132948,2022,France,Argentina,0,1,15,16,09/07/2022,0,0,8,8,10,1,9,20,0,1,4,5,5,1,12,18,4,2,3,9
4609,132948,2022,France,Brazil,0,0,1,1,08/07/2022,0,0,0,0,0,0,0,0,0,0,0,0,0,0,0,0,0,0,0,0
4610,132948,2022,France,USA,2,1,12,15,07/07/2022,0,0,7,7,8,5,15,28,0,0,5,5,5,3,20,28,4,4,1,9
4611,132948,2022,Germany,France,0,0,0,0,26/06/2022,0,0,0,0,0,0,0,0,0,0,0,0,0,0,0,0,0,0,0,0
4612,132948,2022,Japan,France,1,0,10,11,25/06/2022,0,1,5,6,9,2,9,20,0,2,1,3,7,1,9,17,4,2,0,6
4613,132948,2022,France,Netherlands,2,3,11,16,23/06/2022,0,0,1,1,9,0,5,14,0,0,3,3,1,0,6,7,4,1,0,5
4614,120735,2022,France,USA,0,0,0,0,24/07/2022,0,0,0,0,0,0,0,0,0,0,0,0,0,0,0,0,0,0,0,0
4615,120735,2022,Italy,France,0,0,0,0,23/07/2022,0,0,0,0,0,0,0,0,0,0,0,0,0,0,0,0,0,0,0,0
4616,120735,2022,France,Japan,1,3,13,17,21/07/2022,0,0,3,3,7,2,3,12,2,2,1,5,6,3,7,16,4,2,0,6
4617,120735,2022,Australia,France,0,0,0,0,10/07/2022,0,0,0,0,0,0,0,0,0,0,0,0,0,0,0,0,0,0,0,0
4618,120735,2022,France,Argentina,0,4,8,12,09/07/2022,0,0,2,2,7,3,12,22,1,5,7,13,5,4,16,25,12,5,1,18
4619,120735,2022,France,Brazil,2,4,8,14,08/07/2022,0,0,3,3,9,3,5,17,1,3,2,6,4,4,17,25,4,1,1,6
4620,120735,2022,France,USA,0,0,1,1,07/07/2022,0,0,0,0,0,1,2,3,0,0,0,0,1,0,2,3,1,0,1,2
4621,120735,2022,Germany,France,1,5,8,14,26/06/2022,0,1,4,5,11,3,5,19,1,5,0,6,7,2,22,31,5,1,0,6
4622,120735,2022,Japan,France,1,4,14,19,25/06/2022,0,0,5,5,6,3,9,18,1,4,2,7,7,0,12,19,4,0,3,7
4623,120735,2022,France,Netherlands,0,0,1,1,23/06/2022,0,0,0,0,0,0,0,0,0,0,0,0,0,0,0,0,0,0,0,0
4624,120735,2022,France,Poland,0,4,10,14,12/06/2022,0,0,5,5,10,3,7,20,0,3,5,8,9,5,24,38,4,7,2,13
4625,120735,2022,France,Canada,1,1,6,8,10/06/2022,0,0,2,2,9,3,4,16,2,1,3,6,6,2,14,22,6,3,1,10
4626,120735,2022,Serbia,France,2,2,11,15,09/06/2022,2,0,3,5,8,1,6,15,0,5,2,7,8,3,24,35,3,2,2,7
4627,120735,2022,France,Italy,0,2,3,5,08/06/2022,0,0,1,1,2,5,5,12,0,0,1,1,6,1,9,16,4,0,0,4
4628,152506,2022,France,USA,0,0,0,0,24/07/2022,0,0,0,0,0,0,0,0,0,0,0,0,0,0,0,0,0,0,0,0
4629,152506,2022,Italy,France,0,0,0,0,23/07/2022,0,0,0,0,0,0,0,0,0,0,0,0,0,0,0,0,0,0,0,0
4630,152506,2022,France,Japan,0,0,0,0,21/07/2022,0,0,0,0,0,0,0,0,0,0,0,0,0,0,0,0,0,0,0,0
4631,152506,2022,Australia,France,0,0,0,0,10/07/2022,0,0,0,0,0,0,0,0,0,0,0,0,1,0,5,6,10,0,0,10
4632,152506,2022,France,Argentina,0,0,0,0,09/07/2022,0,0,0,0,0,0,0,0,0,0,0,0,0,0,0,0,0,0,0,0
4633,152506,2022,France,Brazil,0,0,0,0,08/07/2022,0,0,2,2,0,0,0,0,0,0,0,0,3,1,10,14,11,0,2,13
4634,152506,2022,France,USA,0,0,0,0,07/07/2022,0,0,6,6,0,0,0,0,0,0,0,0,13,1,13,27,14,3,4,21
4635,152506,2022,Germany,France,0,0,0,0,26/06/2022,0,0,0,0,0,0,0,0,0,0,0,0,0,0,0,0,0,0,0,0
4636,152506,2022,Japan,France,0,0,0,0,25/06/2022,0,0,1,1,0,0,0,0,0,0,0,0,6,0,3,9,11,3,2,16
4637,152506,2022,France,Netherlands,0,0,0,0,23/06/2022,0,0,0,0,0,0,0,0,0,0,0,0,7,5,11,23,6,1,0,7
4638,152506,2022,France,Poland,0,0,0,0,12/06/2022,0,0,2,2,0,0,0,0,0,0,0,0,5,2,16,23,9,5,1,15
4639,152506,2022,France,Canada,0,0,0,0,10/06/2022,0,0,0,0,0,0,0,0,0,0,0,0,0,0,0,0,0,0,0,0
4640,152506,2022,Serbia,France,0,0,0,0,09/06/2022,1,0,0,1,0,0,0,0,0,0,0,0,6,0,12,18,16,4,3,23
4641,152506,2022,France,Italy,0,0,0,0,08/06/2022,0,0,0,0,0,0,0,0,0,0,0,0,2,0,8,10,13,1,4,18
4642,163309,2022,,,-,-,-,-,-,-,-,-,-,-,-,-,-,-,-,-,-,-,-,-,-,-,-,-,-
4643,152531,2022,France,USA,0,0,0,0,24/07/2022,0,0,0,0,0,0,0,0,0,0,0,0,0,0,0,0,0,0,0,0
4644,152531,2022,Italy,France,0,0,0,0,23/07/2022,0,0,0,0,0,0,0,0,0,0,0,0,0,0,0,0,0,0,0,0
4645,152531,2022,France,Japan,0,0,0,0,21/07/2022,0,0,0,0,0,0,0,0,0,0,0,0,0,0,0,0,0,0,0,0
4646,152531,2022,Australia,France,0,2,1,3,10/07/2022,0,0,1,1,5,1,2,8,0,2,0,2,1,0,3,4,1,0,0,1
4647,152531,2022,France,Argentina,0,0,0,0,09/07/2022,0,0,0,0,0,0,0,0,0,0,0,0,0,0,0,0,0,0,0,0
4648,152531,2022,France,Brazil,0,0,0,0,08/07/2022,0,0,0,0,0,0,0,0,0,0,0,0,0,0,0,0,0,0,0,0
4649,152531,2022,France,USA,0,0,0,0,07/07/2022,0,0,0,0,0,0,0,0,0,0,0,0,0,0,0,0,0,0,0,0
4650,152531,2022,Germany,France,0,0,0,0,26/06/2022,0,0,0,0,0,0,0,0,0,0,0,0,0,0,0,0,0,0,0,0
4651,152531,2022,Japan,France,0,0,0,0,25/06/2022,0,0,0,0,0,0,0,0,0,0,0,0,0,0,0,0,0,0,0,0
4652,152531,2022,France,Netherlands,0,0,0,0,23/06/2022,0,0,0,0,0,0,0,0,0,0,0,0,0,0,0,0,0,0,0,0
4653,152531,2022,France,Poland,0,1,1,2,12/06/2022,0,0,1,1,4,0,1,5,0,0,0,0,0,0,3,3,1,0,0,1
4654,152531,2022,France,Canada,2,5,7,14,10/06/2022,0,1,0,1,6,3,9,18,0,0,0,0,2,3,10,15,1,0,1,2
4655,152531,2022,Serbia,France,0,0,0,0,09/06/2022,0,0,0,0,0,0,0,0,0,0,0,0,0,0,0,0,0,0,0,0
4656,152531,2022,France,Italy,0,0,0,0,08/06/2022,0,0,0,0,0,0,0,0,0,0,0,0,0,0,0,0,0,0,0,0
4657,142659,2022,,,-,-,-,-,-,-,-,-,-,-,-,-,-,-,-,-,-,-,-,-,-,-,-,-,-
4658,181197,2022,France,Poland,0,0,0,0,12/06/2022,0,0,0,0,0,0,0,0,0,0,0,0,0,0,0,0,0,0,0,0
4659,181197,2022,France,Canada,0,0,0,0,10/06/2022,0,0,0,0,0,0,0,0,0,0,0,0,0,0,0,0,0,0,0,0
4660,181197,2022,Serbia,France,0,0,0,0,09/06/2022,0,0,0,0,0,0,0,0,0,0,0,0,0,0,0,0,0,0,0,0
4661,181197,2022,France,Italy,0,0,0,0,08/06/2022,0,0,0,0,0,0,0,0,0,0,0,0,0,0,0,0,0,0,0,0
4662,136856,2022,France,USA,2,3,3,8,24/07/2022,0,0,0,0,0,0,0,0,0,0,0,0,0,0,0,0,2,0,0,2
4663,136856,2022,Italy,France,0,0,3,3,23/07/2022,0,0,0,0,0,0,0,0,0,0,0,0,0,0,0,0,0,0,0,0
4664,136856,2022,France,Japan,0,1,0,1,21/07/2022,0,0,0,0,0,0,0,0,0,0,0,0,0,0,0,0,0,0,0,0
4665,136856,2022,Australia,France,1,3,6,10,10/07/2022,0,0,1,1,3,0,1,4,1,1,3,5,0,0,0,0,1,1,0,2
4666,136856,2022,France,Argentina,1,6,11,18,09/07/2022,0,0,2,2,6,1,2,9,1,3,6,10,0,0,0,0,2,0,1,3
4667,136856,2022,France,Brazil,0,1,1,2,08/07/2022,0,0,0,0,0,0,0,0,0,0,0,0,0,0,0,0,0,0,0,0
4668,136856,2022,France,USA,0,2,4,6,07/07/2022,0,0,0,0,0,0,0,0,0,0,0,0,0,0,0,0,1,0,0,1
4669,136856,2022,Germany,France,3,5,10,18,26/06/2022,0,0,1,1,6,0,3,9,3,1,5,9,0,0,0,0,2,0,0,2
4670,136856,2022,Japan,France,1,2,1,4,25/06/2022,0,0,0,0,0,0,0,0,0,0,0,0,0,0,0,0,0,0,0,0
4671,136856,2022,France,Netherlands,0,0,0,0,23/06/2022,0,0,0,0,0,0,0,0,0,0,0,0,0,0,0,0,0,0,0,0
4672,136856,2022,France,Poland,2,3,14,19,12/06/2022,0,0,0,0,4,1,3,8,1,3,4,8,0,0,1,1,0,1,1,2
4673,136856,2022,France,Canada,0,0,3,3,10/06/2022,0,0,0,0,0,0,0,0,0,0,0,0,0,0,0,0,0,1,0,1
4674,136856,2022,Serbia,France,1,3,10,14,09/06/2022,0,1,0,1,1,2,3,6,3,6,10,19,0,0,1,1,3,0,3,6
4675,136856,2022,France,Italy,2,2,7,11,08/06/2022,0,0,1,1,5,0,4,9,0,4,7,11,0,0,0,0,3,0,2,5
4676,164022,2022,,,-,-,-,-,-,-,-,-,-,-,-,-,-,-,-,-,-,-,-,-,-,-,-,-,-
4677,183115,2022,,,-,-,-,-,-,-,-,-,-,-,-,-,-,-,-,-,-,-,-,-,-,-,-,-,-
4678,164020,2022,,,-,-,-,-,-,-,-,-,-,-,-,-,-,-,-,-,-,-,-,-,-,-,-,-,-
4679,119779,2022,Germany,Japan,0,5,8,13,09/07/2022,0,0,5,5,9,4,11,24,1,1,2,4,7,1,11,19,1,1,3,5
4680,119779,2022,Germany,Australia,0,1,14,15,07/07/2022,0,0,0,0,13,6,6,25,0,1,2,3,0,0,1,1,4,0,2,6
4681,119779,2022,Brazil,Germany,1,2,9,12,06/07/2022,0,0,3,3,10,3,12,25,1,3,0,4,6,1,24,31,2,4,1,7
4682,119779,2022,USA,Germany,0,3,7,10,05/07/2022,0,0,3,3,7,3,14,24,2,2,2,6,7,5,11,23,3,0,0,3
4683,119779,2022,Germany,France,0,4,5,9,26/06/2022,0,0,1,1,5,3,10,18,1,1,2,4,1,2,14,17,2,0,0,2
4684,119779,2022,Germany,Netherlands,0,5,9,14,24/06/2022,1,0,3,4,8,5,18,31,1,3,3,7,3,1,13,17,9,3,1,13
4685,119779,2022,China,Germany,0,0,0,0,23/06/2022,0,0,0,0,0,0,0,0,0,0,0,0,0,0,0,0,0,0,0,0
4686,119779,2022,Germany,Italy,0,4,2,6,22/06/2022,0,0,2,2,4,1,2,7,0,0,1,1,1,3,10,14,0,0,1,1
4687,119779,2022,Germany,Serbia,1,5,8,14,11/06/2022,0,0,7,7,13,1,11,25,4,1,1,6,2,4,18,24,6,3,2,11
4688,119779,2022,Bulgaria,Germany,2,3,17,22,10/06/2022,0,0,7,7,17,4,7,28,3,1,2,6,9,0,23,32,2,1,2,5
4689,119779,2022,Germany,Argentina,1,1,6,8,09/06/2022,0,0,2,2,7,4,9,20,1,1,2,4,1,2,19,22,1,3,0,4
4690,119779,2022,Canada,Germany,3,0,11,14,07/06/2022,0,0,2,2,14,1,11,26,1,4,1,6,2,3,14,19,6,1,1,8
4691,152469,2022,Germany,France,2,3,13,18,26/06/2022,15,1,44,60,1,0,0,1,1,4,0,5,0,0,1,1,8,0,1,9
4692,152469,2022,Germany,Netherlands,0,1,3,4,24/06/2022,2,0,9,11,0,0,0,0,0,0,0,0,0,0,0,0,0,0,0,0
4693,152469,2022,China,Germany,0,0,0,0,23/06/2022,0,0,0,0,0,0,0,0,0,0,0,0,0,0,0,0,0,0,0,0
4694,152469,2022,Germany,Italy,0,2,3,5,22/06/2022,6,0,13,19,0,1,0,1,0,0,0,0,0,0,0,0,1,1,1,3
4695,152469,2022,Germany,Serbia,1,0,11,12,11/06/2022,7,0,21,28,0,0,0,0,2,2,0,4,0,1,0,1,2,0,2,4
4696,152469,2022,Bulgaria,Germany,0,0,0,0,10/06/2022,1,0,0,1,0,0,0,0,0,1,0,1,0,0,0,0,0,0,0,0
4697,152469,2022,Germany,Argentina,0,1,3,4,09/06/2022,3,0,19,22,0,0,0,0,0,0,1,1,0,0,0,0,2,0,0,2
4698,152469,2022,Canada,Germany,0,1,1,2,07/06/2022,0,0,0,0,0,0,0,0,0,0,0,0,0,0,0,0,0,0,0,0
4699,136441,2022,,,-,-,-,-,-,-,-,-,-,-,-,-,-,-,-,-,-,-,-,-,-,-,-,-,-
4700,182291,2022,Germany,Japan,0,0,0,0,09/07/2022,0,0,2,2,0,0,0,0,0,0,0,0,0,0,0,0,4,2,0,6
4701,182291,2022,Germany,Australia,0,0,0,0,07/07/2022,0,0,0,0,0,0,0,0,0,0,0,0,0,0,0,0,0,0,0,0
4702,182291,2022,Brazil,Germany,0,0,0,0,06/07/2022,0,0,0,0,0,0,0,0,0,0,0,0,0,0,0,0,0,0,0,0
4703,182291,2022,USA,Germany,0,0,0,0,05/07/2022,0,0,0,0,0,0,0,0,0,0,0,0,0,0,0,0,0,0,0,0
4704,182291,2022,Germany,France,0,0,0,0,26/06/2022,0,0,2,2,0,0,0,0,0,0,0,0,1,1,5,7,0,0,0,0
4705,182291,2022,Germany,Netherlands,0,0,0,0,24/06/2022,0,0,0,0,0,0,0,0,0,0,0,0,0,0,1,1,0,0,0,0
4706,182291,2022,China,Germany,0,0,0,0,23/06/2022,0,0,0,0,0,0,0,0,0,0,0,0,0,0,0,0,0,0,0,0
4707,182291,2022,Germany,Italy,0,0,0,0,22/06/2022,0,0,0,0,0,0,0,0,0,0,0,0,0,0,0,0,0,0,0,0
4708,139386,2022,Germany,Japan,0,0,0,0,09/07/2022,0,0,0,0,0,0,0,0,0,0,0,0,1,0,1,2,0,0,0,0
4709,139386,2022,Germany,Australia,1,4,14,19,07/07/2022,0,0,5,5,21,1,10,32,0,5,1,6,9,2,8,19,5,4,2,11
4710,139386,2022,Brazil,Germany,0,0,0,0,06/07/2022,0,1,0,1,0,0,0,0,0,0,0,0,0,0,4,4,1,0,1,2
4711,139386,2022,USA,Germany,0,0,1,1,05/07/2022,0,0,3,3,0,0,1,1,0,0,0,0,3,0,1,4,0,0,0,0
4712,139386,2022,Germany,France,0,0,0,0,26/06/2022,0,0,0,0,0,0,0,0,0,0,0,0,0,0,0,0,0,0,0,0
4713,139386,2022,Germany,Netherlands,0,0,0,0,24/06/2022,0,0,0,0,0,0,0,0,0,0,0,0,0,0,0,0,0,0,0,0
4714,139386,2022,China,Germany,0,0,0,0,23/06/2022,0,0,0,0,0,0,0,0,0,0,0,0,0,0,0,0,0,0,0,0
4715,139386,2022,Germany,Italy,0,2,7,9,22/06/2022,0,0,3,3,3,3,7,13,0,1,1,2,2,1,13,16,6,2,0,8
4716,139386,2022,Germany,Serbia,3,3,18,24,11/06/2022,0,0,4,4,14,4,19,37,1,2,1,4,16,0,25,41,4,0,7,11
4717,139386,2022,Bulgaria,Germany,0,4,19,23,10/06/2022,0,0,2,2,13,4,11,28,1,3,2,6,8,1,21,30,3,3,4,10
4718,139386,2022,Germany,Argentina,2,1,15,18,09/06/2022,0,1,2,3,14,5,6,25,2,3,5,10,8,2,19,29,1,2,1,4
4719,139386,2022,Canada,Germany,2,1,13,16,07/06/2022,0,0,5,5,12,1,7,20,1,1,0,2,6,1,11,18,3,0,1,4
4720,152470,2022,Germany,Japan,0,0,0,0,09/07/2022,0,0,5,5,0,0,0,0,0,0,0,0,4,1,11,16,2,1,1,4
4721,152470,2022,Germany,Australia,0,0,0,0,07/07/2022,2,0,6,8,0,0,0,0,0,0,0,0,10,0,10,20,10,1,1,12
4722,152470,2022,Brazil,Germany,0,0,0,0,06/07/2022,0,0,12,12,0,0,0,0,0,0,0,0,8,3,10,21,10,4,5,19
4723,152470,2022,USA,Germany,0,0,0,0,05/07/2022,3,0,11,14,0,0,0,0,0,0,0,0,11,0,11,22,3,6,15,24
4724,152470,2022,Germany,France,0,0,0,0,26/06/2022,0,0,6,6,0,0,0,0,0,0,0,0,5,2,6,13,2,3,0,5
4725,152470,2022,Germany,Netherlands,0,0,0,0,24/06/2022,1,0,12,13,0,0,0,0,0,0,0,0,6,4,16,26,25,1,1,27
4726,152470,2022,China,Germany,0,0,0,0,23/06/2022,0,0,0,0,0,0,0,0,0,0,0,0,0,0,0,0,0,0,0,0
4727,152470,2022,Germany,Italy,0,0,0,0,22/06/2022,0,0,2,2,0,0,0,0,0,0,0,0,7,0,5,12,7,2,1,10
4728,152470,2022,Germany,Serbia,0,0,0,0,11/06/2022,0,0,4,4,0,0,0,0,0,0,0,0,7,3,17,27,12,5,3,20
4729,152470,2022,Bulgaria,Germany,0,0,0,0,10/06/2022,0,0,6,6,0,0,0,0,0,0,0,0,4,1,6,11,14,6,5,25
4730,152470,2022,Germany,Argentina,0,0,0,0,09/06/2022,0,0,3,3,0,0,0,0,0,0,0,0,3,1,20,24,10,4,2,16
4731,152470,2022,Canada,Germany,0,0,0,0,07/06/2022,0,0,3,3,0,0,0,0,0,0,0,0,9,0,11,20,5,1,5,11
4732,116575,2022,,,-,-,-,-,-,-,-,-,-,-,-,-,-,-,-,-,-,-,-,-,-,-,-,-,-
4733,156597,2022,,,-,-,-,-,-,-,-,-,-,-,-,-,-,-,-,-,-,-,-,-,-,-,-,-,-
4734,189255,2022,,,-,-,-,-,-,-,-,-,-,-,-,-,-,-,-,-,-,-,-,-,-,-,-,-,-
4735,162788,2022,,,-,-,-,-,-,-,-,-,-,-,-,-,-,-,-,-,-,-,-,-,-,-,-,-,-
4736,136442,2022,Germany,Japan,0,1,12,13,09/07/2022,20,0,44,64,0,0,2,2,1,3,1,5,0,0,0,0,3,2,5,10
4737,136442,2022,Germany,Australia,1,2,10,13,07/07/2022,33,0,50,83,1,0,1,2,0,2,2,4,0,0,0,0,4,0,2,6
4738,136442,2022,Brazil,Germany,0,1,16,17,06/07/2022,28,0,58,86,0,0,0,0,0,1,1,2,0,0,0,0,2,2,3,7
4739,136442,2022,USA,Germany,0,2,12,14,05/07/2022,30,0,62,92,2,0,1,3,0,3,2,5,0,0,0,0,8,2,3,13
4740,136442,2022,Germany,France,0,0,0,0,26/06/2022,0,0,0,0,0,0,0,0,0,0,0,0,0,0,0,0,0,0,0,0
4741,136442,2022,Germany,Netherlands,0,0,21,21,24/06/2022,11,1,90,102,0,0,2,2,0,4,4,8,0,0,0,0,8,2,3,13
4742,136442,2022,China,Germany,0,0,0,0,23/06/2022,0,0,0,0,0,0,0,0,0,0,0,0,0,0,0,0,0,0,0,0
4743,136442,2022,Germany,Italy,1,1,4,6,22/06/2022,9,0,38,47,0,0,0,0,0,4,0,4,0,0,0,0,1,0,0,1
4744,136442,2022,Germany,Serbia,0,0,11,11,11/06/2022,26,2,66,94,0,0,2,2,0,2,2,4,0,1,1,2,4,5,1,10
4745,136442,2022,Bulgaria,Germany,0,2,6,8,10/06/2022,32,1,59,92,1,1,0,2,0,2,1,3,0,0,2,2,4,0,2,6
4746,136442,2022,Germany,Argentina,1,0,10,11,09/06/2022,13,0,51,64,0,0,1,1,0,0,2,2,0,0,0,0,4,2,1,7
4747,136442,2022,Canada,Germany,1,1,11,13,07/06/2022,25,1,45,71,0,0,0,0,0,0,0,0,0,0,0,0,6,1,1,8
4748,162790,2022,Germany,Japan,0,3,13,16,09/07/2022,0,0,0,0,3,1,3,7,2,3,1,6,1,0,0,1,1,0,1,2
4749,162790,2022,Germany,Australia,1,2,13,16,07/07/2022,0,0,0,0,3,2,3,8,1,4,2,7,0,0,0,0,0,2,1,3
4750,162790,2022,Brazil,Germany,1,2,11,14,06/07/2022,0,0,4,4,8,2,3,13,0,9,4,13,0,0,0,0,1,0,0,1
4751,162790,2022,USA,Germany,0,3,11,14,05/07/2022,0,0,2,2,7,1,5,13,0,2,3,5,0,0,1,1,1,2,0,3
4752,162790,2022,Germany,France,0,5,4,9,26/06/2022,0,0,1,1,3,1,0,4,1,9,3,13,1,1,1,3,1,0,2,3
4753,162790,2022,Germany,Netherlands,0,0,1,1,24/06/2022,0,0,0,0,0,0,0,0,0,0,0,0,0,0,0,0,0,0,0,0
4754,162790,2022,China,Germany,0,0,0,0,23/06/2022,0,0,0,0,0,0,0,0,0,0,0,0,0,0,0,0,0,0,0,0
4755,162790,2022,Germany,Italy,0,1,5,6,22/06/2022,0,0,0,0,1,2,0,3,1,0,1,2,1,0,1,2,1,0,0,1
4756,162790,2022,Germany,Serbia,0,3,8,11,11/06/2022,0,0,0,0,6,1,2,9,4,3,4,11,0,0,1,1,5,1,1,7
4757,162790,2022,Bulgaria,Germany,0,0,0,0,10/06/2022,0,0,0,0,0,0,0,0,0,0,0,0,0,0,0,0,0,0,0,0
4758,162790,2022,Germany,Argentina,2,4,9,15,09/06/2022,0,1,0,1,5,1,1,7,1,3,4,8,0,0,0,0,2,2,3,7
4759,162790,2022,Canada,Germany,0,0,0,0,07/06/2022,0,0,0,0,0,0,0,0,0,0,0,0,0,0,0,0,0,0,0,0
4760,174660,2022,Germany,Netherlands,0,0,0,0,24/06/2022,0,0,0,0,0,0,0,0,0,0,0,0,0,0,0,0,0,0,0,0
4761,174660,2022,China,Germany,0,0,0,0,23/06/2022,0,0,0,0,0,0,0,0,0,0,0,0,0,0,0,0,0,0,0,0
4762,174660,2022,Germany,Italy,2,0,6,8,22/06/2022,0,0,0,0,0,1,3,4,0,0,0,0,2,0,4,6,0,0,0,0
4763,162082,2022,USA,Germany,0,0,0,0,05/07/2022,0,0,0,0,0,0,0,0,0,0,0,0,0,0,0,0,0,0,0,0
4764,162082,2022,Germany,France,1,7,5,13,26/06/2022,0,0,2,2,14,6,8,28,1,4,4,9,0,0,0,0,3,3,0,6
4765,162082,2022,Germany,Netherlands,1,8,5,14,24/06/2022,0,0,0,0,22,8,20,50,2,3,5,10,0,0,0,0,7,3,1,11
4766,162082,2022,China,Germany,0,0,0,0,23/06/2022,0,0,0,0,0,0,0,0,0,0,0,0,0,0,0,0,0,0,0,0
4767,162082,2022,Germany,Italy,0,4,3,7,22/06/2022,0,0,0,0,14,7,5,26,0,2,0,2,0,0,1,1,1,1,0,2
4768,162082,2022,Germany,Serbia,2,5,10,17,11/06/2022,0,0,3,3,15,8,20,43,2,2,5,9,0,0,0,0,3,2,0,5
4769,162082,2022,Bulgaria,Germany,1,3,14,18,10/06/2022,0,0,1,1,13,7,7,27,1,5,0,6,0,0,0,0,4,2,3,9
4770,162082,2022,Germany,Argentina,3,6,5,14,09/06/2022,0,0,3,3,16,8,10,34,1,1,5,7,0,0,0,0,4,1,2,7
4771,162082,2022,Canada,Germany,0,5,7,12,07/06/2022,0,0,2,2,12,4,9,25,3,4,3,10,0,0,0,0,1,1,3,5
4772,152349,2022,Germany,Japan,0,4,7,11,09/07/2022,0,0,0,0,8,2,4,14,1,5,3,9,0,0,3,3,2,0,2,4
4773,152349,2022,Germany,Australia,2,4,7,13,07/07/2022,0,0,0,0,9,3,3,15,6,7,5,18,0,0,0,0,0,0,0,0
4774,152349,2022,Brazil,Germany,0,4,3,7,06/07/2022,0,0,0,0,5,1,2,8,1,9,2,12,0,0,2,2,1,1,0,2
4775,152349,2022,USA,Germany,1,5,5,11,05/07/2022,0,0,2,2,6,1,12,19,1,4,4,9,1,0,1,2,0,0,3,3
4776,152349,2022,Germany,France,0,0,0,0,26/06/2022,0,0,0,0,0,0,0,0,0,0,0,0,0,0,0,0,0,0,0,0
4777,152349,2022,Germany,Netherlands,0,2,7,9,24/06/2022,0,0,0,0,11,2,2,15,1,3,5,9,0,0,0,0,1,0,0,1
4778,152349,2022,China,Germany,0,0,0,0,23/06/2022,0,0,0,0,0,0,0,0,0,0,0,0,0,0,0,0,0,0,0,0
4779,152349,2022,Germany,Italy,0,1,1,2,22/06/2022,0,0,0,0,4,0,1,5,1,0,2,3,0,0,0,0,1,0,0,1
4780,152349,2022,Germany,Serbia,0,0,0,0,11/06/2022,0,0,0,0,0,0,0,0,0,0,0,0,0,0,0,0,0,0,0,0
4781,152349,2022,Bulgaria,Germany,1,1,10,12,10/06/2022,0,0,0,0,11,1,4,16,5,4,5,14,1,0,0,1,0,0,1,1
4782,152349,2022,Germany,Argentina,0,0,0,0,09/06/2022,0,0,0,0,0,0,0,0,0,0,0,0,0,0,0,0,0,0,0,0
4783,152349,2022,Canada,Germany,1,3,1,5,07/06/2022,0,0,2,2,1,3,4,8,1,3,4,8,0,0,0,0,1,0,0,1
4784,163592,2022,Germany,Japan,0,4,8,12,09/07/2022,0,0,3,3,12,2,13,27,0,2,0,2,5,2,18,25,3,2,1,6
4785,163592,2022,Germany,Australia,0,4,12,16,07/07/2022,0,0,0,0,5,4,9,18,1,2,1,4,6,2,18,26,7,2,1,10
4786,163592,2022,Brazil,Germany,0,2,11,13,06/07/2022,0,0,4,4,14,2,11,27,3,4,2,9,7,2,17,26,4,0,3,7
4787,163592,2022,USA,Germany,0,2,15,17,05/07/2022,1,0,3,4,11,1,8,20,0,3,3,6,11,2,12,25,9,2,3,14
4788,163592,2022,Germany,France,1,2,13,16,26/06/2022,0,0,6,6,4,1,10,15,0,1,1,2,8,2,11,21,3,1,0,4
4789,163592,2022,Germany,Netherlands,0,1,13,14,24/06/2022,0,0,2,2,7,1,13,21,0,4,5,9,8,1,25,34,10,3,0,13
4790,163592,2022,China,Germany,0,0,0,0,23/06/2022,0,0,0,0,0,0,0,0,0,0,0,0,0,0,0,0,0,0,0,0
4791,163592,2022,Germany,Italy,0,0,1,1,22/06/2022,0,0,0,0,1,2,2,5,0,1,1,2,0,0,6,6,2,0,0,2
4792,163592,2022,Germany,Serbia,0,0,5,5,11/06/2022,0,0,1,1,0,0,3,3,0,0,0,0,2,1,2,5,1,2,3,6
4793,163592,2022,Bulgaria,Germany,0,0,2,2,10/06/2022,0,0,0,0,0,0,0,0,0,0,0,0,0,0,0,0,0,0,0,0
4794,163592,2022,Germany,Argentina,0,0,1,1,09/06/2022,0,0,1,1,0,1,0,1,0,0,1,1,0,0,2,2,0,0,0,0
4795,163592,2022,Canada,Germany,0,0,0,0,07/06/2022,0,0,0,0,0,0,0,0,0,0,0,0,0,0,0,0,0,0,0,0
4796,183112,2022,Germany,Serbia,0,0,0,0,11/06/2022,0,0,0,0,0,0,0,0,0,0,0,0,0,0,0,0,0,0,0,0
4797,183112,2022,Bulgaria,Germany,0,0,0,0,10/06/2022,0,0,0,0,0,0,0,0,0,0,0,0,0,0,0,0,0,0,0,0
4798,183112,2022,Germany,Argentina,0,0,0,0,09/06/2022,0,0,0,0,0,0,0,0,0,0,0,0,0,0,0,0,0,0,0,0
4799,183112,2022,Canada,Germany,0,0,0,0,07/06/2022,0,0,0,0,0,0,0,0,0,0,0,0,0,0,0,0,0,0,0,0
4800,156598,2022,,,-,-,-,-,-,-,-,-,-,-,-,-,-,-,-,-,-,-,-,-,-,-,-,-,-
4801,152352,2022,Brazil,Germany,1,3,12,16,06/07/2022,0,2,2,4,13,5,14,32,1,3,1,5,0,0,1,1,5,2,5,12
4802,152352,2022,USA,Germany,1,2,12,15,05/07/2022,0,1,2,3,14,4,22,40,0,3,1,4,0,0,1,1,2,3,3,8
4803,152352,2022,Germany,France,0,3,13,16,26/06/2022,0,0,1,1,5,1,5,11,3,4,3,10,0,0,2,2,3,0,0,3
4804,152352,2022,Germany,Netherlands,0,2,13,15,24/06/2022,0,0,1,1,5,0,6,11,5,7,10,22,1,0,2,3,4,2,1,7
4805,152352,2022,China,Germany,0,0,0,0,23/06/2022,0,0,0,0,0,0,0,0,0,0,0,0,0,0,0,0,0,0,0,0
4806,152352,2022,Germany,Italy,0,2,7,9,22/06/2022,0,0,1,1,5,1,4,10,2,5,2,9,0,0,3,3,3,1,0,4
4807,152352,2022,Germany,Serbia,2,3,16,21,11/06/2022,0,0,0,0,12,3,7,22,3,14,7,24,0,0,1,1,0,4,3,7
4808,152352,2022,Bulgaria,Germany,1,3,18,22,10/06/2022,0,1,1,2,6,1,3,10,3,4,4,11,0,0,2,2,3,2,2,7
4809,152352,2022,Germany,Argentina,0,3,9,12,09/06/2022,0,0,2,2,6,1,6,13,1,5,2,8,1,1,1,3,1,0,4,5
4810,152352,2022,Canada,Germany,1,3,10,14,07/06/2022,0,0,0,0,4,0,3,7,0,6,1,7,0,0,1,1,1,0,4,5
4811,174663,2022,,,-,-,-,-,-,-,-,-,-,-,-,-,-,-,-,-,-,-,-,-,-,-,-,-,-
4812,176931,2022,Germany,Japan,0,1,1,2,09/07/2022,5,0,16,21,1,0,0,1,0,1,0,1,0,0,0,0,1,4,0,5
4813,176931,2022,Germany,Australia,0,0,0,0,07/07/2022,0,0,0,0,0,0,0,0,0,0,0,0,0,0,0,0,0,0,0,0
4814,176931,2022,Brazil,Germany,0,0,0,0,06/07/2022,0,0,4,4,0,0,0,0,0,0,0,0,0,0,0,0,0,0,0,0
4815,176931,2022,USA,Germany,0,0,0,0,05/07/2022,1,0,1,2,0,0,0,0,0,0,0,0,0,0,0,0,0,0,0,0
4816,152751,2022,Germany,Japan,0,0,0,0,09/07/2022,0,0,0,0,0,0,0,0,0,0,0,0,0,0,0,0,0,0,0,0
4817,152751,2022,Germany,Australia,0,0,0,0,07/07/2022,0,0,0,0,0,0,0,0,0,0,0,0,0,0,0,0,0,0,0,0
4818,152751,2022,Brazil,Germany,0,0,0,0,06/07/2022,0,0,0,0,0,0,0,0,0,0,0,0,0,0,0,0,0,0,0,0
4819,152751,2022,USA,Germany,0,0,0,0,05/07/2022,0,0,0,0,0,0,0,0,0,0,0,0,0,0,0,0,0,0,0,0
4820,152751,2022,Germany,France,0,1,0,1,26/06/2022,0,0,0,0,0,0,0,0,0,0,0,0,0,0,0,0,0,0,0,0
4821,152751,2022,Germany,Netherlands,0,0,0,0,24/06/2022,0,0,0,0,1,0,0,1,0,0,1,1,0,0,0,0,0,0,0,0
4822,152751,2022,China,Germany,0,0,0,0,23/06/2022,0,0,0,0,0,0,0,0,0,0,0,0,0,0,0,0,0,0,0,0
4823,152751,2022,Germany,Italy,0,0,0,0,22/06/2022,0,0,0,0,0,0,0,0,0,0,0,0,0,0,0,0,0,0,0,0
4824,152751,2022,Germany,Serbia,0,0,0,0,11/06/2022,0,0,0,0,0,0,0,0,0,0,0,0,0,0,0,0,0,0,0,0
4825,152751,2022,Bulgaria,Germany,0,0,0,0,10/06/2022,0,0,0,0,0,0,0,0,0,0,0,0,0,0,0,0,0,0,0,0
4826,152751,2022,Germany,Argentina,0,0,0,0,09/06/2022,0,0,0,0,0,0,0,0,0,0,0,0,0,0,0,0,0,0,0,0
4827,152751,2022,Canada,Germany,0,0,0,0,07/06/2022,0,0,0,0,0,0,0,0,0,0,0,0,0,0,0,0,0,0,0,0
4828,152713,2022,Germany,Japan,2,1,6,9,09/07/2022,0,0,0,0,5,2,1,8,0,0,0,0,0,0,10,10,0,1,3,4
4829,152713,2022,Germany,Australia,0,1,2,3,07/07/2022,0,0,0,0,0,0,0,0,0,0,0,0,0,0,0,0,0,0,0,0
4830,152713,2022,Brazil,Germany,0,0,3,3,06/07/2022,0,0,0,0,0,0,0,0,0,0,0,0,0,0,0,0,0,0,0,0
4831,152713,2022,USA,Germany,0,0,2,2,05/07/2022,0,0,0,0,0,0,0,0,0,0,0,0,0,0,0,0,0,0,0,0
4832,152713,2022,Germany,France,0,0,0,0,26/06/2022,0,0,0,0,0,0,0,0,0,0,0,0,0,0,0,0,0,0,0,0
4833,152713,2022,Germany,Netherlands,0,1,1,2,24/06/2022,0,0,0,0,1,2,0,3,0,0,1,1,0,0,0,0,0,1,0,1
4834,152713,2022,China,Germany,0,0,0,0,23/06/2022,0,0,0,0,0,0,0,0,0,0,0,0,0,0,0,0,0,0,0,0
4835,152713,2022,Germany,Italy,0,0,1,1,22/06/2022,0,0,1,1,1,1,0,2,0,0,0,0,0,0,1,1,0,0,0,0
4836,152713,2022,Germany,Serbia,0,0,0,0,11/06/2022,0,0,0,0,0,0,0,0,0,0,0,0,0,0,0,0,0,0,0,0
4837,152713,2022,Bulgaria,Germany,0,0,0,0,10/06/2022,0,0,0,0,0,0,0,0,0,0,0,0,0,0,0,0,0,0,0,0
4838,152713,2022,Germany,Argentina,0,1,0,1,09/06/2022,0,0,0,0,0,0,0,0,0,0,0,0,0,0,0,0,0,0,0,0
4839,152713,2022,Canada,Germany,0,1,0,1,07/06/2022,0,0,0,0,0,0,0,0,0,0,0,0,0,0,0,0,0,0,0,0
4840,174640,2022,Germany,Japan,0,5,7,12,09/07/2022,0,0,1,1,9,7,3,19,3,4,5,12,0,0,1,1,6,3,1,10
4841,174640,2022,Germany,Australia,0,0,0,0,07/07/2022,0,0,0,0,0,0,0,0,0,0,0,0,0,0,0,0,0,0,0,0
4842,174640,2022,Brazil,Germany,0,1,1,2,06/07/2022,0,0,0,0,1,0,2,3,0,0,0,0,0,0,0,0,0,0,0,0
4843,174640,2022,USA,Germany,0,0,0,0,05/07/2022,0,0,0,0,0,1,1,2,0,0,0,0,0,0,0,0,0,0,0,0
4844,174640,2022,Germany,Serbia,0,0,0,0,11/06/2022,0,0,0,0,0,0,0,0,0,0,0,0,0,0,0,0,0,0,0,0
4845,174640,2022,Bulgaria,Germany,0,0,0,0,10/06/2022,0,0,0,0,0,0,0,0,0,0,0,0,0,0,0,0,0,0,0,0
4846,174640,2022,Germany,Argentina,0,1,0,1,09/06/2022,0,0,0,0,0,0,2,2,0,0,0,0,0,0,0,0,0,0,0,0
4847,174640,2022,Canada,Germany,0,0,0,0,07/06/2022,0,0,0,0,0,0,0,0,0,0,0,0,0,0,0,0,0,0,0,0
4848,181283,2022,,,-,-,-,-,-,-,-,-,-,-,-,-,-,-,-,-,-,-,-,-,-,-,-,-,-
4849,163173,2022,Poland,Iran,0,2,12,14,21/07/2022,0,0,4,4,5,2,2,9,1,2,9,12,2,0,0,2,1,1,1,3
4850,163173,2022,Iran,Serbia,0,0,11,11,09/07/2022,0,0,0,0,3,2,0,5,6,3,0,9,0,0,1,1,2,1,0,3
4851,163173,2022,Slovenia,Iran,0,2,7,9,08/07/2022,0,0,0,0,4,0,1,5,0,2,0,2,0,0,0,0,0,0,0,0
4852,163173,2022,Italy,Iran,0,2,2,4,07/07/2022,0,0,0,0,0,0,1,1,0,3,1,4,0,0,0,0,0,0,0,0
4853,163173,2022,Iran,Poland,0,1,9,10,05/07/2022,0,0,1,1,3,1,2,6,3,4,1,8,0,0,0,0,1,2,1,4
4854,163173,2022,Canada,Iran,0,0,10,10,25/06/2022,0,0,0,0,3,0,0,3,2,3,2,7,0,0,1,1,0,1,0,1
4855,163173,2022,Iran,Brazil,1,0,13,14,24/06/2022,0,0,0,0,2,1,3,6,0,1,0,1,0,0,0,0,0,0,0,0
4856,163173,2022,USA,Iran,0,0,9,9,23/06/2022,0,0,0,0,4,1,1,6,1,3,0,4,0,0,0,0,1,2,0,3
4857,163173,2022,Iran,Bulgaria,0,1,13,14,21/06/2022,0,0,0,0,0,0,2,2,1,3,3,7,1,0,0,1,0,1,0,1
4858,163173,2022,Iran,Japan,0,0,5,5,12/06/2022,0,0,0,0,2,0,0,2,0,1,1,2,1,0,0,1,1,0,0,1
4859,163173,2022,Iran,Australia,2,2,9,13,12/06/2022,3,0,0,3,4,1,4,9,5,4,3,12,0,0,0,0,1,0,0,1
4860,163173,2022,Netherlands,Iran,2,0,7,9,10/06/2022,0,0,0,0,2,0,3,5,1,5,1,7,0,0,2,2,1,0,1,2
4861,163173,2022,China,Iran,0,0,0,0,07/06/2022,0,0,0,0,0,0,0,0,0,0,0,0,0,0,0,0,0,0,0,0
4862,136751,2022,Poland,Iran,3,5,11,19,21/07/2022,0,2,2,4,12,4,11,27,2,3,2,7,7,1,10,18,11,4,0,15
4863,136751,2022,Iran,Serbia,1,3,12,16,09/07/2022,0,0,2,2,9,3,7,19,0,3,0,3,2,1,8,11,3,1,0,4
4864,136751,2022,Slovenia,Iran,1,2,8,11,08/07/2022,0,0,2,2,10,2,5,17,1,0,0,1,3,2,10,15,0,1,0,1
4865,136751,2022,Italy,Iran,4,2,14,20,07/07/2022,0,0,3,3,20,1,9,30,2,2,0,4,3,7,14,24,9,0,0,9
4866,136751,2022,Iran,Poland,3,2,14,19,05/07/2022,0,0,4,4,14,4,6,24,1,1,0,2,2,3,10,15,8,2,2,12
4867,136751,2022,Canada,Iran,2,4,10,16,25/06/2022,0,1,1,2,7,2,4,13,1,2,0,3,4,1,8,13,4,0,0,4
4868,136751,2022,Iran,Brazil,0,1,9,10,24/06/2022,0,0,2,2,3,5,7,15,2,1,0,3,8,0,7,15,1,3,1,5
4869,136751,2022,USA,Iran,2,3,8,13,23/06/2022,0,1,0,1,12,2,7,21,1,0,0,1,3,2,15,20,0,1,0,1
4870,136751,2022,Iran,Bulgaria,0,0,2,2,21/06/2022,0,0,0,0,1,0,1,2,0,1,1,2,1,0,4,5,0,0,0,0
4871,136751,2022,Iran,Japan,0,1,5,6,12/06/2022,2,0,0,2,2,2,8,12,1,1,1,3,3,3,12,18,1,1,0,2
4872,136751,2022,Iran,Australia,0,2,11,13,12/06/2022,2,0,0,2,6,2,7,15,2,2,0,4,7,0,7,14,8,2,2,12
4873,136751,2022,Netherlands,Iran,1,3,5,9,10/06/2022,1,0,0,1,5,4,7,16,0,2,0,2,3,1,14,18,4,0,0,4
4874,136751,2022,China,Iran,1,3,11,15,07/06/2022,0,0,3,3,13,5,8,26,1,2,0,3,5,2,17,24,3,0,0,3
4875,150817,2022,Iran,Japan,0,0,0,0,12/06/2022,0,0,0,0,0,0,0,0,0,0,0,0,0,0,0,0,0,0,0,0
4876,150817,2022,Iran,Australia,0,0,0,0,12/06/2022,0,0,0,0,0,0,0,0,0,0,0,0,0,0,0,0,0,0,0,0
4877,150817,2022,China,Iran,1,2,8,11,07/06/2022,0,0,0,0,2,2,0,4,2,7,4,13,0,1,3,4,5,1,2,8
4878,163179,2022,Poland,Iran,2,4,8,14,21/07/2022,0,0,2,2,4,3,1,8,0,3,2,5,1,1,2,4,2,0,0,2
4879,163179,2022,Iran,Serbia,1,3,15,19,09/07/2022,0,0,0,0,10,1,1,12,2,2,0,4,0,0,2,2,0,0,0,0
4880,163179,2022,Slovenia,Iran,1,4,5,10,08/07/2022,0,0,0,0,3,0,1,4,1,0,1,2,0,0,1,1,0,0,0,0
4881,163179,2022,Italy,Iran,1,2,11,14,07/07/2022,0,0,0,0,2,2,4,8,1,6,1,8,0,0,4,4,1,0,0,1
4882,163179,2022,Iran,Poland,1,3,21,25,05/07/2022,0,0,0,0,6,3,5,14,0,5,1,6,0,0,3,3,1,1,1,3
4883,163179,2022,Canada,Iran,0,0,0,0,25/06/2022,0,0,0,0,0,0,0,0,0,0,0,0,0,0,0,0,0,0,0,0
4884,163179,2022,Iran,Brazil,0,2,7,9,24/06/2022,0,0,0,0,5,0,1,6,1,2,1,4,0,0,0,0,0,0,0,0
4885,163179,2022,USA,Iran,0,1,2,3,23/06/2022,0,0,0,0,2,1,2,5,0,2,1,3,0,0,0,0,1,0,0,1
4886,163179,2022,Iran,Bulgaria,0,1,8,9,21/06/2022,0,0,1,1,2,0,1,3,1,3,1,5,0,1,1,2,0,0,0,0
4887,163179,2022,Iran,Japan,0,3,3,6,12/06/2022,0,0,0,0,2,1,3,6,0,6,1,7,2,0,1,3,2,1,1,4
4888,163179,2022,Iran,Australia,1,4,15,20,12/06/2022,1,2,0,3,6,0,0,6,1,4,6,11,0,0,1,1,1,0,1,2
4889,163179,2022,Netherlands,Iran,1,1,5,7,10/06/2022,0,0,0,0,1,0,0,1,0,4,0,4,0,0,2,2,0,0,0,0
4890,163179,2022,China,Iran,2,2,12,16,07/06/2022,0,0,1,1,9,0,3,12,1,4,0,5,0,0,3,3,3,0,0,3
4891,152741,2022,Canada,Iran,0,0,0,0,25/06/2022,0,0,0,0,0,0,0,0,0,0,0,0,0,0,0,0,0,0,0,0
4892,152741,2022,Iran,Brazil,0,0,0,0,24/06/2022,0,0,0,0,0,0,0,0,0,0,0,0,0,0,0,0,0,0,0,0
4893,152741,2022,USA,Iran,0,0,0,0,23/06/2022,0,0,0,0,0,0,0,0,0,0,0,0,0,0,0,0,0,0,0,0
4894,152741,2022,Iran,Bulgaria,0,0,0,0,21/06/2022,0,0,0,0,0,0,0,0,0,0,0,0,0,0,3,3,1,0,0,1
4895,152741,2022,Iran,Japan,0,1,1,2,12/06/2022,0,0,1,1,2,1,2,5,1,1,1,3,0,1,8,9,1,0,1,2
4896,152741,2022,Iran,Australia,0,0,0,0,12/06/2022,0,0,0,0,0,0,0,0,0,0,0,0,0,0,0,0,0,0,0,0
4897,152741,2022,Netherlands,Iran,0,0,0,0,10/06/2022,0,0,0,0,0,0,0,0,0,0,0,0,0,0,0,0,0,0,0,0
4898,152741,2022,China,Iran,0,0,0,0,07/06/2022,0,0,0,0,0,0,0,0,0,0,0,0,0,0,0,0,0,0,0,0
4899,163176,2022,Poland,Iran,0,0,0,0,21/07/2022,0,0,8,8,0,0,0,0,0,0,0,0,10,0,10,20,9,2,2,13
4900,163176,2022,Iran,Serbia,0,0,0,0,09/07/2022,0,0,2,2,0,0,0,0,0,0,0,0,1,0,15,16,4,4,1,9
4901,163176,2022,Slovenia,Iran,0,0,0,0,08/07/2022,0,0,4,4,0,0,0,0,0,0,0,0,4,1,3,8,7,2,2,11
4902,163176,2022,Italy,Iran,0,0,0,0,07/07/2022,0,0,7,7,0,0,0,0,0,0,0,0,2,0,19,21,7,2,1,10
4903,163176,2022,Iran,Poland,0,0,0,0,05/07/2022,0,0,3,3,0,0,0,0,0,0,0,0,6,3,11,20,5,2,0,7
4904,163176,2022,Canada,Iran,0,0,0,0,25/06/2022,0,0,2,2,0,0,0,0,0,0,0,0,3,1,5,9,3,1,0,4
4905,163176,2022,Iran,Brazil,0,0,0,0,24/06/2022,0,0,1,1,0,0,0,0,0,0,0,0,8,3,11,22,0,1,1,2
4906,163176,2022,USA,Iran,0,0,0,0,23/06/2022,0,0,6,6,0,0,0,0,0,0,0,0,2,0,9,11,0,1,1,2
4907,163176,2022,Iran,Bulgaria,0,0,0,0,21/06/2022,0,0,4,4,0,0,0,0,0,0,0,0,0,1,9,10,3,2,3,8
4908,163176,2022,Iran,Japan,0,0,0,0,12/06/2022,2,0,0,2,0,0,0,0,0,0,0,0,0,0,4,4,4,1,0,5
4909,163176,2022,Iran,Australia,0,0,0,0,12/06/2022,4,0,3,7,0,0,0,0,0,0,0,0,11,0,14,25,6,2,1,9
4910,163176,2022,Netherlands,Iran,0,0,0,0,10/06/2022,5,0,0,5,0,0,0,0,0,0,0,0,8,0,11,19,6,3,3,12
4911,163176,2022,China,Iran,0,0,0,0,07/06/2022,0,0,8,8,0,0,0,0,0,0,0,0,4,0,15,19,5,1,4,10
4912,153535,2022,Canada,Iran,0,0,0,0,25/06/2022,0,0,0,0,0,0,0,0,0,0,0,0,0,0,0,0,0,0,0,0
4913,153535,2022,Iran,Brazil,0,0,0,0,24/06/2022,0,0,0,0,0,0,0,0,0,0,0,0,0,0,0,0,0,0,0,0
4914,153535,2022,USA,Iran,0,0,0,0,23/06/2022,0,0,0,0,0,0,0,0,0,0,0,0,0,0,0,0,0,0,0,0
4915,153535,2022,Iran,Bulgaria,0,0,0,0,21/06/2022,0,0,0,0,0,0,0,0,0,0,0,0,2,0,3,5,0,1,0,1
4916,153535,2022,Iran,Japan,0,0,0,0,12/06/2022,2,0,1,3,0,0,0,0,0,0,0,0,4,0,1,5,2,0,0,2
4917,153535,2022,Iran,Australia,0,0,0,0,12/06/2022,0,0,0,0,0,0,0,0,0,0,0,0,0,0,0,0,0,0,0,0
4918,153535,2022,Netherlands,Iran,0,0,0,0,10/06/2022,0,0,0,0,0,0,0,0,0,0,0,0,0,0,0,0,0,0,0,0
4919,153535,2022,China,Iran,0,0,0,0,07/06/2022,0,0,0,0,0,0,0,0,0,0,0,0,0,0,0,0,0,0,0,0
4920,164188,2022,Iran,Japan,0,0,5,5,12/06/2022,0,0,0,0,3,1,5,9,0,0,0,0,0,0,0,0,2,0,0,2
4921,164188,2022,Iran,Australia,0,1,0,1,12/06/2022,0,0,0,0,0,0,0,0,0,0,0,0,0,0,0,0,0,0,0,0
4922,164188,2022,Netherlands,Iran,0,0,1,1,10/06/2022,0,0,0,0,1,1,1,3,0,0,0,0,0,0,0,0,0,0,0,0
4923,164188,2022,China,Iran,4,2,6,12,07/06/2022,0,1,0,1,3,5,5,13,0,1,1,2,0,0,1,1,4,1,0,5
4924,124251,2022,,,-,-,-,-,-,-,-,-,-,-,-,-,-,-,-,-,-,-,-,-,-,-,-,-,-
4925,152753,2022,Canada,Iran,0,0,0,0,25/06/2022,0,0,3,3,0,0,0,0,0,0,0,0,0,0,0,0,0,0,0,0
4926,152753,2022,Iran,Brazil,0,0,2,2,24/06/2022,0,0,10,10,0,0,0,0,0,0,0,0,0,0,0,0,0,0,0,0
4927,152753,2022,USA,Iran,0,0,0,0,23/06/2022,0,0,1,1,0,0,0,0,0,0,0,0,0,0,0,0,0,0,0,0
4928,152753,2022,Iran,Bulgaria,0,1,0,1,21/06/2022,2,0,1,3,0,0,0,0,0,0,0,0,0,0,0,0,0,0,0,0
4929,152753,2022,Iran,Japan,1,0,5,6,12/06/2022,12,2,21,35,0,0,2,2,0,0,1,1,0,0,0,0,2,1,0,3
4930,152753,2022,Iran,Australia,0,0,0,0,12/06/2022,6,0,3,9,0,0,0,0,0,0,1,1,0,0,0,0,3,0,0,3
4931,152753,2022,Netherlands,Iran,0,0,6,6,10/06/2022,9,1,17,27,1,0,0,1,0,3,0,3,0,0,1,1,1,1,1,3
4932,152753,2022,China,Iran,0,0,0,0,07/06/2022,0,0,2,2,0,0,0,0,0,0,0,0,0,0,0,0,0,0,0,0
4933,162557,2022,,,-,-,-,-,-,-,-,-,-,-,-,-,-,-,-,-,-,-,-,-,-,-,-,-,-
4934,152743,2022,,,-,-,-,-,-,-,-,-,-,-,-,-,-,-,-,-,-,-,-,-,-,-,-,-,-
4935,132534,2022,Poland,Iran,0,0,0,0,21/07/2022,0,0,0,0,0,0,0,0,0,0,0,0,0,0,0,0,0,0,0,0
4936,132534,2022,Iran,Serbia,0,0,0,0,09/07/2022,0,0,0,0,0,0,0,0,0,0,0,0,0,0,0,0,0,0,0,0
4937,132534,2022,Slovenia,Iran,0,0,0,0,08/07/2022,0,0,0,0,0,0,0,0,0,0,0,0,0,0,0,0,0,0,0,0
4938,132534,2022,Italy,Iran,0,0,0,0,07/07/2022,0,0,0,0,0,0,0,0,0,0,0,0,0,0,0,0,0,0,0,0
4939,132534,2022,Iran,Poland,0,0,0,0,05/07/2022,0,0,0,0,0,0,0,0,0,0,0,0,0,0,0,0,0,0,0,0
4940,153539,2022,Poland,Iran,0,3,12,15,21/07/2022,1,0,1,2,21,9,9,39,1,6,4,11,1,0,0,1,2,2,2,6
4941,153539,2022,Iran,Serbia,2,2,11,15,09/07/2022,0,0,2,2,13,2,9,24,1,4,0,5,0,0,0,0,4,2,0,6
4942,153539,2022,Slovenia,Iran,3,5,14,22,08/07/2022,0,0,0,0,11,5,10,26,0,2,0,2,0,0,0,0,4,0,0,4
4943,153539,2022,Italy,Iran,2,2,11,15,07/07/2022,0,0,5,5,18,6,18,42,3,2,0,5,0,0,2,2,0,2,0,2
4944,153539,2022,Iran,Poland,3,4,17,24,05/07/2022,0,0,2,2,14,5,8,27,1,4,0,5,0,0,0,0,2,1,1,4
4945,153539,2022,Canada,Iran,0,5,11,16,25/06/2022,0,0,0,0,15,3,6,24,0,1,2,3,0,0,0,0,2,0,3,5
4946,153539,2022,Iran,Brazil,0,2,7,9,24/06/2022,0,0,0,0,15,3,3,21,0,2,2,4,0,0,0,0,0,0,0,0
4947,153539,2022,USA,Iran,0,2,12,14,23/06/2022,0,1,0,1,19,4,6,29,1,1,3,5,0,0,1,1,1,1,1,3
4948,153539,2022,Iran,Bulgaria,0,1,6,7,21/06/2022,0,0,0,0,15,6,8,29,2,2,0,4,0,0,0,0,2,0,1,3
4949,153539,2022,Iran,Japan,2,2,4,8,12/06/2022,1,0,0,1,7,2,8,17,1,1,1,3,0,0,0,0,1,1,0,2
4950,153539,2022,Iran,Australia,1,4,10,15,12/06/2022,1,0,0,1,21,7,9,37,1,2,3,6,0,0,0,0,7,2,1,10
4951,153539,2022,Netherlands,Iran,0,2,8,10,10/06/2022,0,0,1,1,15,4,11,30,0,3,2,5,0,0,0,0,3,0,0,3
4952,153539,2022,China,Iran,0,1,4,5,07/06/2022,0,0,0,0,6,0,0,6,1,0,2,3,0,0,0,0,1,0,0,1
4953,119750,2022,Poland,Iran,0,1,16,17,21/07/2022,15,0,80,95,0,0,0,0,0,4,2,6,0,1,1,2,8,2,0,10
4954,119750,2022,Iran,Serbia,1,1,7,9,09/07/2022,24,0,49,73,2,0,0,2,1,0,0,1,0,0,0,0,1,1,0,2
4955,119750,2022,Slovenia,Iran,0,1,10,11,08/07/2022,18,0,44,62,0,0,0,0,3,1,0,4,0,0,0,0,0,1,0,1
4956,119750,2022,Italy,Iran,0,0,14,14,07/07/2022,12,0,62,74,1,0,0,1,0,0,0,0,0,0,0,0,0,1,1,2
4957,119750,2022,Iran,Poland,0,3,8,11,05/07/2022,19,0,75,94,0,0,1,1,0,3,0,3,0,0,0,0,1,0,1,2
4958,119750,2022,Canada,Iran,0,1,10,11,25/06/2022,10,0,44,54,0,0,1,1,0,1,0,1,0,0,0,0,4,0,0,4
4959,119750,2022,Iran,Brazil,0,0,8,8,24/06/2022,10,0,43,53,1,0,2,3,1,2,0,3,0,0,0,0,1,0,0,1
4960,119750,2022,USA,Iran,0,1,11,12,23/06/2022,12,0,53,65,1,0,0,1,0,4,2,6,0,0,0,0,1,0,2,3
4961,119750,2022,Iran,Bulgaria,0,1,13,14,21/06/2022,14,0,53,67,1,0,0,1,1,2,0,3,0,0,0,0,1,0,0,1
4962,119750,2022,Iran,Japan,0,0,4,4,12/06/2022,8,0,16,24,0,0,0,0,0,1,1,2,0,0,0,0,4,0,0,4
4963,119750,2022,Iran,Australia,0,0,12,12,12/06/2022,30,0,35,65,1,0,0,1,0,3,4,7,0,0,0,0,5,2,0,7
4964,119750,2022,Netherlands,Iran,0,0,6,6,10/06/2022,13,0,27,40,0,0,0,0,0,1,0,1,0,0,0,0,3,1,0,4
4965,119750,2022,China,Iran,2,0,11,13,07/06/2022,29,1,16,46,1,0,1,2,0,0,1,1,0,0,2,2,2,2,2,6
4966,163174,2022,Poland,Iran,0,0,0,0,21/07/2022,0,0,0,0,1,0,0,1,0,0,0,0,2,0,2,4,0,1,0,1
4967,163174,2022,Iran,Serbia,0,0,0,0,09/07/2022,0,0,0,0,0,0,0,0,0,0,0,0,0,0,0,0,0,0,0,0
4968,163174,2022,Slovenia,Iran,0,0,0,0,08/07/2022,0,0,0,0,0,0,0,0,0,0,0,0,0,0,0,0,0,0,0,0
4969,163174,2022,Italy,Iran,0,0,0,0,07/07/2022,0,0,0,0,0,0,0,0,0,0,0,0,0,0,2,2,0,0,0,0
4970,163174,2022,Iran,Poland,0,0,0,0,05/07/2022,0,0,0,0,0,0,0,0,0,0,0,0,0,0,0,0,0,0,0,0
4971,152762,2022,,,-,-,-,-,-,-,-,-,-,-,-,-,-,-,-,-,-,-,-,-,-,-,-,-,-
4972,174560,2022,Poland,Iran,0,0,1,1,21/07/2022,0,0,0,0,1,1,0,2,0,0,0,0,0,0,0,0,0,0,0,0
4973,174560,2022,Iran,Serbia,0,0,1,1,09/07/2022,0,0,0,0,0,0,0,0,0,0,0,0,0,0,0,0,0,0,0,0
4974,174560,2022,Slovenia,Iran,0,0,0,0,08/07/2022,0,0,0,0,0,0,0,0,0,0,0,0,0,0,0,0,0,0,0,0
4975,174560,2022,Italy,Iran,0,0,8,8,07/07/2022,0,0,0,0,1,0,0,1,0,2,0,2,0,0,0,0,1,0,1,2
4976,174560,2022,Iran,Poland,0,0,1,1,05/07/2022,0,0,0,0,0,0,0,0,0,0,0,0,0,0,0,0,0,0,0,0
4977,174560,2022,Canada,Iran,0,0,10,10,25/06/2022,0,0,1,1,3,0,1,4,1,2,4,7,0,0,0,0,0,1,0,1
4978,174560,2022,Iran,Brazil,0,0,2,2,24/06/2022,0,0,0,0,0,1,0,1,0,2,0,2,0,0,0,0,0,1,0,1
4979,174560,2022,USA,Iran,0,1,7,8,23/06/2022,0,0,0,0,0,0,1,1,1,0,0,1,0,0,2,2,0,0,0,0
4980,174560,2022,Iran,Bulgaria,0,1,1,2,21/06/2022,0,0,0,0,0,0,0,0,0,0,0,0,0,0,0,0,1,0,0,1
4981,152752,2022,Poland,Iran,1,4,9,14,21/07/2022,0,0,2,2,10,5,14,29,3,3,3,9,10,3,13,26,5,3,2,10
4982,152752,2022,Iran,Serbia,2,2,8,12,09/07/2022,0,0,4,4,11,3,7,21,4,3,0,7,4,0,21,25,1,0,0,1
4983,152752,2022,Slovenia,Iran,1,3,6,10,08/07/2022,0,0,0,0,8,3,5,16,1,0,0,1,3,1,19,23,1,1,1,3
4984,152752,2022,Italy,Iran,1,5,2,8,07/07/2022,0,0,2,2,4,4,6,14,0,0,0,0,3,1,12,16,1,0,1,2
4985,152752,2022,Iran,Poland,2,2,14,18,05/07/2022,0,0,1,1,19,3,10,32,0,4,1,5,3,4,34,41,1,3,1,5
4986,152752,2022,Canada,Iran,2,3,6,11,25/06/2022,0,0,1,1,12,1,8,21,0,1,3,4,8,2,11,21,2,2,0,4
4987,152752,2022,Iran,Brazil,1,4,3,8,24/06/2022,0,0,0,0,4,3,5,12,1,3,1,5,5,1,10,16,0,0,0,0
4988,152752,2022,USA,Iran,3,5,9,17,23/06/2022,0,0,0,0,8,1,4,13,2,2,2,6,5,1,20,26,1,1,0,2
4989,152752,2022,Iran,Bulgaria,0,0,7,7,21/06/2022,0,0,1,1,8,5,4,17,0,1,1,2,5,2,9,16,0,1,0,1
4990,152752,2022,Iran,Japan,0,2,2,4,12/06/2022,1,0,1,2,4,1,1,6,0,2,4,6,3,5,5,13,1,0,1,2
4991,152752,2022,Iran,Australia,1,3,14,18,12/06/2022,1,0,1,2,10,2,8,20,3,1,4,8,6,2,14,22,3,2,2,7
4992,152752,2022,Netherlands,Iran,2,1,3,6,10/06/2022,0,0,0,0,3,0,1,4,0,3,2,5,4,0,5,9,3,1,1,5
4993,152752,2022,China,Iran,0,0,0,0,07/06/2022,0,0,0,0,0,0,0,0,0,0,0,0,0,0,0,0,0,0,0,0
4994,168551,2022,Poland,Iran,0,0,0,0,21/07/2022,0,0,1,1,0,0,0,0,0,0,0,0,0,0,0,0,0,0,0,0
4995,168551,2022,Iran,Serbia,0,0,0,0,09/07/2022,0,0,0,0,0,0,0,0,0,0,0,0,0,0,0,0,0,0,0,0
4996,168551,2022,Slovenia,Iran,0,0,0,0,08/07/2022,0,0,0,0,1,0,0,1,0,0,0,0,0,0,0,0,0,0,0,0
4997,168551,2022,Italy,Iran,0,0,0,0,07/07/2022,0,0,0,0,0,0,0,0,0,0,0,0,0,0,0,0,0,0,0,0
4998,168551,2022,Iran,Poland,0,0,0,0,05/07/2022,0,0,0,0,0,0,0,0,0,1,0,1,0,0,0,0,0,0,0,0
4999,168551,2022,Canada,Iran,0,0,0,0,25/06/2022,0,0,0,0,0,0,0,0,0,0,0,0,0,0,0,0,0,0,0,0
5000,168551,2022,Iran,Brazil,1,1,1,3,24/06/2022,0,0,0,0,1,0,4,5,0,1,0,1,0,0,0,0,1,1,0,2
5001,168551,2022,USA,Iran,0,0,0,0,23/06/2022,0,0,0,0,0,0,0,0,0,0,0,0,0,0,0,0,0,0,0,0
5002,168551,2022,Iran,Bulgaria,0,0,1,1,21/06/2022,0,0,0,0,2,0,0,2,0,0,0,0,0,0,0,0,0,0,0,0
5003,152755,2022,,,-,-,-,-,-,-,-,-,-,-,-,-,-,-,-,-,-,-,-,-,-,-,-,-,-
5004,189118,2022,Poland,Iran,0,0,1,1,21/07/2022,3,0,1,4,0,0,0,0,0,0,0,0,0,0,0,0,0,0,0,0
5005,189118,2022,Iran,Serbia,0,0,0,0,09/07/2022,0,0,0,0,0,0,0,0,0,0,0,0,0,0,0,0,0,0,0,0
5006,189118,2022,Slovenia,Iran,0,0,0,0,08/07/2022,0,0,0,0,0,0,0,0,0,0,0,0,0,0,0,0,0,0,0,0
5007,189118,2022,Italy,Iran,0,1,1,2,07/07/2022,1,0,22,23,0,0,1,1,0,0,0,0,0,0,0,0,0,0,0,0
5008,189118,2022,Iran,Poland,0,0,1,1,05/07/2022,0,0,1,1,0,0,0,0,0,0,0,0,0,0,0,0,0,0,0,0
5009,189175,2022,Poland,Iran,0,0,0,0,21/07/2022,0,0,0,0,0,0,0,0,0,0,0,0,0,0,0,0,0,0,0,0
5010,189175,2022,Iran,Serbia,0,0,0,0,09/07/2022,0,0,0,0,0,0,0,0,0,0,0,0,0,0,0,0,0,0,0,0
5011,189175,2022,Slovenia,Iran,0,0,0,0,08/07/2022,0,0,0,0,0,0,0,0,0,0,0,0,0,0,0,0,0,0,0,0
5012,189175,2022,Italy,Iran,0,1,0,1,07/07/2022,0,0,0,0,0,0,0,0,0,0,0,0,0,0,0,0,0,0,0,0
5013,189175,2022,Iran,Poland,0,0,0,0,05/07/2022,0,0,0,0,0,0,0,0,0,0,0,0,0,0,0,0,0,0,0,0
5014,189175,2022,Canada,Iran,0,0,0,0,25/06/2022,0,0,0,0,0,0,0,0,0,0,0,0,0,0,0,0,0,0,0,0
5015,189175,2022,Iran,Brazil,0,1,1,2,24/06/2022,0,0,0,0,0,0,1,1,0,1,0,1,0,0,0,0,0,0,0,0
5016,189175,2022,USA,Iran,0,0,0,0,23/06/2022,0,0,0,0,0,0,0,0,0,0,0,0,0,0,0,0,0,0,0,0
5017,189175,2022,Iran,Bulgaria,0,0,0,0,21/06/2022,0,0,0,0,0,0,0,0,0,0,0,0,0,0,0,0,0,0,0,0
5018,189175,2022,Iran,Japan,0,1,2,3,12/06/2022,0,1,0,1,1,1,1,3,0,2,3,5,0,0,1,1,0,1,0,1
5019,189175,2022,Iran,Australia,0,0,0,0,12/06/2022,0,0,0,0,0,0,0,0,0,0,0,0,0,0,0,0,0,0,0,0
5020,189175,2022,Netherlands,Iran,1,1,4,6,10/06/2022,0,0,0,0,4,0,2,6,0,4,4,8,0,0,0,0,1,0,0,1
5021,189175,2022,China,Iran,0,0,0,0,07/06/2022,0,0,0,0,0,0,0,0,0,0,0,0,0,0,0,0,0,0,0,0
5022,182187,2022,,,-,-,-,-,-,-,-,-,-,-,-,-,-,-,-,-,-,-,-,-,-,-,-,-,-
5023,152742,2022,Poland,Iran,0,1,2,3,21/07/2022,0,0,0,0,1,0,0,1,0,1,0,1,0,0,4,4,0,1,0,1
5024,152742,2022,Iran,Serbia,0,1,0,1,09/07/2022,0,0,0,0,0,0,0,0,0,0,0,0,0,0,3,3,0,0,0,0
5025,152742,2022,Slovenia,Iran,0,0,1,1,08/07/2022,0,0,0,0,0,0,0,0,0,0,0,0,0,0,0,0,0,0,0,0
5026,152742,2022,Italy,Iran,0,2,2,4,07/07/2022,0,0,0,0,3,4,3,10,1,1,0,2,1,0,13,14,4,0,0,4
5027,152742,2022,Iran,Poland,0,0,1,1,05/07/2022,0,0,0,0,0,0,0,0,0,0,0,0,0,0,0,0,0,0,0,0
5028,152742,2022,Canada,Iran,0,0,1,1,25/06/2022,0,0,0,0,0,0,0,0,0,0,0,0,0,0,0,0,0,0,0,0
5029,152742,2022,Iran,Brazil,1,1,2,4,24/06/2022,0,0,0,0,4,0,0,4,0,1,0,1,1,1,5,7,0,2,0,2
5030,152742,2022,USA,Iran,0,0,3,3,23/06/2022,0,0,0,0,0,0,0,0,0,0,0,0,0,0,0,0,1,0,0,1
5031,152742,2022,Iran,Bulgaria,1,4,5,10,21/06/2022,0,0,0,0,10,4,6,20,0,2,0,2,2,2,18,22,0,0,0,0
5032,152742,2022,Iran,Japan,1,3,1,5,12/06/2022,0,0,1,1,4,1,3,8,0,0,0,0,1,1,6,8,2,0,0,2
5033,152742,2022,Iran,Australia,0,0,0,0,12/06/2022,0,0,0,0,0,0,0,0,0,0,0,0,0,0,0,0,0,0,0,0
5034,152742,2022,Netherlands,Iran,0,2,5,7,10/06/2022,1,0,0,1,4,4,2,10,0,3,2,5,1,1,5,7,0,0,1,1
5035,152742,2022,China,Iran,4,3,12,19,07/06/2022,0,0,2,2,14,1,5,20,2,1,2,5,2,2,8,12,3,0,0,3
5036,162518,2022,Italy,China,2,3,7,12,26/06/2022,0,0,0,0,12,4,4,20,1,4,1,6,0,0,0,0,6,0,2,8
5037,162518,2022,Italy,Slovenia,0,2,2,4,25/06/2022,1,0,0,1,5,2,1,8,0,3,1,4,0,0,0,0,3,1,0,4
5038,162518,2022,Japan,Italy,0,0,0,0,24/06/2022,0,0,0,0,0,0,0,0,0,0,0,0,0,0,0,0,0,0,0,0
5039,162518,2022,Germany,Italy,0,1,3,4,22/06/2022,0,0,0,0,0,0,0,0,0,0,0,0,0,0,0,0,0,0,0,0
5040,162518,2022,Argentina,Italy,0,3,2,5,12/06/2022,0,0,2,2,9,3,11,23,0,0,4,4,0,0,0,0,0,3,1,4
5041,162518,2022,Canada,Italy,0,0,0,0,11/06/2022,0,0,0,0,0,1,0,1,0,0,0,0,0,0,0,0,0,0,0,0
5042,162518,2022,Poland,Italy,0,0,0,0,09/06/2022,0,0,0,0,0,0,0,0,0,0,0,0,0,0,0,0,0,0,0,0
5043,162518,2022,France,Italy,0,0,0,0,08/06/2022,0,0,0,0,0,0,0,0,0,0,0,0,0,0,0,0,0,0,0,0
5044,141638,2022,Italy,China,0,0,1,1,26/06/2022,0,0,0,0,0,0,0,0,0,0,0,0,0,0,0,0,0,0,0,0
5045,141638,2022,Italy,Slovenia,0,0,0,0,25/06/2022,0,0,0,0,0,0,0,0,0,0,0,0,0,0,0,0,0,0,0,0
5046,141638,2022,Japan,Italy,0,0,0,0,24/06/2022,0,0,0,0,0,0,0,0,0,0,0,0,0,0,0,0,0,0,0,0
5047,141638,2022,Germany,Italy,0,0,0,0,22/06/2022,0,0,0,0,0,0,0,0,0,0,0,0,0,0,0,0,0,0,0,0
5048,163033,2022,Italy,Poland,0,0,0,0,24/07/2022,0,0,0,0,0,0,0,0,0,0,0,0,0,0,0,0,0,0,0,0
5049,163033,2022,Italy,France,0,1,1,2,23/07/2022,0,0,0,0,0,0,2,2,0,0,0,0,1,1,1,3,1,0,0,1
5050,163033,2022,Italy,Netherlands,0,0,0,0,20/07/2022,0,0,0,0,0,0,0,0,0,0,0,0,0,0,0,0,0,0,0,0
5051,163033,2022,Argentina,Italy,0,4,15,19,12/06/2022,0,0,4,4,13,4,6,23,2,3,2,7,5,1,23,29,5,0,3,8
5052,163033,2022,Canada,Italy,0,2,7,9,11/06/2022,0,0,2,2,7,4,4,15,0,1,1,2,6,0,12,18,5,0,1,6
5053,163033,2022,Poland,Italy,0,2,14,16,09/06/2022,0,0,8,8,8,3,14,25,1,3,1,5,3,2,17,22,5,2,4,11
5054,163033,2022,France,Italy,1,3,9,13,08/06/2022,0,0,8,8,8,2,5,15,0,5,1,6,2,1,19,22,7,2,3,12
5055,152492,2022,Italy,Netherlands,0,0,0,0,10/07/2022,0,0,0,0,0,0,0,0,0,0,0,0,0,0,0,0,0,0,0,0
5056,152492,2022,Italy,Serbia,0,0,0,0,08/07/2022,0,0,0,0,0,0,0,0,0,0,0,0,0,0,0,0,0,0,0,0
5057,152492,2022,Italy,Iran,0,0,0,0,07/07/2022,0,0,0,0,0,0,0,0,0,0,0,0,0,0,0,0,0,0,0,0
5058,152492,2022,Bulgaria,Italy,0,0,0,0,05/07/2022,0,0,0,0,0,0,0,0,0,0,0,0,0,0,0,0,0,0,0,0
5059,152492,2022,Italy,China,0,0,0,0,26/06/2022,0,0,0,0,0,0,0,0,0,0,0,0,0,0,0,0,0,0,0,0
5060,152492,2022,Italy,Slovenia,0,0,0,0,25/06/2022,0,0,0,0,0,0,0,0,0,0,0,0,0,0,0,0,0,0,0,0
5061,152492,2022,Japan,Italy,0,0,0,0,24/06/2022,0,0,0,0,0,0,0,0,0,0,0,0,0,1,1,2,0,0,0,0
5062,152492,2022,Germany,Italy,0,0,0,0,22/06/2022,0,0,0,0,0,0,0,0,0,0,0,0,0,0,0,0,0,0,0,0
5063,171191,2022,Italy,Poland,1,3,7,11,24/07/2022,0,0,4,4,3,4,7,14,1,2,3,6,1,3,8,12,2,2,0,4
5064,171191,2022,Italy,France,1,1,11,13,23/07/2022,0,0,1,1,9,2,4,15,0,3,2,5,11,3,6,20,3,5,0,8
5065,171191,2022,Italy,Netherlands,1,2,11,14,20/07/2022,0,0,3,3,10,5,10,25,1,4,5,10,3,0,14,17,2,3,1,6
5066,171191,2022,Italy,Netherlands,3,2,12,17,10/07/2022,0,0,0,0,9,4,5,18,2,3,0,5,0,0,15,15,1,1,0,2
5067,171191,2022,Italy,Serbia,0,1,14,15,08/07/2022,0,0,0,0,7,4,6,17,0,3,0,3,2,0,6,8,5,0,1,6
5068,171191,2022,Italy,Iran,0,0,19,19,07/07/2022,0,0,0,0,11,1,10,22,0,2,0,2,3,2,23,28,4,1,0,5
5069,171191,2022,Bulgaria,Italy,1,1,13,15,05/07/2022,0,0,3,3,10,1,9,20,1,0,0,1,5,0,19,24,2,0,1,3
5070,171191,2022,Italy,China,1,2,8,11,26/06/2022,0,0,1,1,8,2,5,15,0,1,1,2,8,2,14,24,3,0,0,3
5071,171191,2022,Italy,Slovenia,1,2,10,13,25/06/2022,0,0,1,1,13,1,10,24,2,1,1,4,8,0,10,18,6,2,1,9
5072,171191,2022,Japan,Italy,0,6,8,14,24/06/2022,0,0,2,2,14,2,5,21,2,2,0,4,11,5,26,42,4,1,0,5
5073,171191,2022,Germany,Italy,1,1,8,10,22/06/2022,0,0,0,0,6,5,4,15,1,1,0,2,1,1,11,13,6,2,1,9
5074,144005,2022,Italy,Poland,0,1,7,8,24/07/2022,9,0,60,69,1,0,3,4,0,6,2,8,0,0,0,0,8,1,0,9
5075,144005,2022,Italy,France,0,0,11,11,23/07/2022,14,0,38,52,0,0,1,1,0,4,1,5,0,0,1,1,3,2,0,5
5076,144005,2022,Italy,Netherlands,0,1,20,21,20/07/2022,16,1,67,84,1,0,1,2,2,7,2,11,0,0,2,2,5,1,1,7
5077,144005,2022,Italy,Netherlands,0,4,9,13,10/07/2022,11,0,58,69,1,0,0,1,0,2,0,2,0,0,1,1,1,0,0,1
5078,144005,2022,Italy,Serbia,0,1,9,10,08/07/2022,13,0,51,64,2,0,2,4,3,1,0,4,0,0,0,0,0,2,0,2
5079,144005,2022,Italy,Iran,3,2,11,16,07/07/2022,26,0,70,96,2,1,1,4,2,3,0,5,0,0,2,2,2,2,0,4
5080,144005,2022,Bulgaria,Italy,3,1,10,14,05/07/2022,7,1,51,59,2,0,0,2,2,1,0,3,0,0,1,1,2,0,0,2
5081,144005,2022,Italy,China,1,2,9,12,26/06/2022,16,1,40,57,1,0,1,2,3,0,3,6,0,0,0,0,2,1,1,4
5082,144005,2022,Italy,Slovenia,1,2,10,13,25/06/2022,20,0,43,63,4,0,0,4,0,4,0,4,0,0,0,0,6,1,0,7
5083,144005,2022,Japan,Italy,1,2,20,23,24/06/2022,31,0,60,91,4,0,1,5,3,0,4,7,0,0,0,0,6,1,2,9
5084,144005,2022,Germany,Italy,0,2,8,10,22/06/2022,16,0,38,54,0,0,0,0,1,2,2,5,0,0,0,0,5,1,2,8
5085,144005,2022,Argentina,Italy,1,2,12,15,12/06/2022,52,0,35,87,1,0,3,4,1,2,3,6,0,0,0,0,6,7,2,15
5086,144005,2022,Canada,Italy,1,4,14,19,11/06/2022,0,0,71,71,6,0,0,6,2,1,1,4,0,0,0,0,5,1,0,6
5087,144005,2022,Poland,Italy,0,5,11,16,09/06/2022,32,0,38,70,4,0,4,8,0,3,4,7,0,0,0,0,6,2,4,12
5088,144005,2022,France,Italy,1,3,8,12,08/06/2022,45,1,22,68,0,1,2,3,4,4,1,9,0,0,0,0,8,3,1,12
5089,150436,2022,Italy,Poland,0,0,0,0,24/07/2022,0,0,7,7,0,0,0,0,0,0,0,0,3,6,10,19,13,3,2,18
5090,150436,2022,Italy,France,0,0,0,0,23/07/2022,0,0,4,4,0,0,0,0,0,0,0,0,6,1,11,18,7,2,1,10
5091,150436,2022,Italy,Netherlands,0,0,0,0,20/07/2022,0,0,4,4,0,0,0,0,0,0,0,0,3,3,18,24,15,1,0,16
5092,150436,2022,Italy,Netherlands,0,0,0,0,10/07/2022,0,0,0,0,0,0,0,0,0,0,0,0,0,0,0,0,0,0,0,0
5093,150436,2022,Italy,Serbia,0,0,0,0,08/07/2022,0,0,0,0,0,0,0,0,0,0,0,0,2,1,4,7,3,0,0,3
5094,150436,2022,Italy,Iran,0,0,0,0,07/07/2022,0,0,4,4,0,0,0,0,0,0,0,0,7,1,12,20,5,3,1,9
5095,150436,2022,Bulgaria,Italy,0,0,0,0,05/07/2022,0,0,4,4,0,0,0,0,0,0,0,0,1,1,11,13,3,3,1,7
5096,150436,2022,Italy,China,0,0,0,0,26/06/2022,0,0,1,1,0,0,0,0,0,0,0,0,4,0,5,9,9,2,1,12
5097,150436,2022,Italy,Slovenia,0,0,0,0,25/06/2022,0,1,6,7,0,0,0,0,0,0,0,0,3,0,3,6,7,1,2,10
5098,150436,2022,Japan,Italy,0,0,0,0,24/06/2022,1,0,7,8,0,0,0,0,0,0,0,0,6,3,13,22,8,2,1,11
5099,150436,2022,Germany,Italy,0,0,0,0,22/06/2022,0,0,4,4,0,0,0,0,0,0,0,0,4,2,11,17,6,2,0,8
5100,152370,2022,Italy,Poland,0,1,3,4,24/07/2022,0,0,0,0,0,0,0,0,0,0,0,0,0,0,0,0,0,0,0,0
5101,152370,2022,Italy,France,0,0,2,2,23/07/2022,5,0,8,13,0,0,0,0,0,2,0,2,0,0,0,0,0,0,0,0
5102,152370,2022,Italy,Netherlands,0,0,0,0,20/07/2022,0,0,0,0,0,0,0,0,0,0,0,0,0,0,0,0,0,0,0,0
5103,152370,2022,Italy,Netherlands,0,0,3,3,10/07/2022,0,0,4,4,0,0,0,0,0,0,0,0,0,0,0,0,0,0,0,0
5104,152370,2022,Italy,Serbia,0,0,0,0,08/07/2022,1,1,5,7,0,0,0,0,0,0,0,0,0,0,0,0,0,0,0,0
5105,152370,2022,Italy,Iran,0,1,1,2,07/07/2022,0,0,1,1,0,0,0,0,0,0,0,0,0,0,0,0,0,0,0,0
5106,152370,2022,Bulgaria,Italy,0,0,1,1,05/07/2022,0,0,0,0,0,0,0,0,0,0,0,0,0,0,0,0,0,0,0,0
5107,152370,2022,Italy,China,0,1,1,2,26/06/2022,3,0,8,11,0,0,0,0,1,1,0,2,0,0,0,0,0,0,0,0
5108,152370,2022,Italy,Slovenia,0,0,3,3,25/06/2022,1,0,9,10,0,0,0,0,0,2,1,3,0,0,0,0,0,0,0,0
5109,152370,2022,Japan,Italy,0,0,5,5,24/06/2022,0,0,0,0,0,0,0,0,0,0,0,0,0,0,0,0,0,0,0,0
5110,152370,2022,Germany,Italy,0,0,0,0,22/06/2022,0,0,0,0,0,0,0,0,0,0,0,0,0,0,0,0,0,0,0,0
5111,120511,2022,Italy,Poland,0,0,0,0,24/07/2022,0,0,0,0,0,0,0,0,0,0,0,0,0,0,0,0,0,0,0,0
5112,120511,2022,Italy,France,0,1,1,2,23/07/2022,0,0,1,1,5,2,2,9,0,2,1,3,1,1,1,3,0,1,0,1
5113,120511,2022,Italy,Netherlands,0,1,1,2,20/07/2022,0,0,0,0,1,0,0,1,0,0,0,0,0,0,0,0,2,0,0,2
5114,120511,2022,Italy,Netherlands,0,4,7,11,10/07/2022,0,0,0,0,11,5,8,24,0,4,0,4,0,0,2,2,2,1,0,3
5115,120511,2022,Italy,Serbia,0,0,0,0,08/07/2022,0,0,0,0,0,0,0,0,0,0,0,0,0,0,0,0,0,0,0,0
5116,120511,2022,Italy,Iran,1,5,9,15,07/07/2022,0,0,1,1,14,5,11,30,2,2,0,4,0,0,3,3,3,0,2,5
5117,120511,2022,Bulgaria,Italy,0,0,0,0,05/07/2022,0,0,0,0,0,0,0,0,0,0,0,0,0,0,0,0,0,0,0,0
5118,115843,2022,Argentina,Italy,0,1,2,3,12/06/2022,5,1,4,10,0,0,0,0,0,0,1,1,0,0,0,0,0,0,0,0
5119,115843,2022,Canada,Italy,0,0,0,0,11/06/2022,0,0,0,0,0,0,0,0,0,0,0,0,0,0,0,0,0,0,0,0
5120,115843,2022,Poland,Italy,0,0,0,0,09/06/2022,0,0,0,0,0,0,0,0,0,0,0,0,0,0,0,0,0,0,0,0
5121,115843,2022,France,Italy,0,0,0,0,08/06/2022,0,0,0,0,0,0,0,0,0,0,0,0,0,0,0,0,0,0,0,0
5122,152422,2022,Argentina,Italy,0,0,0,0,12/06/2022,0,0,0,0,0,0,0,0,0,0,0,0,0,0,0,0,0,0,0,0
5123,152422,2022,Canada,Italy,0,0,0,0,11/06/2022,0,0,0,0,0,0,0,0,0,0,0,0,0,0,0,0,0,0,0,0
5124,152422,2022,Poland,Italy,0,0,0,0,09/06/2022,0,0,0,0,0,0,0,0,0,0,0,0,0,0,0,0,0,0,0,0
5125,152422,2022,France,Italy,0,1,2,3,08/06/2022,0,0,1,1,0,1,7,8,0,0,2,2,0,2,6,8,1,1,0,2
5126,163447,2022,Italy,Poland,0,0,0,0,24/07/2022,0,0,0,0,0,0,0,0,0,0,0,0,0,0,0,0,0,0,0,0
5127,163447,2022,Italy,France,0,0,1,1,23/07/2022,0,0,1,1,0,1,1,2,0,0,0,0,1,1,1,3,0,2,0,2
5128,163447,2022,Italy,Netherlands,0,0,0,0,20/07/2022,0,0,0,0,0,0,0,0,0,0,0,0,0,1,0,1,0,0,0,0
5129,163447,2022,Italy,Netherlands,0,0,0,0,10/07/2022,0,0,0,0,0,0,0,0,0,0,0,0,0,0,0,0,0,0,0,0
5130,163447,2022,Italy,Serbia,0,0,0,0,08/07/2022,0,0,0,0,0,0,0,0,0,0,0,0,0,0,0,0,0,0,0,0
5131,163447,2022,Italy,Iran,2,2,4,8,07/07/2022,0,0,1,1,2,3,5,10,0,0,0,0,1,1,6,8,2,0,0,2
5132,163447,2022,Bulgaria,Italy,0,0,0,0,05/07/2022,0,0,0,0,0,0,0,0,0,0,0,0,0,0,0,0,0,0,0,0
5133,163447,2022,Italy,China,0,1,1,2,26/06/2022,0,0,0,0,2,1,2,5,0,2,2,4,0,0,6,6,0,0,0,0
5134,163447,2022,Italy,Slovenia,0,0,0,0,25/06/2022,0,0,0,0,0,0,0,0,0,0,0,0,0,0,0,0,0,0,0,0
5135,163447,2022,Japan,Italy,0,1,2,3,24/06/2022,0,0,0,0,0,0,0,0,0,1,0,1,1,1,1,3,0,2,0,2
5136,163447,2022,Germany,Italy,0,0,0,0,22/06/2022,0,0,0,0,0,0,0,0,0,0,0,0,0,0,0,0,0,0,0,0
5137,163447,2022,Argentina,Italy,4,4,11,19,12/06/2022,0,0,1,1,14,4,12,30,3,5,5,13,5,1,18,24,4,2,4,10
5138,163447,2022,Canada,Italy,1,4,9,14,11/06/2022,0,0,2,2,11,5,9,25,1,1,2,4,0,0,13,13,8,0,0,8
5139,163447,2022,Poland,Italy,2,3,15,20,09/06/2022,1,0,5,6,13,4,1,18,1,2,0,3,7,1,19,27,1,0,2,3
5140,163447,2022,France,Italy,0,2,7,9,08/06/2022,0,0,0,0,3,5,10,18,0,2,2,4,1,0,13,14,2,2,0,4
5141,163028,2022,Italy,Poland,0,0,0,0,24/07/2022,0,0,0,0,0,0,0,0,0,0,0,0,0,0,0,0,0,0,0,0
5142,163028,2022,Italy,France,0,0,0,0,23/07/2022,0,0,0,0,0,0,0,0,0,0,0,0,0,0,0,0,0,0,0,0
5143,163028,2022,Italy,Netherlands,0,0,0,0,20/07/2022,0,0,0,0,0,0,0,0,0,0,0,0,0,0,0,0,0,0,0,0
5144,163028,2022,Italy,Netherlands,0,0,0,0,10/07/2022,0,0,0,0,0,0,0,0,0,0,0,0,0,0,0,0,0,0,0,0
5145,163028,2022,Italy,Serbia,0,0,3,3,08/07/2022,0,0,0,0,3,0,4,7,2,5,0,7,0,0,0,0,0,1,0,1
5146,163028,2022,Italy,Iran,0,0,0,0,07/07/2022,0,0,0,0,0,0,0,0,0,0,0,0,0,0,0,0,0,0,0,0
5147,163028,2022,Bulgaria,Italy,0,0,0,0,05/07/2022,0,0,0,0,0,0,0,0,0,0,0,0,0,0,0,0,0,0,0,0
5148,163028,2022,Argentina,Italy,0,0,0,0,12/06/2022,0,0,0,0,0,0,0,0,0,0,0,0,0,0,0,0,0,0,0,0
5149,163028,2022,Canada,Italy,0,0,0,0,11/06/2022,0,0,0,0,0,0,0,0,0,0,0,0,0,0,0,0,0,0,0,0
5150,163028,2022,Poland,Italy,0,2,4,6,09/06/2022,0,0,0,0,2,0,4,6,0,2,0,2,0,0,0,0,0,0,2,2
5151,163028,2022,France,Italy,0,3,5,8,08/06/2022,0,0,1,1,5,1,2,8,0,3,4,7,0,0,2,2,2,0,1,3
5152,152408,2022,Italy,Poland,0,2,2,4,24/07/2022,0,0,1,1,2,1,3,6,1,1,4,6,0,0,1,1,0,0,0,0
5153,152408,2022,Italy,France,1,2,5,8,23/07/2022,0,0,0,0,5,0,1,6,0,2,4,6,0,0,0,0,0,0,0,0
5154,152408,2022,Italy,Netherlands,1,0,2,3,20/07/2022,0,0,0,0,4,0,3,7,2,2,2,6,0,0,0,0,1,0,0,1
5155,152408,2022,Italy,Netherlands,1,2,2,5,10/07/2022,0,0,0,0,3,0,2,5,2,2,0,4,0,0,0,0,0,0,0,0
5156,152408,2022,Italy,Serbia,0,2,4,6,08/07/2022,0,0,1,1,3,0,2,5,3,3,0,6,0,0,0,0,0,0,0,0
5157,152408,2022,Italy,Iran,2,2,13,17,07/07/2022,0,0,0,0,9,0,1,10,2,3,0,5,0,0,0,0,0,0,0,0
5158,152408,2022,Bulgaria,Italy,0,0,4,4,05/07/2022,0,0,0,0,0,0,0,0,0,0,0,0,0,0,0,0,0,0,1,1
5159,152408,2022,Italy,China,0,3,5,8,26/06/2022,0,0,0,0,3,0,4,7,1,5,4,10,0,0,1,1,2,1,0,3
5160,152408,2022,Italy,Slovenia,1,3,5,9,25/06/2022,1,0,1,2,5,1,3,9,1,2,2,5,0,0,0,0,1,0,0,1
5161,152408,2022,Japan,Italy,1,4,8,13,24/06/2022,0,0,0,0,6,0,5,11,1,8,5,14,1,0,0,1,2,1,1,4
5162,152408,2022,Germany,Italy,0,3,6,9,22/06/2022,0,0,0,0,7,0,1,8,4,6,2,12,0,0,0,0,1,1,0,2
5163,152408,2022,Argentina,Italy,0,2,5,7,12/06/2022,0,0,0,0,3,3,2,8,2,2,2,6,0,0,0,0,0,1,1,2
5164,152408,2022,Canada,Italy,0,0,10,10,11/06/2022,0,0,0,0,5,2,0,7,1,2,1,4,0,0,2,2,1,0,0,1
5165,152408,2022,Poland,Italy,2,2,3,7,09/06/2022,0,0,0,0,2,2,3,7,1,5,3,9,0,0,0,0,0,0,4,4
5166,152408,2022,France,Italy,0,1,6,7,08/06/2022,0,0,1,1,3,1,4,8,0,2,4,6,0,0,2,2,0,0,4,4
5167,153200,2022,Italy,Poland,0,1,10,11,24/07/2022,1,0,4,5,14,3,16,33,0,0,1,1,6,0,14,20,6,4,0,10
5168,153200,2022,Italy,France,0,0,6,6,23/07/2022,0,0,1,1,4,2,11,17,2,3,1,6,0,4,5,9,2,1,0,3
5169,153200,2022,Italy,Netherlands,1,1,14,16,20/07/2022,1,0,2,3,10,1,12,23,2,5,0,7,6,2,9,17,10,1,1,12
5170,153200,2022,Italy,Netherlands,0,0,15,15,10/07/2022,0,0,0,0,15,3,7,25,0,2,0,2,0,3,11,14,2,1,0,3
5171,153200,2022,Italy,Serbia,2,1,15,18,08/07/2022,0,0,0,0,7,3,7,17,1,1,0,2,5,1,26,32,1,1,1,3
5172,153200,2022,Italy,Iran,0,2,8,10,07/07/2022,0,0,1,1,11,5,8,24,0,3,0,3,2,4,6,12,2,1,0,3
5173,153200,2022,Bulgaria,Italy,0,1,11,12,05/07/2022,0,0,0,0,10,1,7,18,2,3,1,6,1,0,8,9,3,1,2,6
5174,153200,2022,Italy,China,3,2,12,17,26/06/2022,0,0,2,2,16,1,6,23,3,3,0,6,4,0,2,6,5,0,0,5
5175,153200,2022,Italy,Slovenia,2,2,10,14,25/06/2022,0,0,2,2,12,2,10,24,0,2,0,2,5,0,19,24,2,0,2,4
5176,153200,2022,Japan,Italy,1,3,14,18,24/06/2022,0,0,1,1,18,2,11,31,3,5,6,14,7,4,15,26,1,1,1,3
5177,153200,2022,Germany,Italy,0,1,11,12,22/06/2022,0,0,1,1,8,2,8,18,1,2,0,3,2,0,11,13,1,0,0,1
5178,162520,2022,Italy,Poland,0,4,8,12,24/07/2022,0,0,1,1,12,5,11,28,0,1,0,1,,,,,4,1,0,5
5179,162520,2022,Italy,France,0,3,2,5,23/07/2022,0,0,0,0,6,1,8,15,0,1,0,1,,,,,6,1,0,7
5180,162520,2022,Italy,Netherlands,4,0,12,16,20/07/2022,0,0,1,1,12,6,8,26,0,7,5,12,,,,,1,2,0,3
5181,162520,2022,Italy,Netherlands,0,0,0,0,10/07/2022,0,0,0,0,0,0,0,0,0,0,0,0,,,,,0,0,0,0
5182,162520,2022,Italy,Serbia,3,3,8,14,08/07/2022,0,0,1,1,9,3,7,19,1,2,0,3,,,,,1,0,0,1
5183,162520,2022,Italy,Iran,0,0,0,0,07/07/2022,0,0,0,0,0,0,0,0,0,0,0,0,,,,,0,0,0,0
5184,162520,2022,Bulgaria,Italy,1,3,8,12,05/07/2022,0,0,1,1,10,3,7,20,2,2,0,4,,,,,0,0,0,0
5185,162520,2022,Italy,China,0,0,0,0,26/06/2022,0,0,0,0,0,0,0,0,0,0,0,0,,,,,0,0,0,0
5186,162520,2022,Italy,Slovenia,1,1,3,5,25/06/2022,0,0,0,0,4,2,4,10,1,1,0,2,,,,,7,1,0,8
5187,162520,2022,Japan,Italy,0,6,8,14,24/06/2022,0,0,0,0,14,3,11,28,2,3,3,8,,,,,7,1,0,8
5188,162520,2022,Germany,Italy,2,4,10,16,22/06/2022,0,0,0,0,10,2,4,16,1,2,5,8,,,,,2,3,0,5
5189,162520,2022,Argentina,Italy,0,3,2,5,12/06/2022,0,0,1,1,2,2,8,12,2,2,2,6,,,,,1,1,1,3
5190,162520,2022,Canada,Italy,1,2,6,9,11/06/2022,0,0,0,0,11,3,8,22,1,1,1,3,,,,,2,0,0,2
5191,162520,2022,Poland,Italy,0,6,10,16,09/06/2022,1,0,1,2,16,5,9,30,0,7,1,8,,,,,7,1,1,9
5192,162520,2022,France,Italy,0,4,9,13,08/06/2022,0,0,2,2,14,5,13,32,2,1,0,3,,,,,3,1,5,9
5193,124865,2022,Italy,Poland,0,0,8,8,24/07/2022,0,0,0,0,1,0,5,6,0,6,2,8,0,0,0,0,2,0,0,2
5194,124865,2022,Italy,France,0,0,1,1,23/07/2022,0,0,0,0,0,0,0,0,1,2,1,4,0,0,0,0,1,0,0,1
5195,124865,2022,Italy,Netherlands,0,1,4,5,20/07/2022,0,0,0,0,0,1,1,2,2,1,2,5,0,0,0,0,0,1,0,1
5196,124865,2022,Italy,Netherlands,0,0,7,7,10/07/2022,0,0,0,0,3,0,0,3,2,1,0,3,0,0,1,1,0,0,0,0
5197,124865,2022,Italy,Serbia,0,0,0,0,08/07/2022,0,0,0,0,0,0,0,0,0,0,0,0,0,0,0,0,0,0,0,0
5198,124865,2022,Italy,Iran,0,2,10,12,07/07/2022,0,0,0,0,6,1,2,9,4,5,0,9,0,0,0,0,1,0,1,2
5199,124865,2022,Bulgaria,Italy,0,1,5,6,05/07/2022,0,0,0,0,2,0,2,4,1,2,0,3,0,1,0,1,1,0,0,1
5200,124865,2022,Italy,China,0,1,8,9,26/06/2022,0,0,2,2,3,0,0,3,2,2,3,7,1,1,0,2,1,0,0,1
5201,124865,2022,Italy,Slovenia,0,1,11,12,25/06/2022,0,0,2,2,6,1,2,9,1,1,7,9,0,0,0,0,3,0,0,3
5202,124865,2022,Japan,Italy,0,1,13,14,24/06/2022,0,0,2,2,7,0,3,10,3,7,9,19,0,0,0,0,1,2,2,5
5203,124865,2022,Germany,Italy,1,1,11,13,22/06/2022,0,0,0,0,4,1,0,5,4,2,2,8,0,0,0,0,1,3,1,5
5204,163032,2022,Argentina,Italy,0,0,0,0,12/06/2022,0,0,0,0,0,0,0,0,0,0,0,0,0,0,0,0,0,0,0,0
5205,163032,2022,Canada,Italy,0,0,0,0,11/06/2022,0,0,0,0,0,0,0,0,0,0,0,0,0,0,0,0,0,0,0,0
5206,163032,2022,Poland,Italy,0,0,0,0,09/06/2022,0,0,0,0,0,0,0,0,0,0,0,0,0,0,0,0,0,0,0,0
5207,163032,2022,France,Italy,0,0,0,0,08/06/2022,0,0,0,0,0,0,0,0,0,0,0,0,0,0,0,0,0,0,0,0
5208,152405,2022,Italy,Poland,0,0,2,2,24/07/2022,0,0,1,1,0,1,0,1,0,1,2,3,0,0,0,0,2,0,0,2
5209,152405,2022,Italy,France,0,1,7,8,23/07/2022,0,0,0,0,3,1,2,6,0,4,0,4,0,0,0,0,1,0,0,1
5210,152405,2022,Italy,Netherlands,0,1,17,18,20/07/2022,0,0,0,0,9,0,2,11,3,9,1,13,1,0,0,1,2,1,0,3
5211,152405,2022,Italy,Netherlands,0,1,3,4,10/07/2022,0,0,0,0,2,0,0,2,0,3,1,4,0,0,0,0,0,0,0,0
5212,152405,2022,Italy,Serbia,1,2,5,8,08/07/2022,0,0,0,0,5,0,3,8,4,4,0,8,0,0,0,0,0,0,0,0
5213,152405,2022,Italy,Iran,0,0,0,0,07/07/2022,0,0,0,0,0,0,0,0,0,0,0,0,0,0,0,0,0,0,0,0
5214,152405,2022,Bulgaria,Italy,1,2,7,10,05/07/2022,0,0,1,1,3,0,3,6,3,5,0,8,0,0,0,0,0,0,0,0
5215,172961,2022,,,-,-,-,-,-,-,-,-,-,-,-,-,-,-,-,-,-,-,-,-,-,-,-,-,-
5216,152412,2022,Italy,China,0,0,0,0,26/06/2022,0,0,0,0,0,0,0,0,0,0,0,0,1,0,3,4,2,0,0,2
5217,152412,2022,Italy,Slovenia,0,0,0,0,25/06/2022,0,0,0,0,0,0,0,0,0,0,0,0,0,0,0,0,0,0,0,0
5218,152412,2022,Japan,Italy,0,0,0,0,24/06/2022,0,0,0,0,0,0,0,0,0,0,0,0,0,0,0,0,0,0,0,0
5219,152412,2022,Germany,Italy,0,0,0,0,22/06/2022,0,0,0,0,0,0,0,0,0,0,0,0,0,0,0,0,0,0,0,0
5220,152412,2022,Argentina,Italy,0,0,0,0,12/06/2022,0,0,4,4,0,0,0,0,0,0,0,0,9,0,11,20,17,5,5,27
5221,152412,2022,Canada,Italy,0,0,0,0,11/06/2022,0,0,2,2,0,0,0,0,0,0,0,0,8,0,11,19,7,0,1,8
5222,152412,2022,Poland,Italy,0,0,0,0,09/06/2022,0,1,6,7,0,0,0,0,0,0,0,0,5,1,9,15,5,5,3,13
5223,152412,2022,France,Italy,0,0,0,0,08/06/2022,0,0,13,13,0,0,0,0,0,0,0,0,1,1,9,11,8,0,3,11
5224,172965,2022,,,-,-,-,-,-,-,-,-,-,-,-,-,-,-,-,-,-,-,-,-,-,-,-,-,-
5225,181128,2022,Italy,Poland,0,0,0,0,24/07/2022,0,0,0,0,0,0,0,0,0,0,0,0,0,0,3,3,1,1,0,2
5226,181128,2022,Italy,France,0,0,0,0,23/07/2022,0,0,0,0,0,0,0,0,0,0,0,0,0,0,0,0,0,0,0,0
5227,181128,2022,Italy,Netherlands,0,0,0,0,20/07/2022,0,0,0,0,0,0,0,0,0,0,0,0,0,0,0,0,0,0,0,0
5228,181128,2022,Italy,Netherlands,0,0,0,0,10/07/2022,0,0,1,1,0,0,0,0,0,0,0,0,0,1,15,16,8,1,0,9
5229,181128,2022,Italy,Serbia,0,0,0,0,08/07/2022,0,0,0,0,0,0,0,0,0,0,0,0,0,0,4,4,0,0,2,2
5230,181128,2022,Italy,Iran,0,0,0,0,07/07/2022,0,0,0,0,0,0,0,0,0,0,0,0,0,0,0,0,1,1,1,3
5231,181128,2022,Bulgaria,Italy,0,0,0,0,05/07/2022,0,0,0,0,0,0,0,0,0,0,0,0,0,0,0,0,0,0,0,0
5232,181128,2022,Argentina,Italy,0,0,0,0,12/06/2022,0,0,0,0,0,0,0,0,0,0,0,0,0,0,0,0,0,0,0,0
5233,181128,2022,Canada,Italy,0,0,0,0,11/06/2022,0,0,0,0,0,0,0,0,0,0,0,0,0,0,0,0,0,0,0,0
5234,181128,2022,Poland,Italy,0,0,0,0,09/06/2022,0,0,0,0,0,0,0,0,0,0,0,0,0,0,0,0,0,0,0,0
5235,181128,2022,France,Italy,0,0,0,0,08/06/2022,0,0,1,1,0,0,0,0,0,0,0,0,0,0,0,0,1,0,0,1
5236,150435,2022,Argentina,Italy,2,2,14,18,12/06/2022,1,0,2,3,5,2,5,12,2,6,7,15,0,0,0,0,3,0,0,3
5237,150435,2022,Canada,Italy,0,0,0,0,11/06/2022,0,0,0,0,0,0,0,0,0,0,0,0,0,0,0,0,0,0,0,0
5238,150435,2022,Poland,Italy,1,2,7,10,09/06/2022,0,0,0,0,2,0,1,3,0,4,1,5,0,0,0,0,0,0,2,2
5239,150435,2022,France,Italy,0,1,1,2,08/06/2022,0,0,0,0,1,0,0,1,0,1,2,3,0,0,0,0,0,0,2,2
5240,174074,2022,Japan,Italy,0,0,0,0,24/06/2022,0,0,0,0,0,0,0,0,0,0,0,0,0,0,0,0,0,0,0,0
5241,174074,2022,Germany,Italy,0,0,0,0,22/06/2022,0,0,0,0,0,0,0,0,0,0,0,0,0,0,0,0,0,0,0,0
5242,174074,2022,Argentina,Italy,0,1,3,4,12/06/2022,0,0,0,0,1,0,0,1,1,0,0,1,0,0,1,1,1,0,0,1
5243,174074,2022,Canada,Italy,0,0,12,12,11/06/2022,0,0,0,0,7,2,0,9,2,4,5,11,0,0,0,0,2,1,0,3
5244,174074,2022,Poland,Italy,0,0,4,4,09/06/2022,0,0,1,1,1,0,1,2,2,1,5,8,0,0,0,0,1,1,0,2
5245,174074,2022,France,Italy,0,0,0,0,08/06/2022,0,0,0,0,0,0,0,0,0,0,0,0,0,0,0,0,0,0,0,0
5246,163519,2022,France,Japan,2,5,4,11,21/07/2022,0,0,0,0,6,5,11,22,0,3,1,4,0,0,0,0,3,4,0,7
5247,163519,2022,Brazil,Japan,1,6,6,13,10/07/2022,0,0,0,0,15,6,8,29,1,2,2,5,1,0,0,1,0,0,2,2
5248,163519,2022,Germany,Japan,0,0,1,1,09/07/2022,0,0,0,0,0,0,1,1,1,0,0,1,0,0,0,0,0,1,0,1
5249,163519,2022,Japan,Canada,1,6,8,15,08/07/2022,0,0,0,0,16,2,11,29,1,5,3,9,0,0,0,0,5,5,2,12
5250,163519,2022,Japan,Australia,6,7,8,21,06/07/2022,0,0,0,0,17,4,1,22,1,2,3,6,0,0,0,0,4,1,0,5
5251,163519,2022,Japan,Slovenia,2,4,10,16,26/06/2022,0,0,1,1,10,5,10,25,0,6,3,9,0,0,0,0,2,2,0,4
5252,163519,2022,Japan,France,0,0,0,0,25/06/2022,0,0,0,0,0,0,0,0,0,0,0,0,0,0,0,0,0,0,0,0
5253,163519,2022,Japan,Italy,5,5,6,16,24/06/2022,0,0,2,2,22,9,9,40,1,6,2,9,0,0,1,1,4,3,0,7
5254,163519,2022,Argentina,Japan,3,5,9,17,21/06/2022,0,0,1,1,20,4,11,35,2,4,3,9,0,0,0,0,6,2,1,9
5255,163519,2022,Iran,Japan,5,4,6,15,12/06/2022,1,0,0,1,11,3,8,22,1,1,1,3,0,0,0,0,3,0,0,3
5256,163519,2022,Japan,USA,0,0,0,0,10/06/2022,0,0,0,0,0,0,0,0,0,0,0,0,0,0,0,0,0,0,0,0
5257,163519,2022,Japan,China,3,7,8,18,09/06/2022,0,0,0,0,22,7,4,33,1,2,0,3,0,0,0,0,3,1,1,5
5258,163519,2022,Japan,Netherlands,1,5,10,16,08/06/2022,1,0,1,2,23,7,7,37,1,4,0,5,0,0,0,0,3,3,0,6
5259,142565,2022,France,Japan,1,2,10,13,21/07/2022,0,0,1,1,5,0,1,6,1,3,1,5,0,0,1,1,1,1,0,2
5260,142565,2022,Brazil,Japan,0,1,8,9,10/07/2022,0,0,0,0,3,1,3,7,0,1,3,4,0,0,3,3,3,4,3,10
5261,142565,2022,Germany,Japan,0,4,13,17,09/07/2022,0,0,1,1,5,0,3,8,1,5,6,12,1,0,1,2,2,0,0,2
5262,142565,2022,Japan,Canada,0,0,10,10,08/07/2022,0,0,1,1,9,1,2,12,1,4,2,7,1,1,2,4,2,2,0,4
5263,142565,2022,Japan,Australia,0,1,7,8,06/07/2022,0,0,0,0,0,0,0,0,0,0,0,0,0,0,0,0,0,0,0,0
5264,142565,2022,Japan,Slovenia,0,0,2,2,26/06/2022,0,0,0,0,0,0,0,0,0,0,0,0,0,0,0,0,1,0,0,1
5265,142565,2022,Japan,France,0,0,0,0,25/06/2022,0,0,0,0,0,0,0,0,0,0,0,0,0,0,0,0,0,0,0,0
5266,142565,2022,Japan,Italy,1,1,20,22,24/06/2022,0,0,1,1,5,1,3,9,0,3,2,5,2,0,1,3,5,1,2,8
5267,142565,2022,Argentina,Japan,2,2,11,15,21/06/2022,0,0,0,0,5,0,5,10,2,2,3,7,0,0,1,1,4,0,1,5
5268,142565,2022,Iran,Japan,0,1,4,5,12/06/2022,0,0,0,0,2,1,1,4,2,3,2,7,1,0,1,2,4,1,0,5
5269,142565,2022,Japan,USA,0,1,11,12,10/06/2022,0,1,0,1,5,1,2,8,0,3,2,5,1,0,0,1,2,2,1,5
5270,142565,2022,Japan,China,0,0,0,0,09/06/2022,0,0,0,0,0,0,0,0,0,0,0,0,0,0,0,0,0,0,0,0
5271,142565,2022,Japan,Netherlands,1,2,15,18,08/06/2022,0,1,1,2,4,2,3,9,2,5,6,13,2,0,4,6,3,0,1,4
5272,118822,2022,,,-,-,-,-,-,-,-,-,-,-,-,-,-,-,-,-,-,-,-,-,-,-,-,-,-
5273,142575,2022,,,-,-,-,-,-,-,-,-,-,-,-,-,-,-,-,-,-,-,-,-,-,-,-,-,-
5274,163516,2022,France,Japan,0,1,6,7,21/07/2022,0,0,2,2,5,4,5,14,0,3,1,4,2,0,12,14,2,3,0,5
5275,163516,2022,Brazil,Japan,1,0,8,9,10/07/2022,0,0,2,2,3,1,3,7,1,0,1,2,3,0,11,14,4,0,0,4
5276,163516,2022,Germany,Japan,0,0,0,0,09/07/2022,0,0,0,0,0,0,0,0,0,0,0,0,0,0,0,0,0,0,0,0
5277,163516,2022,Japan,Canada,1,2,13,16,08/07/2022,0,0,2,2,8,0,12,20,0,5,1,6,7,3,11,21,4,3,3,10
5278,163516,2022,Japan,Australia,0,0,13,13,06/07/2022,1,0,1,2,11,2,6,19,0,2,1,3,9,0,14,23,2,3,1,6
5279,163516,2022,Japan,Slovenia,0,3,10,13,26/06/2022,0,0,3,3,13,3,6,22,0,0,2,2,10,1,26,37,8,2,0,10
5280,163516,2022,Japan,France,0,2,5,7,25/06/2022,0,1,0,1,15,6,13,34,0,0,3,3,0,0,0,0,5,1,1,7
5281,163516,2022,Japan,Italy,0,0,0,0,24/06/2022,0,0,0,0,0,0,0,0,0,0,0,0,0,0,0,0,0,0,0,0
5282,163516,2022,Argentina,Japan,0,0,0,0,21/06/2022,0,0,1,1,0,0,1,1,0,0,0,0,0,0,0,0,0,0,0,0
5283,163516,2022,Iran,Japan,0,1,1,2,12/06/2022,0,0,0,0,2,0,0,2,0,0,0,0,1,1,3,5,0,0,0,0
5284,163516,2022,Japan,USA,0,1,4,5,10/06/2022,0,0,0,0,5,3,11,19,0,1,2,3,2,0,4,6,3,1,0,4
5285,163516,2022,Japan,China,0,0,0,0,09/06/2022,0,0,0,0,0,0,1,1,0,0,0,0,1,0,0,1,0,0,0,0
5286,163516,2022,Japan,Netherlands,0,0,1,1,08/06/2022,0,0,0,0,3,0,2,5,0,1,0,1,0,0,1,1,1,0,0,1
5287,146409,2022,France,Japan,0,1,8,9,21/07/2022,0,0,1,1,5,2,1,8,2,4,1,7,0,0,0,0,3,1,0,4
5288,146409,2022,Brazil,Japan,0,1,8,9,10/07/2022,0,0,0,0,3,2,3,8,0,3,2,5,0,0,1,1,1,1,0,2
5289,146409,2022,Germany,Japan,0,0,0,0,09/07/2022,0,0,0,0,0,0,0,0,0,0,0,0,0,0,0,0,0,0,0,0
5290,146409,2022,Japan,Canada,1,1,12,14,08/07/2022,0,0,0,0,5,1,3,9,2,5,7,14,0,0,2,2,0,0,2,2
5291,146409,2022,Japan,Australia,0,2,14,16,06/07/2022,1,0,0,1,7,0,5,12,0,7,1,8,0,0,0,0,2,1,1,4
5292,146409,2022,Japan,Slovenia,0,3,14,17,26/06/2022,0,0,1,1,5,1,5,11,2,5,5,12,0,0,1,1,6,1,0,7
5293,146409,2022,Japan,France,0,0,0,0,25/06/2022,0,0,0,0,0,0,0,0,0,0,0,0,0,0,0,0,0,0,0,0
5294,146409,2022,Japan,Italy,1,1,15,17,24/06/2022,0,0,3,3,14,1,3,18,0,5,8,13,0,0,0,0,3,1,0,4
5295,146409,2022,Argentina,Japan,1,2,14,17,21/06/2022,0,0,0,0,7,1,5,13,2,3,2,7,0,0,0,0,3,0,0,3
5296,146409,2022,Iran,Japan,1,1,8,10,12/06/2022,0,0,0,0,4,0,1,5,2,2,4,8,0,0,0,0,1,0,0,1
5297,146409,2022,Japan,USA,0,2,18,20,10/06/2022,0,0,0,0,6,0,6,12,0,8,7,15,0,0,0,0,4,1,2,7
5298,146409,2022,Japan,China,0,2,8,10,09/06/2022,1,0,0,1,5,2,1,8,0,2,2,4,0,0,0,0,2,0,1,3
5299,146409,2022,Japan,Netherlands,0,0,7,7,08/06/2022,0,0,0,0,1,1,4,6,0,3,0,3,1,0,1,2,3,0,1,4
5300,153365,2022,France,Japan,0,3,1,4,21/07/2022,0,0,5,5,3,2,7,12,0,2,0,2,2,1,4,7,0,1,1,2
5301,153365,2022,Brazil,Japan,0,0,0,0,10/07/2022,0,0,2,2,1,0,0,1,0,0,0,0,0,0,0,0,1,0,0,1
5302,153365,2022,Germany,Japan,0,4,7,11,09/07/2022,0,0,5,5,14,4,3,21,2,6,6,14,3,1,16,20,4,3,1,8
5303,153365,2022,Japan,Canada,0,0,0,0,08/07/2022,0,0,0,0,0,0,0,0,0,0,0,0,0,0,0,0,0,0,0,0
5304,153365,2022,Japan,Australia,0,0,0,0,06/07/2022,0,0,0,0,0,0,0,0,0,0,0,0,0,0,0,0,0,0,0,0
5305,153365,2022,Japan,Slovenia,0,0,0,0,26/06/2022,0,0,0,0,0,0,0,0,0,0,0,0,0,0,0,0,0,0,0,0
5306,153365,2022,Japan,France,0,7,4,11,25/06/2022,0,1,2,3,12,5,11,28,1,1,1,3,2,4,17,23,6,2,0,8
5307,153365,2022,Japan,Italy,0,0,0,0,24/06/2022,0,0,1,1,1,1,1,3,0,1,0,1,1,0,1,2,1,0,0,1
5308,153365,2022,Argentina,Japan,0,2,3,5,21/06/2022,0,0,2,2,4,3,3,10,0,0,1,1,4,1,11,16,4,1,0,5
5309,133009,2022,France,Japan,0,0,8,8,21/07/2022,10,0,41,51,0,0,1,1,0,0,0,0,0,1,0,1,6,3,0,9
5310,133009,2022,Brazil,Japan,0,1,9,10,10/07/2022,29,0,40,69,0,0,0,0,0,0,3,3,0,1,0,1,3,4,2,9
5311,133009,2022,Germany,Japan,0,0,0,0,09/07/2022,0,0,4,4,0,0,0,0,0,0,0,0,0,0,0,0,0,0,0,0
5312,133009,2022,Japan,Canada,0,2,16,18,08/07/2022,29,0,48,77,1,0,1,2,0,1,7,8,0,0,0,0,12,3,4,19
5313,133009,2022,Japan,Australia,2,0,10,12,06/07/2022,31,0,41,72,1,0,0,1,0,2,2,4,0,0,1,1,4,2,2,8
5314,133009,2022,Japan,Slovenia,0,0,16,16,26/06/2022,20,0,71,91,1,0,1,2,1,2,4,7,0,0,2,2,5,2,0,7
5315,133009,2022,Japan,France,0,0,2,2,25/06/2022,0,0,1,1,0,0,0,0,0,0,0,0,0,0,0,0,0,0,0,0
5316,133009,2022,Japan,Italy,1,0,18,19,24/06/2022,24,0,81,105,1,0,0,1,0,3,1,4,0,0,2,2,6,4,3,13
5317,133009,2022,Argentina,Japan,0,2,14,16,21/06/2022,15,0,69,84,0,0,0,0,0,2,2,4,0,0,0,0,8,2,0,10
5318,133009,2022,Iran,Japan,0,1,14,15,12/06/2022,18,1,31,50,0,0,0,0,0,1,5,6,0,0,1,1,8,1,0,9
5319,133009,2022,Japan,USA,0,1,4,5,10/06/2022,11,0,25,36,0,0,0,0,0,1,0,1,0,0,0,0,4,0,0,4
5320,133009,2022,Japan,China,0,0,0,0,09/06/2022,0,0,0,0,0,0,0,0,0,0,0,0,0,0,0,0,0,0,0,0
5321,133009,2022,Japan,Netherlands,0,0,8,8,08/06/2022,31,0,47,78,0,0,0,0,0,1,3,4,0,0,1,1,5,3,0,8
5322,142570,2022,France,Japan,0,0,0,0,21/07/2022,4,0,5,9,0,0,0,0,0,0,0,0,0,0,1,1,0,1,1,2
5323,142570,2022,Brazil,Japan,0,0,0,0,10/07/2022,1,0,1,2,0,0,0,0,0,0,0,0,0,0,0,0,0,0,1,1
5324,142570,2022,Germany,Japan,0,0,13,13,09/07/2022,16,1,54,71,0,1,0,1,0,1,8,9,0,0,0,0,6,3,2,11
5325,142570,2022,Japan,Canada,0,0,0,0,08/07/2022,1,0,2,3,0,0,0,0,0,0,0,0,0,0,0,0,1,0,0,1
5326,142570,2022,Japan,Australia,0,0,0,0,06/07/2022,5,1,4,10,0,0,0,0,0,0,0,0,0,0,0,0,1,0,0,1
5327,142570,2022,Japan,Slovenia,0,0,0,0,26/06/2022,0,0,0,0,0,0,0,0,0,0,0,0,0,0,0,0,0,0,0,0
5328,142570,2022,Japan,France,0,1,12,13,25/06/2022,16,1,64,81,3,0,1,4,1,1,5,7,0,0,1,1,6,2,2,10
5329,142570,2022,Japan,Italy,0,0,0,0,24/06/2022,0,0,0,0,0,0,0,0,0,0,0,0,0,0,0,0,0,0,0,0
5330,142570,2022,Argentina,Japan,0,0,1,1,21/06/2022,0,0,1,1,0,0,0,0,0,0,0,0,0,0,0,0,0,0,0,0
5331,142561,2022,France,Japan,0,0,0,0,21/07/2022,0,0,0,0,0,0,0,0,0,0,0,0,0,0,0,0,0,0,0,0
5332,142561,2022,Brazil,Japan,0,0,0,0,10/07/2022,0,0,0,0,0,0,0,0,0,0,0,0,0,0,0,0,0,0,0,0
5333,142561,2022,Germany,Japan,0,2,12,14,09/07/2022,0,0,1,1,4,0,2,6,6,3,4,13,0,0,1,1,3,3,0,6
5334,142561,2022,Japan,Canada,0,0,1,1,08/07/2022,0,0,0,0,0,1,0,1,1,0,0,1,0,0,0,0,1,0,0,1
5335,142561,2022,Japan,Australia,0,1,6,7,06/07/2022,0,0,0,0,12,0,4,16,2,5,8,15,0,0,0,0,1,0,2,3
5336,142561,2022,Japan,Slovenia,0,3,12,15,26/06/2022,0,0,0,0,9,0,3,12,2,2,5,9,0,0,0,0,2,0,1,3
5337,142561,2022,Japan,France,0,1,6,7,25/06/2022,0,0,1,1,6,1,2,9,0,6,10,16,0,0,0,0,4,0,0,4
5338,142561,2022,Japan,Italy,0,0,0,0,24/06/2022,0,0,0,0,0,0,0,0,0,0,1,1,0,0,0,0,0,0,0,0
5339,142561,2022,Argentina,Japan,0,0,0,0,21/06/2022,0,0,0,0,0,0,0,0,0,0,0,0,0,0,0,0,0,0,0,0
5340,178761,2022,Japan,Slovenia,0,0,0,0,26/06/2022,0,0,0,0,0,1,0,1,0,0,0,0,0,0,1,1,0,0,0,0
5341,178761,2022,Japan,France,0,3,7,10,25/06/2022,0,0,3,3,2,1,8,11,0,0,0,0,7,0,16,23,10,1,1,12
5342,178761,2022,Japan,Italy,0,0,0,0,24/06/2022,0,0,1,1,0,0,0,0,0,0,0,0,0,0,0,0,0,0,0,0
5343,178761,2022,Argentina,Japan,0,1,1,2,21/06/2022,0,0,0,0,1,1,1,3,0,0,0,0,0,0,3,3,0,0,0,0
5344,178761,2022,Iran,Japan,0,0,0,0,12/06/2022,0,0,0,0,0,0,0,0,0,0,0,0,0,0,0,0,0,0,0,0
5345,178761,2022,Japan,USA,0,2,1,3,10/06/2022,0,0,1,1,1,1,1,3,0,3,0,3,2,0,7,9,4,0,0,4
5346,178761,2022,Japan,China,0,0,0,0,09/06/2022,0,0,0,0,0,0,0,0,0,0,0,0,0,0,0,0,0,0,0,0
5347,178761,2022,Japan,Netherlands,0,0,0,0,08/06/2022,0,0,0,0,0,0,0,0,0,0,0,0,0,0,0,0,0,0,0,0
5348,178762,2022,France,Japan,1,2,4,7,21/07/2022,0,0,0,0,3,2,1,6,0,0,0,0,8,1,12,21,1,1,0,2
5349,178762,2022,Brazil,Japan,0,3,5,8,10/07/2022,0,0,0,0,3,3,5,11,0,1,0,1,2,1,9,12,1,2,1,4
5350,178762,2022,Germany,Japan,1,4,14,19,09/07/2022,0,0,5,5,13,4,6,23,0,4,3,7,3,0,21,24,6,1,0,7
5351,178762,2022,Japan,Canada,0,0,0,0,08/07/2022,0,0,0,0,0,0,0,0,0,0,0,0,0,0,1,1,0,0,0,0
5352,178762,2022,Japan,Australia,0,0,0,0,06/07/2022,0,0,0,0,0,0,0,0,0,0,0,0,0,0,0,0,0,0,0,0
5353,178762,2022,Japan,Slovenia,0,0,0,0,26/06/2022,0,0,0,0,0,0,0,0,0,0,0,0,0,0,0,0,0,0,0,0
5354,178762,2022,Japan,France,0,0,0,0,25/06/2022,0,0,0,0,0,0,0,0,0,0,0,0,0,0,0,0,0,0,0,0
5355,178762,2022,Japan,Italy,0,4,9,13,24/06/2022,0,0,2,2,7,4,8,19,1,3,1,5,5,1,21,27,4,3,0,7
5356,178762,2022,Argentina,Japan,0,0,4,4,21/06/2022,0,0,3,3,4,1,1,6,0,0,0,0,4,0,5,9,3,2,0,5
5357,178762,2022,Iran,Japan,3,2,8,13,12/06/2022,2,0,2,4,6,2,8,16,0,3,3,6,4,0,6,10,9,1,0,10
5358,178762,2022,Japan,USA,0,2,18,20,10/06/2022,2,0,0,2,12,1,15,28,0,3,6,9,13,3,24,40,12,1,2,15
5359,178762,2022,Japan,China,1,2,18,21,09/06/2022,1,0,1,2,13,3,6,22,0,2,0,2,7,0,13,20,6,1,0,7
5360,178762,2022,Japan,Netherlands,2,3,13,18,08/06/2022,0,0,0,0,8,3,8,19,0,1,1,2,7,0,13,20,3,0,1,4
5361,180990,2022,France,Japan,0,0,0,0,21/07/2022,0,0,0,0,0,0,0,0,0,0,0,0,0,0,0,0,0,0,0,0
5362,180990,2022,Brazil,Japan,0,0,0,0,10/07/2022,0,0,0,0,0,0,0,0,0,0,0,0,0,0,0,0,0,0,0,0
5363,180990,2022,Germany,Japan,0,0,0,0,09/07/2022,0,0,4,4,0,0,0,0,0,0,0,0,4,1,12,17,4,2,1,7
5364,180990,2022,Japan,Canada,0,0,0,0,08/07/2022,0,0,0,0,0,0,0,0,0,0,0,0,0,0,0,0,0,0,0,0
5365,180990,2022,Japan,Australia,0,0,0,0,06/07/2022,0,0,0,0,0,0,0,0,0,0,0,0,0,0,0,0,0,0,0,0
5366,180990,2022,Japan,Slovenia,0,0,0,0,26/06/2022,0,0,0,0,0,0,0,0,0,0,0,0,0,0,0,0,0,0,0,0
5367,180990,2022,Japan,France,0,0,0,0,25/06/2022,0,0,5,5,0,0,0,0,0,0,0,0,2,1,11,14,8,1,5,14
5368,180990,2022,Japan,Italy,0,0,0,0,24/06/2022,0,0,0,0,0,0,0,0,0,0,0,0,0,0,0,0,0,0,0,0
5369,180990,2022,Argentina,Japan,0,0,0,0,21/06/2022,0,0,0,0,0,0,0,0,0,0,0,0,0,0,0,0,0,0,0,0
5370,180990,2022,Iran,Japan,0,0,0,0,12/06/2022,0,0,0,0,0,0,0,0,0,0,0,0,0,0,0,0,0,1,0,1
5371,180990,2022,Japan,USA,0,0,0,0,10/06/2022,0,0,0,0,0,0,0,0,0,0,0,0,0,0,0,0,0,0,0,0
5372,180990,2022,Japan,China,0,0,0,0,09/06/2022,0,0,0,0,0,0,0,0,0,0,0,0,0,0,0,0,0,0,0,0
5373,180990,2022,Japan,Netherlands,0,0,0,0,08/06/2022,0,0,0,0,0,0,0,0,0,0,0,0,0,0,0,0,0,0,0,0
5374,142568,2022,Brazil,Japan,1,2,9,12,10/07/2022,0,0,6,6,12,2,3,17,1,3,2,6,8,1,8,17,3,4,0,7
5375,142568,2022,Germany,Japan,1,1,2,4,09/07/2022,0,0,0,0,0,0,0,0,0,0,0,0,0,0,0,0,0,0,0,0
5376,142568,2022,Japan,Canada,4,4,12,20,08/07/2022,1,0,5,6,15,3,12,30,0,3,3,6,4,2,10,16,7,1,2,10
5377,142568,2022,Japan,Australia,5,5,9,19,06/07/2022,2,0,4,6,11,2,6,19,2,2,1,5,9,1,13,23,4,2,4,10
5378,142568,2022,Japan,Slovenia,3,4,10,17,26/06/2022,0,0,3,3,17,2,15,34,1,2,0,3,7,1,7,15,8,2,2,12
5379,142568,2022,Japan,France,0,0,0,0,25/06/2022,0,0,0,0,0,0,0,0,0,0,0,0,0,0,0,0,0,0,0,0
5380,142568,2022,Japan,Italy,6,2,14,22,24/06/2022,3,0,4,7,14,8,17,39,0,2,1,3,7,1,20,28,10,2,4,16
5381,142568,2022,Argentina,Japan,3,6,7,16,21/06/2022,0,0,9,9,15,4,10,29,0,1,2,3,8,0,17,25,6,2,2,10
5382,142568,2022,Iran,Japan,1,2,11,14,12/06/2022,3,0,1,4,14,1,5,20,1,3,3,7,4,0,9,13,4,1,0,5
5383,142568,2022,Japan,USA,1,3,3,7,10/06/2022,1,1,0,2,7,4,9,20,1,4,0,5,5,1,3,9,2,1,0,3
5384,142568,2022,Japan,China,3,9,7,19,09/06/2022,3,0,0,3,11,3,7,21,2,2,3,7,7,0,14,21,5,2,0,7
5385,142568,2022,Japan,Netherlands,1,3,13,17,08/06/2022,1,0,4,5,6,5,8,19,5,7,1,13,8,1,11,20,6,2,1,9
5386,163038,2022,France,Japan,0,1,2,3,21/07/2022,0,0,1,1,3,0,1,4,0,0,0,0,0,0,0,0,0,0,0,0
5387,163038,2022,Brazil,Japan,0,0,0,0,10/07/2022,0,0,0,0,0,0,0,0,0,0,0,0,0,0,0,0,0,0,0,0
5388,163038,2022,Germany,Japan,2,5,10,17,09/07/2022,0,0,0,0,15,7,10,32,0,1,3,4,0,0,0,0,7,3,0,10
5389,163038,2022,Japan,Canada,0,0,2,2,08/07/2022,0,0,0,0,0,0,2,2,0,0,0,0,0,0,0,0,0,0,0,0
5390,163038,2022,Japan,Australia,0,0,1,1,06/07/2022,0,0,0,0,2,0,2,4,1,1,1,3,0,0,0,0,0,0,0,0
5391,163038,2022,Iran,Japan,0,0,0,0,12/06/2022,0,0,0,0,0,0,0,0,0,0,0,0,0,0,0,0,0,0,0,0
5392,163038,2022,Japan,USA,0,3,11,14,10/06/2022,0,0,2,2,19,6,17,42,1,3,7,11,0,0,0,0,11,2,1,14
5393,163038,2022,Japan,China,0,0,1,1,09/06/2022,0,0,0,0,0,0,0,0,0,0,0,0,0,0,0,0,0,0,0,0
5394,163038,2022,Japan,Netherlands,0,1,0,1,08/06/2022,0,0,0,0,0,0,0,0,0,0,0,0,0,0,0,0,0,0,0,0
5395,189192,2022,,,-,-,-,-,-,-,-,-,-,-,-,-,-,-,-,-,-,-,-,-,-,-,-,-,-
5396,152593,2022,,,-,-,-,-,-,-,-,-,-,-,-,-,-,-,-,-,-,-,-,-,-,-,-,-,-
5397,172893,2022,France,Japan,0,0,0,0,21/07/2022,0,0,3,3,0,0,0,0,0,0,0,0,3,0,6,9,6,0,0,6
5398,172893,2022,Brazil,Japan,0,0,0,0,10/07/2022,0,0,0,0,0,0,0,0,0,0,0,0,4,1,6,11,8,2,2,12
5399,172893,2022,Germany,Japan,0,0,0,0,09/07/2022,0,0,0,0,0,0,0,0,0,0,0,0,0,0,0,0,0,0,0,0
5400,172893,2022,Japan,Canada,0,0,0,0,08/07/2022,2,0,9,11,0,0,0,0,0,0,0,0,10,2,9,21,7,0,5,12
5401,172893,2022,Japan,Australia,0,0,0,0,06/07/2022,1,0,4,5,0,0,0,0,0,0,0,0,12,0,8,20,6,5,3,14
5402,172893,2022,Japan,Slovenia,0,0,0,0,26/06/2022,0,0,3,3,0,0,0,0,0,0,0,0,2,0,7,9,11,1,0,12
5403,172893,2022,Japan,France,0,0,0,0,25/06/2022,0,0,0,0,0,0,0,0,0,0,0,0,0,0,1,1,0,0,0,0
5404,172893,2022,Japan,Italy,0,0,0,0,24/06/2022,1,0,4,5,0,0,0,0,0,0,0,0,6,1,11,18,14,1,0,15
5405,172893,2022,Argentina,Japan,0,0,0,0,21/06/2022,0,0,5,5,0,0,0,0,0,0,0,0,0,0,13,13,6,7,1,14
5406,172893,2022,Iran,Japan,0,0,0,0,12/06/2022,3,0,1,4,0,0,0,0,0,0,0,0,3,3,4,10,5,0,2,7
5407,172893,2022,Japan,USA,0,0,0,0,10/06/2022,10,0,5,15,0,0,0,0,0,0,0,0,11,0,7,18,20,2,2,24
5408,172893,2022,Japan,China,0,0,0,0,09/06/2022,4,0,0,4,0,0,0,0,0,0,0,0,11,0,11,22,12,1,3,16
5409,172893,2022,Japan,Netherlands,0,0,0,0,08/06/2022,1,0,1,2,0,0,0,0,0,0,0,0,10,2,10,22,12,3,2,17
5410,142562,2022,Iran,Japan,0,0,0,0,12/06/2022,2,0,4,6,0,0,1,1,0,1,0,1,0,0,0,0,0,0,0,0
5411,142562,2022,Japan,USA,0,0,8,8,10/06/2022,32,2,47,81,3,1,0,4,1,0,2,3,0,0,0,0,4,0,1,5
5412,142562,2022,Japan,China,0,4,8,12,09/06/2022,38,0,46,84,0,0,0,0,0,1,5,6,0,0,0,0,5,1,2,8
5413,142562,2022,Japan,Netherlands,0,0,3,3,08/06/2022,5,0,14,19,0,0,0,0,0,0,1,1,0,0,0,0,3,0,0,3
5414,153359,2022,,,-,-,-,-,-,-,-,-,-,-,-,-,-,-,-,-,-,-,-,-,-,-,-,-,-
5415,189038,2022,,,-,-,-,-,-,-,-,-,-,-,-,-,-,-,-,-,-,-,-,-,-,-,-,-,-
5416,189037,2022,France,Japan,0,0,0,0,21/07/2022,0,0,0,0,0,0,0,0,0,0,0,0,0,0,0,0,0,0,0,0
5417,189037,2022,Brazil,Japan,0,0,0,0,10/07/2022,0,0,0,0,0,0,0,0,0,0,0,0,0,0,0,0,0,0,0,0
5418,189037,2022,Germany,Japan,0,0,1,1,09/07/2022,0,0,1,1,1,0,0,1,0,0,0,0,0,0,0,0,1,0,0,1
5419,189037,2022,Japan,Canada,0,0,0,0,08/07/2022,0,0,0,0,0,0,0,0,0,0,0,0,0,0,0,0,0,0,0,0
5420,189037,2022,Japan,Australia,0,0,0,0,06/07/2022,0,0,0,0,0,0,0,0,0,0,0,0,0,0,0,0,0,0,0,0
5421,189037,2022,Japan,Slovenia,0,0,0,0,26/06/2022,0,0,0,0,0,0,0,0,0,0,0,0,0,0,0,0,0,0,0,0
5422,189037,2022,Japan,France,1,2,11,14,25/06/2022,0,0,0,0,2,1,3,6,0,3,3,6,0,0,0,0,4,0,1,5
5423,189037,2022,Japan,Italy,0,0,0,0,24/06/2022,0,0,0,0,0,0,0,0,0,0,0,0,0,0,0,0,0,0,0,0
5424,189037,2022,Argentina,Japan,0,0,0,0,21/06/2022,0,0,0,0,0,0,0,0,0,0,0,0,0,0,0,0,0,0,0,0
5425,189037,2022,Iran,Japan,0,0,0,0,12/06/2022,0,0,0,0,0,0,0,0,0,0,0,0,0,0,0,0,0,0,0,0
5426,189037,2022,Japan,USA,0,1,3,4,10/06/2022,0,0,0,0,2,0,2,4,0,1,0,1,0,0,0,0,0,0,0,0
5427,189037,2022,Japan,China,1,2,11,14,09/06/2022,0,0,1,1,5,2,2,9,1,6,1,8,0,0,0,0,0,2,0,2
5428,189037,2022,Japan,Netherlands,1,1,6,8,08/06/2022,0,0,0,0,9,0,3,12,2,3,4,9,0,0,1,1,1,0,0,1
5429,189039,2022,,,-,-,-,-,-,-,-,-,-,-,-,-,-,-,-,-,-,-,-,-,-,-,-,-,-
5430,189064,2022,,,-,-,-,-,-,-,-,-,-,-,-,-,-,-,-,-,-,-,-,-,-,-,-,-,-
5431,150729,2022,,,-,-,-,-,-,-,-,-,-,-,-,-,-,-,-,-,-,-,-,-,-,-,-,-,-
5432,181284,2022,,,-,-,-,-,-,-,-,-,-,-,-,-,-,-,-,-,-,-,-,-,-,-,-,-,-
5433,141546,2022,Italy,Netherlands,0,0,14,14,20/07/2022,14,0,82,96,1,0,0,1,0,3,3,6,0,1,0,1,10,2,0,12
5434,141546,2022,Italy,Netherlands,0,2,6,8,10/07/2022,8,0,62,70,3,0,0,3,0,2,0,2,0,0,0,0,2,0,0,2
5435,141546,2022,Poland,Netherlands,1,1,7,9,09/07/2022,6,0,57,63,3,0,1,4,0,0,0,0,0,0,1,1,1,1,0,2
5436,141546,2022,Bulgaria,Netherlands,0,0,14,14,08/07/2022,19,0,63,82,0,1,0,1,0,1,0,1,1,0,3,4,1,0,0,1
5437,141546,2022,Netherlands,China,0,1,15,16,06/07/2022,7,0,63,70,0,0,0,0,0,0,0,0,0,0,0,0,0,1,0,1
5438,141546,2022,Argentina,Netherlands,0,0,17,17,25/06/2022,12,0,93,105,1,0,1,2,1,2,2,5,0,0,1,1,10,2,1,13
5439,141546,2022,Germany,Netherlands,1,1,12,14,24/06/2022,12,1,85,98,2,0,1,3,0,4,5,9,0,0,0,0,4,1,2,7
5440,141546,2022,France,Netherlands,0,0,6,6,23/06/2022,13,0,38,51,0,0,0,0,0,1,0,1,0,0,2,2,3,3,0,6
5441,141546,2022,Slovenia,Netherlands,0,0,13,13,21/06/2022,12,0,47,59,0,1,0,1,1,1,4,6,0,0,0,0,3,0,1,4
5442,141546,2022,Netherlands,Australia,0,1,6,7,12/06/2022,22,0,38,60,2,0,0,2,1,1,1,3,0,0,0,0,2,0,0,2
5443,141546,2022,Netherlands,Iran,0,0,12,12,10/06/2022,25,0,46,71,0,0,1,1,0,1,2,3,0,3,0,3,3,1,1,5
5444,141546,2022,Netherlands,USA,0,0,0,0,09/06/2022,0,1,7,8,0,0,0,0,0,0,0,0,0,0,0,0,1,0,0,1
5445,141546,2022,Japan,Netherlands,0,0,10,10,08/06/2022,20,0,54,74,1,0,2,3,2,5,2,9,1,0,0,1,3,2,1,6
5446,139929,2022,Italy,Netherlands,0,4,4,8,20/07/2022,0,0,2,2,4,1,9,14,1,2,2,5,3,0,6,9,2,4,0,6
5447,139929,2022,Italy,Netherlands,0,1,0,1,10/07/2022,0,0,0,0,2,0,2,4,0,0,0,0,0,0,1,1,0,0,0,0
5448,139929,2022,Poland,Netherlands,0,3,4,7,09/07/2022,0,0,3,3,7,4,6,17,0,4,0,4,0,1,12,13,1,2,0,3
5449,139929,2022,Bulgaria,Netherlands,0,0,5,5,08/07/2022,0,0,1,1,1,2,3,6,0,0,0,0,1,1,11,13,0,0,0,0
5450,139929,2022,Netherlands,China,0,0,0,0,06/07/2022,0,0,0,0,1,0,0,1,0,0,0,0,0,0,2,2,0,0,0,0
5451,139929,2022,Netherlands,Australia,1,2,4,7,12/06/2022,1,0,0,1,2,1,5,8,2,2,0,4,8,0,5,13,2,0,1,3
5452,139929,2022,Netherlands,Iran,0,0,0,0,10/06/2022,0,0,0,0,0,0,0,0,0,0,0,0,0,0,0,0,0,0,0,0
5453,139929,2022,Netherlands,USA,0,1,2,3,09/06/2022,0,0,0,0,2,0,1,3,0,0,0,0,0,0,1,1,0,1,1,2
5454,139929,2022,Japan,Netherlands,0,5,9,14,08/06/2022,1,0,0,1,12,8,9,29,2,3,1,6,4,1,19,24,4,2,1,7
5455,137345,2022,Italy,Netherlands,0,2,1,3,20/07/2022,0,1,1,2,3,4,3,10,0,1,0,1,5,1,1,7,2,0,0,2
5456,137345,2022,Italy,Netherlands,1,2,8,11,10/07/2022,0,0,0,0,8,2,6,16,1,1,0,2,4,2,16,22,3,0,0,3
5457,137345,2022,Poland,Netherlands,0,1,4,5,09/07/2022,0,0,0,0,3,0,2,5,0,0,0,0,1,0,3,4,1,0,0,1
5458,137345,2022,Netherlands,China,2,2,7,11,06/07/2022,0,0,0,0,10,2,4,16,2,0,0,2,2,0,17,19,4,0,0,4
5459,137345,2022,Argentina,Netherlands,0,0,0,0,25/06/2022,0,0,0,0,0,1,1,2,0,1,0,1,0,1,0,1,0,0,0,0
5460,137345,2022,Germany,Netherlands,0,1,1,2,24/06/2022,0,0,0,0,3,1,2,6,2,0,0,2,0,0,7,7,1,0,0,1
5461,137345,2022,France,Netherlands,0,0,2,2,23/06/2022,0,0,0,0,4,4,2,10,0,1,1,2,3,1,9,13,1,2,0,3
5462,137345,2022,Slovenia,Netherlands,2,2,6,10,21/06/2022,0,0,4,4,9,2,3,14,1,4,3,8,3,2,10,15,4,1,1,6
5463,137345,2022,Netherlands,Australia,0,3,1,4,12/06/2022,1,0,0,1,2,2,4,8,1,1,2,4,4,1,4,9,5,0,0,5
5464,137345,2022,Netherlands,Iran,0,3,5,8,10/06/2022,0,0,1,1,14,1,5,20,0,1,4,5,0,0,7,7,5,2,1,8
5465,137345,2022,Netherlands,USA,0,3,3,6,09/06/2022,1,0,1,2,9,3,8,20,0,2,0,2,7,2,15,24,4,1,0,5
5466,137345,2022,Japan,Netherlands,0,0,1,1,08/06/2022,0,0,0,0,1,0,1,2,0,0,0,0,1,0,0,1,0,0,0,0
5467,169921,2022,Italy,Netherlands,0,0,0,0,20/07/2022,0,0,0,0,0,0,0,0,0,0,0,0,0,0,0,0,0,0,0,0
5468,169921,2022,Italy,Netherlands,0,1,6,7,10/07/2022,0,0,0,0,1,0,3,4,0,1,0,1,0,0,3,3,0,1,0,1
5469,169921,2022,Poland,Netherlands,0,0,2,2,09/07/2022,0,0,0,0,0,0,0,0,0,1,0,1,0,0,0,0,0,0,0,0
5470,169921,2022,Bulgaria,Netherlands,0,0,1,1,08/07/2022,0,0,0,0,0,0,0,0,0,0,0,0,0,1,0,1,0,0,0,0
5471,169921,2022,Netherlands,China,0,0,0,0,06/07/2022,0,0,0,0,0,0,0,0,0,0,0,0,0,0,0,0,0,0,0,0
5472,169921,2022,Argentina,Netherlands,0,0,0,0,25/06/2022,0,0,0,0,0,0,0,0,0,0,0,0,0,0,0,0,0,0,0,0
5473,169921,2022,Germany,Netherlands,0,0,3,3,24/06/2022,0,0,0,0,0,0,0,0,2,3,1,6,0,0,0,0,0,1,0,1
5474,169921,2022,France,Netherlands,0,0,0,0,23/06/2022,0,0,0,0,0,0,0,0,0,0,0,0,0,0,0,0,0,0,0,0
5475,169921,2022,Slovenia,Netherlands,1,0,12,13,21/06/2022,0,0,0,0,2,0,2,4,0,2,1,3,1,0,1,2,2,0,0,2
5476,169921,2022,Netherlands,Australia,1,0,3,4,12/06/2022,0,0,0,0,0,0,1,1,0,3,3,6,1,0,0,1,0,0,0,0
5477,169921,2022,Netherlands,Iran,0,0,0,0,10/06/2022,0,0,0,0,0,0,0,0,1,0,0,1,0,0,0,0,0,0,0,0
5478,169921,2022,Netherlands,USA,0,0,0,0,09/06/2022,0,0,0,0,0,0,0,0,0,0,0,0,0,0,0,0,0,0,0,0
5479,169921,2022,Japan,Netherlands,1,1,9,11,08/06/2022,0,0,0,0,0,1,3,4,2,6,4,12,0,0,1,1,1,0,0,1
5480,184894,2022,,,-,-,-,-,-,-,-,-,-,-,-,-,-,-,-,-,-,-,-,-,-,-,-,-,-
5481,131980,2022,Italy,Netherlands,1,1,5,7,20/07/2022,0,0,0,0,3,0,3,6,0,1,0,1,5,1,4,10,3,1,1,5
5482,131980,2022,Italy,Netherlands,0,1,1,2,10/07/2022,0,0,0,0,0,0,0,0,0,0,0,0,0,0,1,1,0,0,0,0
5483,131980,2022,Poland,Netherlands,0,0,2,2,09/07/2022,0,0,0,0,0,0,0,0,0,0,0,0,0,0,4,4,0,0,0,0
5484,131980,2022,Bulgaria,Netherlands,1,0,12,13,08/07/2022,0,0,2,2,4,4,11,19,0,2,0,2,0,2,15,17,1,1,1,3
5485,131980,2022,Netherlands,China,1,0,7,8,06/07/2022,0,0,0,0,5,2,1,8,1,0,0,1,0,0,13,13,3,1,2,6
5486,131980,2022,Argentina,Netherlands,1,3,16,20,25/06/2022,0,0,2,2,10,5,9,24,1,0,0,1,7,1,27,35,18,4,1,23
5487,131980,2022,Germany,Netherlands,0,2,19,21,24/06/2022,1,0,7,8,10,3,10,23,1,4,3,8,9,0,14,23,16,2,0,18
5488,131980,2022,France,Netherlands,0,1,4,5,23/06/2022,0,0,5,5,3,3,1,7,0,1,0,1,4,0,4,8,3,2,0,5
5489,131980,2022,Slovenia,Netherlands,0,0,3,3,21/06/2022,0,0,0,0,0,0,1,1,0,0,0,0,3,0,4,7,1,0,0,1
5490,131980,2022,Netherlands,Australia,0,1,3,4,12/06/2022,1,0,0,1,0,0,0,0,0,0,0,0,4,0,3,7,1,1,0,2
5491,131980,2022,Netherlands,Iran,0,0,2,2,10/06/2022,0,0,0,0,0,0,0,0,0,0,0,0,0,0,2,2,0,0,0,0
5492,131980,2022,Netherlands,USA,0,1,8,9,09/06/2022,3,0,1,4,3,4,6,13,1,3,2,6,8,0,14,22,4,3,1,8
5493,131980,2022,Japan,Netherlands,0,0,1,1,08/06/2022,0,0,0,0,1,1,1,3,0,0,0,0,1,1,1,3,3,0,1,4
5494,156678,2022,Italy,Netherlands,1,2,11,14,20/07/2022,0,0,2,2,5,2,1,8,2,5,4,11,0,0,3,3,2,0,0,2
5495,156678,2022,Italy,Netherlands,1,0,1,2,10/07/2022,0,0,0,0,1,0,1,2,0,1,0,1,0,0,0,0,0,0,0,0
5496,156678,2022,Poland,Netherlands,0,2,2,4,09/07/2022,0,0,1,1,2,1,4,7,0,4,0,4,0,1,0,1,0,0,1,1
5497,156678,2022,Bulgaria,Netherlands,0,3,7,10,08/07/2022,0,0,0,0,7,1,2,10,1,7,1,9,0,0,2,2,0,0,0,0
5498,156678,2022,Netherlands,China,0,3,9,12,06/07/2022,0,0,0,0,4,0,1,5,5,4,1,10,0,0,0,0,2,0,0,2
5499,156678,2022,Argentina,Netherlands,5,4,10,19,25/06/2022,1,0,3,4,5,1,4,10,4,4,5,13,0,0,2,2,1,0,0,1
5500,156678,2022,Germany,Netherlands,1,4,8,13,24/06/2022,0,0,1,1,5,0,4,9,2,5,5,12,0,0,0,0,7,0,0,7
5501,156678,2022,France,Netherlands,0,2,4,6,23/06/2022,1,0,1,2,3,0,1,4,0,5,3,8,0,0,1,1,0,0,0,0
5502,156678,2022,Slovenia,Netherlands,0,0,0,0,21/06/2022,0,0,0,0,1,0,0,1,0,1,0,1,0,0,0,0,0,0,0,0
5503,156678,2022,Netherlands,Australia,0,2,11,13,12/06/2022,0,0,0,0,10,0,1,11,0,3,4,7,0,0,0,0,2,0,0,2
5504,156678,2022,Netherlands,Iran,0,4,9,13,10/06/2022,0,1,0,1,8,1,2,11,3,5,2,10,0,1,0,1,5,1,1,7
5505,156678,2022,Netherlands,USA,0,0,0,0,09/06/2022,0,0,0,0,0,0,0,0,0,0,0,0,0,0,0,0,0,0,0,0
5506,156678,2022,Japan,Netherlands,1,2,13,16,08/06/2022,0,0,1,1,6,0,4,10,2,4,5,11,1,0,1,2,2,0,1,3
5507,176460,2022,Argentina,Netherlands,0,0,0,0,25/06/2022,0,0,0,0,0,0,0,0,0,0,0,0,0,0,0,0,0,0,0,0
5508,176460,2022,Germany,Netherlands,0,0,0,0,24/06/2022,0,0,0,0,0,0,0,0,0,0,0,0,0,0,0,0,0,0,0,0
5509,176460,2022,France,Netherlands,0,0,0,0,23/06/2022,0,0,0,0,0,0,0,0,0,0,0,0,0,0,0,0,0,0,0,0
5510,176460,2022,Slovenia,Netherlands,0,0,0,0,21/06/2022,0,0,0,0,0,0,0,0,0,0,0,0,0,0,0,0,0,0,0,0
5511,176460,2022,Netherlands,Australia,0,0,0,0,12/06/2022,0,0,0,0,0,0,0,0,0,0,0,0,0,0,0,0,0,0,0,0
5512,176460,2022,Netherlands,Iran,0,0,0,0,10/06/2022,0,0,0,0,0,0,0,0,0,0,0,0,0,0,0,0,0,0,0,0
5513,176460,2022,Netherlands,USA,0,0,0,0,09/06/2022,0,0,0,0,0,0,0,0,0,0,0,0,0,0,0,0,0,0,0,0
5514,176460,2022,Japan,Netherlands,0,0,0,0,08/06/2022,0,0,0,0,0,0,0,0,0,0,0,0,0,0,0,0,0,0,0,0
5515,169923,2022,Italy,Netherlands,0,0,0,0,20/07/2022,0,0,1,1,2,0,1,3,0,0,0,0,0,0,0,0,0,0,0,0
5516,169923,2022,Italy,Netherlands,0,0,0,0,10/07/2022,0,0,0,0,0,0,0,0,0,0,0,0,0,0,0,0,0,0,0,0
5517,169923,2022,Poland,Netherlands,0,0,0,0,09/07/2022,0,0,0,0,0,0,0,0,0,0,0,0,0,0,0,0,0,0,0,0
5518,169923,2022,Bulgaria,Netherlands,0,0,0,0,08/07/2022,0,0,0,0,0,0,0,0,0,0,0,0,0,0,0,0,0,0,0,0
5519,169923,2022,Netherlands,China,0,0,0,0,06/07/2022,0,0,0,0,0,0,0,0,0,0,0,0,0,0,0,0,0,0,0,0
5520,169923,2022,Argentina,Netherlands,0,1,0,1,25/06/2022,0,0,0,0,7,2,2,11,0,2,2,4,0,0,0,0,1,1,0,2
5521,169923,2022,Germany,Netherlands,0,0,1,1,24/06/2022,0,0,2,2,0,0,0,0,0,0,0,0,0,0,0,0,0,0,0,0
5522,169923,2022,France,Netherlands,0,1,2,3,23/06/2022,0,0,1,1,3,1,1,5,0,0,1,1,0,0,0,0,0,0,0,0
5523,169923,2022,Slovenia,Netherlands,0,0,0,0,21/06/2022,0,0,0,0,0,0,0,0,0,0,0,0,0,0,0,0,0,0,0,0
5524,169923,2022,Netherlands,Australia,0,0,0,0,12/06/2022,0,0,0,0,0,0,0,0,0,0,0,0,0,0,0,0,0,0,0,0
5525,169923,2022,Netherlands,Iran,0,0,0,0,10/06/2022,0,0,0,0,0,0,0,0,0,0,0,0,0,0,0,0,0,0,0,0
5526,169923,2022,Netherlands,USA,0,1,8,9,09/06/2022,0,0,0,0,6,5,10,21,1,2,0,3,0,0,0,0,2,0,0,2
5527,169923,2022,Japan,Netherlands,0,0,1,1,08/06/2022,0,0,0,0,0,0,0,0,0,0,0,0,0,0,0,0,1,0,0,1
5528,181318,2022,,,-,-,-,-,-,-,-,-,-,-,-,-,-,-,-,-,-,-,-,-,-,-,-,-,-
5529,170436,2022,Italy,Netherlands,4,4,9,17,20/07/2022,0,0,3,3,16,4,11,31,0,1,1,2,13,2,14,29,8,1,0,9
5530,170436,2022,Italy,Netherlands,1,4,10,15,10/07/2022,0,0,0,0,5,1,9,15,2,1,0,3,0,1,17,18,2,0,1,3
5531,170436,2022,Poland,Netherlands,1,2,6,9,09/07/2022,0,0,2,2,7,3,5,15,0,4,0,4,1,2,15,18,1,1,0,2
5532,170436,2022,Bulgaria,Netherlands,2,1,6,9,08/07/2022,0,0,6,6,6,2,5,13,0,0,0,0,1,1,14,16,2,0,1,3
5533,170436,2022,Netherlands,China,0,1,2,3,06/07/2022,0,0,1,1,0,2,4,6,0,0,0,0,3,0,5,8,0,0,0,0
5534,170436,2022,Argentina,Netherlands,0,4,16,20,25/06/2022,0,0,3,3,17,1,13,31,1,5,2,8,5,1,18,24,4,1,1,6
5535,170436,2022,Germany,Netherlands,1,4,9,14,24/06/2022,0,0,0,0,8,4,17,29,1,3,3,7,2,1,16,19,7,1,3,11
5536,170436,2022,France,Netherlands,3,2,6,11,23/06/2022,1,0,0,1,7,3,9,19,1,1,1,3,10,2,15,27,3,1,0,4
5537,170436,2022,Slovenia,Netherlands,2,2,10,14,21/06/2022,0,0,3,3,10,4,4,18,1,3,2,6,2,0,10,12,6,2,0,8
5538,170436,2022,Netherlands,Australia,1,1,4,6,12/06/2022,1,0,1,2,4,2,3,9,0,2,0,2,1,0,6,7,2,0,1,3
5539,170436,2022,Netherlands,Iran,0,5,10,15,10/06/2022,1,0,0,1,7,2,4,13,1,3,1,5,4,2,13,19,6,0,0,6
5540,170436,2022,Netherlands,USA,0,1,0,1,09/06/2022,1,0,0,1,2,0,1,3,0,1,0,1,0,0,0,0,0,0,0,0
5541,170436,2022,Japan,Netherlands,0,0,12,12,08/06/2022,2,0,1,3,10,4,9,23,1,2,2,5,9,3,24,36,7,2,0,9
5542,184896,2022,Italy,Netherlands,0,0,0,0,20/07/2022,0,0,0,0,0,0,0,0,0,0,0,0,0,0,0,0,0,0,0,0
5543,184896,2022,Italy,Netherlands,0,0,0,0,10/07/2022,0,0,0,0,0,0,0,0,0,0,0,0,0,0,0,0,0,0,0,0
5544,184896,2022,Poland,Netherlands,0,0,0,0,09/07/2022,0,0,0,0,0,0,0,0,0,0,0,0,0,0,0,0,0,0,0,0
5545,184896,2022,Bulgaria,Netherlands,0,0,0,0,08/07/2022,0,0,0,0,0,0,0,0,0,0,0,0,0,0,0,0,0,0,0,0
5546,184896,2022,Netherlands,China,0,0,0,0,06/07/2022,0,0,0,0,0,0,0,0,0,0,0,0,0,0,0,0,0,0,0,0
5547,137498,2022,Italy,Netherlands,0,6,5,11,20/07/2022,0,0,1,1,16,7,18,41,0,3,2,5,0,0,1,1,6,1,0,7
5548,137498,2022,Italy,Netherlands,1,4,7,12,10/07/2022,0,0,0,0,14,4,11,29,0,4,0,4,0,0,2,2,0,0,0,0
5549,137498,2022,Poland,Netherlands,4,5,9,18,09/07/2022,0,0,2,2,15,5,6,26,0,0,0,0,0,0,1,1,1,1,0,2
5550,137498,2022,Bulgaria,Netherlands,2,5,11,18,08/07/2022,0,1,2,3,22,10,14,46,1,2,0,3,0,0,2,2,5,0,1,6
5551,137498,2022,Netherlands,China,6,3,7,16,06/07/2022,0,0,0,0,21,2,11,34,3,2,0,5,0,0,2,2,0,0,0,0
5552,137498,2022,Argentina,Netherlands,2,5,6,13,25/06/2022,0,0,4,4,21,8,13,42,1,2,1,4,0,0,0,0,3,2,0,5
5553,137498,2022,Germany,Netherlands,3,5,9,17,24/06/2022,0,0,1,1,25,5,23,53,3,0,6,9,0,0,2,2,7,5,0,12
5554,137498,2022,France,Netherlands,1,5,2,8,23/06/2022,1,0,1,2,10,4,8,22,0,2,1,3,1,0,1,2,0,4,0,4
5555,137498,2022,Slovenia,Netherlands,3,5,3,11,21/06/2022,1,0,2,3,15,6,13,34,0,3,4,7,0,0,0,0,6,2,1,9
5556,137498,2022,Netherlands,Australia,5,6,7,18,12/06/2022,1,0,0,1,14,2,8,24,1,3,1,5,0,0,0,0,2,2,0,4
5557,137498,2022,Netherlands,Iran,2,5,8,15,10/06/2022,0,0,0,0,17,1,10,28,1,1,2,4,0,0,1,1,2,2,0,4
5558,137498,2022,Netherlands,USA,0,0,0,0,09/06/2022,0,0,0,0,0,0,0,0,0,0,0,0,0,0,0,0,0,0,0,0
5559,137498,2022,Japan,Netherlands,1,7,10,18,08/06/2022,1,0,3,4,17,6,8,31,0,2,3,5,0,0,1,1,4,1,2,7
5560,164837,2022,Argentina,Netherlands,0,0,2,2,25/06/2022,0,0,1,1,0,0,0,0,0,1,1,2,0,0,0,0,0,0,0,0
5561,164837,2022,Germany,Netherlands,0,0,1,1,24/06/2022,0,0,10,10,0,0,0,0,0,0,1,1,0,0,0,0,0,0,0,0
5562,164837,2022,France,Netherlands,0,0,0,0,23/06/2022,3,0,8,11,0,0,0,0,0,0,0,0,0,0,0,0,1,0,0,1
5563,164837,2022,Slovenia,Netherlands,0,0,0,0,21/06/2022,0,0,0,0,0,0,0,0,0,0,0,0,0,0,0,0,0,0,0,0
5564,164837,2022,Netherlands,Australia,0,0,0,0,12/06/2022,0,0,0,0,0,0,0,0,0,0,0,0,0,0,0,0,0,0,0,0
5565,164837,2022,Netherlands,Iran,0,0,0,0,10/06/2022,0,0,0,0,0,0,0,0,0,0,0,0,0,0,0,0,0,0,0,0
5566,164837,2022,Netherlands,USA,0,0,3,3,09/06/2022,15,4,37,56,0,0,1,1,1,0,3,4,0,0,0,0,2,1,0,3
5567,164837,2022,Japan,Netherlands,0,0,0,0,08/06/2022,0,2,13,15,0,0,0,0,0,0,0,0,0,0,0,0,0,0,0,0
5568,137337,2022,Italy,Netherlands,0,0,1,1,20/07/2022,0,0,0,0,0,0,0,0,0,0,0,0,0,0,0,0,0,0,0,0
5569,137337,2022,Italy,Netherlands,0,0,0,0,10/07/2022,0,0,0,0,0,0,0,0,0,0,0,0,0,0,0,0,0,0,0,0
5570,137337,2022,Poland,Netherlands,0,0,1,1,09/07/2022,0,0,0,0,0,0,0,0,0,0,0,0,0,0,0,0,0,0,0,0
5571,137337,2022,Bulgaria,Netherlands,1,0,5,6,08/07/2022,0,1,2,3,6,0,0,6,1,5,0,6,0,0,2,2,0,0,0,0
5572,137337,2022,Netherlands,China,0,0,0,0,06/07/2022,0,0,0,0,0,0,0,0,0,0,0,0,0,0,0,0,0,0,0,0
5573,137337,2022,Argentina,Netherlands,0,1,6,7,25/06/2022,0,0,1,1,5,0,1,6,0,5,1,6,0,0,0,0,3,1,0,4
5574,137337,2022,Germany,Netherlands,0,0,0,0,24/06/2022,0,0,0,0,0,0,0,0,0,0,0,0,0,0,0,0,0,0,0,0
5575,137337,2022,France,Netherlands,1,0,2,3,23/06/2022,0,0,0,0,0,2,1,3,0,1,1,2,0,0,1,1,0,0,0,0
5576,137337,2022,Slovenia,Netherlands,0,0,0,0,21/06/2022,0,0,0,0,0,0,0,0,0,0,0,0,0,0,0,0,0,0,0,0
5577,137337,2022,Netherlands,Australia,0,0,0,0,12/06/2022,0,0,0,0,0,0,0,0,0,0,0,0,0,0,0,0,0,0,0,0
5578,137337,2022,Netherlands,Iran,0,0,0,0,10/06/2022,0,0,0,0,0,0,0,0,0,0,0,0,0,0,0,0,0,0,0,0
5579,137337,2022,Netherlands,USA,0,1,9,10,09/06/2022,1,0,0,1,2,1,3,6,1,2,3,6,1,0,1,2,2,0,0,2
5580,137337,2022,Japan,Netherlands,0,1,2,3,08/06/2022,0,0,0,0,0,0,0,0,0,0,1,1,0,0,0,0,0,0,0,0
5581,121992,2022,Italy,Netherlands,0,0,0,0,20/07/2022,1,0,5,6,0,0,0,0,0,0,0,0,9,2,16,27,4,3,0,7
5582,121992,2022,Italy,Netherlands,0,0,0,0,10/07/2022,0,0,0,0,0,0,0,0,0,0,0,0,2,1,10,13,5,3,1,9
5583,121992,2022,Poland,Netherlands,0,0,0,0,09/07/2022,0,0,3,3,0,0,0,0,0,0,0,0,1,0,20,21,4,1,1,6
5584,121992,2022,Bulgaria,Netherlands,0,0,0,0,08/07/2022,0,0,0,0,0,0,0,0,0,0,0,0,15,0,10,25,9,4,2,15
5585,121992,2022,Netherlands,China,0,0,0,0,06/07/2022,0,0,0,0,0,0,0,0,0,0,0,0,0,0,5,5,1,2,1,4
5586,121992,2022,Argentina,Netherlands,0,0,0,0,25/06/2022,0,0,6,6,0,0,0,0,0,0,0,0,9,1,15,25,10,3,0,13
5587,121992,2022,Germany,Netherlands,0,0,0,0,24/06/2022,0,0,4,4,0,0,0,0,0,0,0,0,6,0,16,22,8,6,3,17
5588,121992,2022,France,Netherlands,0,0,0,0,23/06/2022,0,0,3,3,0,0,0,0,0,0,0,0,2,1,4,7,8,2,0,10
5589,121992,2022,Slovenia,Netherlands,0,0,0,0,21/06/2022,0,0,4,4,0,0,0,0,0,0,0,0,3,0,7,10,7,2,1,10
5590,121992,2022,Netherlands,Australia,0,0,0,0,12/06/2022,0,0,0,0,0,0,0,0,0,0,0,0,2,0,6,8,6,1,0,7
5591,121992,2022,Netherlands,Iran,0,0,0,0,10/06/2022,1,0,1,2,0,0,0,0,0,0,0,0,6,1,17,24,6,1,1,8
5592,121992,2022,Netherlands,USA,0,0,0,0,09/06/2022,3,0,0,3,0,0,0,0,0,0,0,0,2,3,9,14,2,4,0,6
5593,121992,2022,Japan,Netherlands,0,0,0,0,08/06/2022,2,0,2,4,0,0,0,0,0,0,0,0,3,1,9,13,6,0,0,6
5594,162642,2022,Italy,Netherlands,0,0,0,0,20/07/2022,1,0,7,8,0,0,0,0,0,0,0,0,0,0,0,0,0,1,0,1
5595,162642,2022,Italy,Netherlands,0,0,0,0,10/07/2022,0,0,0,0,0,0,0,0,0,0,0,0,0,0,0,0,0,0,0,0
5596,162642,2022,Poland,Netherlands,0,0,0,0,09/07/2022,0,0,2,2,0,0,0,0,0,0,0,0,0,0,0,0,0,0,0,0
5597,162642,2022,Bulgaria,Netherlands,0,2,1,3,08/07/2022,7,0,11,18,0,0,0,0,0,2,0,2,0,0,0,0,0,0,0,0
5598,162642,2022,Netherlands,China,0,0,0,0,06/07/2022,0,0,0,0,0,0,0,0,0,0,0,0,0,0,0,0,0,0,0,0
5599,181317,2022,,,-,-,-,-,-,-,-,-,-,-,-,-,-,-,-,-,-,-,-,-,-,-,-,-,-
5600,153711,2022,,,-,-,-,-,-,-,-,-,-,-,-,-,-,-,-,-,-,-,-,-,-,-,-,-,-
5601,150703,2022,Italy,Netherlands,0,1,7,8,20/07/2022,0,0,1,1,2,2,2,6,1,2,3,6,0,0,1,1,1,0,1,2
5602,150703,2022,Italy,Netherlands,1,2,8,11,10/07/2022,0,1,1,2,2,1,0,3,2,6,0,8,0,0,2,2,0,0,0,0
5603,150703,2022,Poland,Netherlands,0,2,6,8,09/07/2022,0,0,0,0,0,0,1,1,4,3,0,7,0,0,0,0,0,2,0,2
5604,150703,2022,Bulgaria,Netherlands,0,0,5,5,08/07/2022,0,0,0,0,2,2,1,5,0,3,0,3,0,0,2,2,1,0,0,1
5605,150703,2022,Netherlands,China,1,1,9,11,06/07/2022,0,0,0,0,2,0,2,4,2,3,0,5,0,0,0,0,1,0,0,1
5606,150703,2022,Argentina,Netherlands,0,2,4,6,25/06/2022,0,0,1,1,0,0,0,0,0,0,0,0,0,0,0,0,0,0,0,0
5607,150703,2022,Germany,Netherlands,0,4,12,16,24/06/2022,0,1,0,1,4,0,0,4,4,4,15,23,0,0,1,1,4,0,0,4
5608,150703,2022,France,Netherlands,0,0,7,7,23/06/2022,0,0,0,0,0,2,2,4,0,4,4,8,0,0,0,0,1,0,0,1
5609,150703,2022,Slovenia,Netherlands,1,1,8,10,21/06/2022,0,0,1,1,1,2,1,4,2,3,10,15,0,0,1,1,1,3,0,4
5610,150703,2022,Netherlands,Australia,1,0,9,10,12/06/2022,0,0,0,0,3,0,1,4,1,2,0,3,0,0,0,0,0,1,1,2
5611,150703,2022,Netherlands,Iran,0,0,10,10,10/06/2022,0,0,1,1,2,0,1,3,2,2,3,7,0,0,0,0,0,2,0,2
5612,150703,2022,Netherlands,USA,0,1,5,6,09/06/2022,0,0,0,0,2,0,2,4,1,1,1,3,0,0,2,2,0,0,0,0
5613,150703,2022,Japan,Netherlands,0,0,2,2,08/06/2022,0,0,0,0,0,0,0,0,0,0,0,0,0,0,0,0,0,1,0,1
5614,184361,2022,,,-,-,-,-,-,-,-,-,-,-,-,-,-,-,-,-,-,-,-,-,-,-,-,-,-
5615,157237,2022,,,-,-,-,-,-,-,-,-,-,-,-,-,-,-,-,-,-,-,-,-,-,-,-,-,-
5616,188782,2022,,,-,-,-,-,-,-,-,-,-,-,-,-,-,-,-,-,-,-,-,-,-,-,-,-,-
5617,188784,2022,,,-,-,-,-,-,-,-,-,-,-,-,-,-,-,-,-,-,-,-,-,-,-,-,-,-
5618,153394,2022,France,Poland,0,0,1,1,12/06/2022,0,0,0,0,0,1,0,1,0,0,0,0,0,0,0,0,0,0,0,0
5619,153394,2022,Bulgaria,Poland,1,3,9,13,11/06/2022,0,0,1,1,11,4,12,27,0,3,2,5,3,0,12,15,7,2,3,12
5620,153394,2022,Poland,Italy,0,0,0,0,09/06/2022,0,0,0,0,0,0,0,0,0,0,0,0,0,0,0,0,0,0,0,0
5621,153394,2022,Poland,Argentina,0,0,0,0,08/06/2022,0,0,0,0,0,0,0,0,0,0,0,0,0,0,0,0,0,0,0,0
5622,156531,2022,France,Poland,0,0,0,0,12/06/2022,0,0,0,0,0,0,0,0,0,0,0,0,0,0,0,0,0,0,0,0
5623,156531,2022,Bulgaria,Poland,0,4,7,11,11/06/2022,0,0,1,1,12,1,4,17,1,3,3,7,0,0,0,0,4,4,1,9
5624,156531,2022,Poland,Italy,0,0,0,0,09/06/2022,0,0,0,0,0,0,1,1,0,1,0,1,0,0,0,0,0,0,0,0
5625,156531,2022,Poland,Argentina,0,2,9,11,08/06/2022,0,1,1,2,9,6,9,24,1,0,2,3,0,0,0,0,3,1,1,5
5626,153388,2022,Italy,Poland,0,0,0,0,24/07/2022,0,0,0,0,0,0,0,0,0,0,0,0,0,0,0,0,0,0,0,0
5627,153388,2022,Poland,USA,0,0,0,0,23/07/2022,0,0,0,0,0,0,0,0,0,0,0,0,0,0,0,0,0,0,0,0
5628,153388,2022,Poland,Iran,0,0,0,0,21/07/2022,0,0,0,0,0,0,0,0,0,0,0,0,0,0,0,0,0,0,0,0
5629,153388,2022,Poland,Slovenia,0,0,0,0,10/07/2022,0,0,0,0,0,0,0,0,0,0,0,0,0,0,0,0,0,0,0,0
5630,153388,2022,Poland,Netherlands,0,0,0,0,09/07/2022,0,0,0,0,0,0,0,0,0,0,0,0,0,0,0,0,0,0,0,0
5631,153388,2022,Poland,China,0,0,0,0,07/07/2022,0,0,2,2,0,0,0,0,0,0,0,0,5,0,10,15,4,0,0,4
5632,153388,2022,Iran,Poland,0,0,0,0,05/07/2022,0,0,0,0,0,0,0,0,0,0,0,0,0,0,0,0,0,1,0,1
5633,153388,2022,USA,Poland,0,0,0,0,26/06/2022,0,0,0,0,0,0,0,0,0,0,0,0,5,3,7,15,2,3,0,5
5634,153388,2022,Poland,Australia,0,0,0,0,25/06/2022,0,0,0,0,0,0,0,0,0,0,0,0,0,0,0,0,0,0,0,0
5635,153388,2022,Poland,Canada,0,0,0,0,23/06/2022,0,0,2,2,0,0,0,0,0,0,0,0,0,2,7,9,3,0,0,3
5636,153388,2022,Brazil,Poland,0,0,0,0,22/06/2022,0,0,0,0,0,0,0,0,0,0,0,0,0,0,0,0,0,0,0,0
5637,153388,2022,France,Poland,0,0,0,0,12/06/2022,0,0,3,3,0,0,0,0,0,0,0,0,2,3,15,20,8,4,0,12
5638,153388,2022,Bulgaria,Poland,0,0,0,0,11/06/2022,0,0,0,0,0,0,0,0,0,0,0,0,0,0,0,0,0,0,1,1
5639,153388,2022,Poland,Italy,0,0,0,0,09/06/2022,0,0,3,3,0,0,0,0,0,0,0,0,3,2,16,21,1,3,3,7
5640,153388,2022,Poland,Argentina,0,0,0,0,08/06/2022,0,0,7,7,0,0,0,0,0,0,0,0,7,0,5,12,10,2,2,14
5641,152872,2022,France,Poland,0,0,0,0,12/06/2022,0,0,0,0,0,0,0,0,0,0,0,0,0,0,0,0,0,0,0,0
5642,152872,2022,Bulgaria,Poland,0,0,7,7,11/06/2022,39,0,32,71,1,0,0,1,1,1,3,5,0,0,1,1,1,0,4,5
5643,152872,2022,Poland,Italy,0,0,0,0,09/06/2022,1,0,0,1,0,0,0,0,0,0,0,0,0,0,0,0,0,0,1,1
5644,152872,2022,Poland,Argentina,0,0,0,0,08/06/2022,0,0,0,0,0,0,0,0,0,0,0,0,0,0,0,0,0,0,0,0
5645,162105,2022,Italy,Poland,0,0,0,0,24/07/2022,0,0,0,0,0,0,0,0,0,0,0,0,0,0,0,0,0,0,0,0
5646,162105,2022,Poland,USA,0,0,0,0,23/07/2022,0,0,0,0,1,0,0,1,0,2,0,2,0,0,0,0,0,0,0,0
5647,162105,2022,Poland,Iran,0,1,2,3,21/07/2022,0,0,0,0,3,0,3,6,0,0,0,0,0,0,0,0,0,0,0,0
5648,162105,2022,Poland,Slovenia,0,0,3,3,10/07/2022,0,0,0,0,0,1,1,2,1,0,0,1,0,0,0,0,1,0,0,1
5649,162105,2022,Poland,Netherlands,0,0,1,1,09/07/2022,0,0,0,0,0,0,0,0,0,0,0,0,0,0,0,0,0,0,0,0
5650,162105,2022,Poland,China,2,2,10,14,07/07/2022,0,0,0,0,7,4,5,16,1,1,0,2,0,0,0,0,2,1,0,3
5651,162105,2022,Iran,Poland,0,0,1,1,05/07/2022,0,0,0,0,1,0,1,2,0,0,0,0,0,0,0,0,0,0,0,0
5652,162105,2022,USA,Poland,0,1,0,1,26/06/2022,0,0,0,0,0,0,0,0,0,0,0,0,0,0,0,0,0,0,0,0
5653,162105,2022,Poland,Australia,1,1,12,14,25/06/2022,0,0,1,1,7,4,6,17,0,2,3,5,0,0,0,0,2,1,0,3
5654,162105,2022,Poland,Canada,0,1,13,14,23/06/2022,0,0,1,1,12,1,4,17,1,0,0,1,0,0,0,0,2,1,1,4
5655,162105,2022,Brazil,Poland,0,0,1,1,22/06/2022,0,0,2,2,2,2,3,7,0,0,1,1,0,0,0,0,0,0,0,0
5656,115806,2022,Italy,Poland,3,4,7,14,24/07/2022,0,0,3,3,10,3,12,25,0,0,5,5,0,0,0,0,8,1,1,10
5657,115806,2022,Poland,USA,1,3,7,11,23/07/2022,0,0,1,1,10,3,11,24,0,1,1,2,0,0,0,0,2,4,0,6
5658,115806,2022,Poland,Iran,1,6,6,13,21/07/2022,0,0,2,2,13,5,10,28,1,1,5,7,0,0,0,0,1,5,0,6
5659,115806,2022,Poland,Slovenia,5,6,8,19,10/07/2022,0,0,0,0,14,3,8,25,4,1,0,5,0,0,0,0,2,0,0,2
5660,115806,2022,Poland,Netherlands,1,0,2,3,09/07/2022,0,0,1,1,2,0,1,3,0,1,0,1,0,0,0,0,0,0,0,0
5661,115806,2022,Poland,China,0,0,0,0,07/07/2022,0,0,0,0,0,0,0,0,0,0,0,0,0,0,0,0,0,0,0,0
5662,115806,2022,Iran,Poland,2,3,13,18,05/07/2022,0,0,0,0,19,4,11,34,2,2,0,4,0,0,1,1,1,4,1,6
5663,115806,2022,USA,Poland,0,3,16,19,26/06/2022,0,0,2,2,21,5,2,28,2,1,1,4,1,0,1,2,2,1,2,5
5664,115806,2022,Poland,Australia,0,0,1,1,25/06/2022,0,0,0,0,5,0,1,6,0,0,1,1,0,0,0,0,0,1,0,1
5665,115806,2022,Poland,Canada,0,0,2,2,23/06/2022,0,0,0,0,1,0,0,1,0,0,0,0,0,0,0,0,0,0,0,0
5666,115806,2022,Brazil,Poland,0,6,9,15,22/06/2022,0,0,3,3,16,7,17,40,1,1,2,4,0,0,0,0,1,0,2,3
5667,118618,2022,Italy,Poland,0,0,0,0,24/07/2022,0,0,0,0,0,0,0,0,0,0,0,0,0,0,0,0,0,0,0,0
5668,118618,2022,Poland,USA,0,0,0,0,23/07/2022,0,0,0,0,0,0,0,0,0,0,0,0,0,0,0,0,0,0,0,0
5669,118618,2022,Poland,Iran,1,1,10,12,21/07/2022,0,0,0,0,2,1,0,3,3,2,0,5,1,0,0,1,0,0,2,2
5670,118618,2022,Poland,Slovenia,0,0,2,2,10/07/2022,0,0,0,0,0,0,0,0,2,0,0,2,0,0,0,0,0,0,0,0
5671,118618,2022,Poland,Netherlands,0,1,7,8,09/07/2022,0,0,0,0,5,0,1,6,5,2,1,8,0,0,0,0,2,0,0,2
5672,118618,2022,Poland,China,0,0,6,6,07/07/2022,0,0,1,1,8,1,0,9,0,4,0,4,0,0,0,0,0,1,0,1
5673,118618,2022,Iran,Poland,0,0,5,5,05/07/2022,0,0,0,0,3,0,1,4,1,2,0,3,0,0,1,1,0,0,1,1
5674,118618,2022,USA,Poland,0,0,0,0,26/06/2022,0,0,0,0,0,0,0,0,0,0,0,0,0,0,0,0,0,0,0,0
5675,118618,2022,Poland,Australia,1,0,12,13,25/06/2022,1,0,0,1,6,3,2,11,2,3,5,10,0,0,0,0,1,0,0,1
5676,118618,2022,Poland,Canada,0,0,8,8,23/06/2022,0,0,0,0,7,0,1,8,2,1,3,6,1,0,1,2,1,0,0,1
5677,118618,2022,Brazil,Poland,0,0,0,0,22/06/2022,0,0,0,0,0,0,0,0,0,0,0,0,0,0,0,0,0,0,0,0
5678,118618,2022,France,Poland,0,1,4,5,12/06/2022,0,0,0,0,0,1,2,3,2,2,0,4,0,0,0,0,0,0,0,0
5679,118618,2022,Bulgaria,Poland,1,1,7,9,11/06/2022,0,0,0,0,3,1,0,4,1,1,2,4,0,1,0,1,1,0,1,2
5680,118618,2022,Poland,Italy,0,0,1,1,09/06/2022,0,0,0,0,0,0,0,0,0,1,0,1,0,0,0,0,1,0,0,1
5681,118618,2022,Poland,Argentina,1,1,9,11,08/06/2022,0,0,3,3,5,0,3,8,3,3,4,10,0,0,1,1,0,1,0,1
5682,119646,2022,,,-,-,-,-,-,-,-,-,-,-,-,-,-,-,-,-,-,-,-,-,-,-,-,-,-
5683,150742,2022,Italy,Poland,0,0,0,0,24/07/2022,0,0,0,0,0,0,0,0,0,0,0,0,0,0,0,0,0,0,0,0
5684,150742,2022,Poland,USA,0,1,3,4,23/07/2022,0,0,0,0,2,0,2,4,0,0,1,1,1,3,2,6,0,1,0,1
5685,150742,2022,Poland,Iran,0,0,0,0,21/07/2022,0,0,0,0,0,0,1,1,0,0,0,0,1,0,2,3,0,0,0,0
5686,150742,2022,Poland,Slovenia,0,0,0,0,10/07/2022,0,0,0,0,0,0,0,0,0,0,0,0,0,0,0,0,0,0,0,0
5687,150742,2022,Poland,Netherlands,1,2,3,6,09/07/2022,0,0,0,0,5,1,0,6,0,0,0,0,0,3,7,10,1,3,0,4
5688,150742,2022,Poland,China,0,0,0,0,07/07/2022,0,0,0,0,0,0,0,0,0,0,0,0,0,0,0,0,0,0,0,0
5689,150742,2022,Iran,Poland,0,6,9,15,05/07/2022,0,0,3,3,16,8,6,30,1,1,0,2,5,2,22,29,1,0,0,1
5690,115794,2022,Italy,Poland,0,0,0,0,24/07/2022,0,0,0,0,0,0,0,0,0,0,0,0,0,0,0,0,0,0,0,0
5691,115794,2022,Poland,USA,0,0,1,1,23/07/2022,5,0,6,11,0,0,0,0,0,1,0,1,0,0,0,0,0,0,0,0
5692,115794,2022,Poland,Iran,0,0,3,3,21/07/2022,3,0,15,18,0,0,0,0,0,1,0,1,0,0,0,0,1,1,0,2
5693,115794,2022,USA,Poland,0,0,0,0,26/06/2022,1,0,5,6,0,0,0,0,0,0,0,0,0,0,0,0,0,0,1,1
5694,115794,2022,Poland,Australia,0,0,7,7,25/06/2022,26,0,39,65,0,0,0,0,0,1,2,3,0,0,0,0,2,2,1,5
5695,115794,2022,Poland,Canada,0,0,3,3,23/06/2022,4,0,7,11,0,0,0,0,0,1,0,1,0,0,0,0,1,0,0,1
5696,115794,2022,Brazil,Poland,0,0,1,1,22/06/2022,2,0,1,3,0,0,0,0,0,0,0,0,0,0,0,0,0,0,1,1
5697,142678,2022,France,Poland,0,0,1,1,12/06/2022,0,0,0,0,0,1,2,3,0,0,1,1,0,2,3,5,2,0,0,2
5698,142678,2022,Bulgaria,Poland,0,0,0,0,11/06/2022,0,0,0,0,0,0,1,1,0,0,0,0,0,0,0,0,0,0,0,0
5699,142678,2022,Poland,Italy,0,1,13,14,09/06/2022,0,0,6,6,13,4,9,26,0,4,5,9,10,3,13,26,7,2,2,11
5700,142678,2022,Poland,Argentina,0,0,0,0,08/06/2022,0,0,0,0,0,0,0,0,0,0,0,0,0,0,0,0,0,0,0,0
5701,142679,2022,Italy,Poland,0,0,1,1,24/07/2022,0,0,1,1,1,0,3,4,0,1,2,3,2,0,6,8,5,0,0,5
5702,142679,2022,Poland,USA,0,3,1,4,23/07/2022,0,0,2,2,4,2,4,10,0,1,0,1,4,1,9,14,3,2,1,6
5703,142679,2022,Poland,Iran,0,2,6,8,21/07/2022,1,0,2,3,10,1,7,18,0,1,3,4,5,1,15,21,5,5,0,10
5704,142679,2022,Poland,Slovenia,0,2,4,6,10/07/2022,0,0,0,0,6,0,5,11,2,3,0,5,1,3,14,18,1,1,1,3
5705,142679,2022,Poland,Netherlands,0,1,9,10,09/07/2022,0,0,0,0,5,0,3,8,0,0,0,0,0,1,6,7,2,0,1,3
5706,142679,2022,Poland,China,0,0,0,0,07/07/2022,0,0,0,0,0,0,0,0,0,0,0,0,0,0,0,0,0,0,0,0
5707,142679,2022,Iran,Poland,1,6,10,17,05/07/2022,0,0,3,3,9,0,8,17,0,2,0,2,3,2,28,33,5,3,0,8
5708,142679,2022,USA,Poland,2,2,15,19,26/06/2022,1,0,1,2,10,5,9,24,1,2,0,3,6,4,20,30,1,1,0,2
5709,142679,2022,Poland,Australia,0,2,7,9,25/06/2022,0,0,0,0,7,0,3,10,1,1,2,4,3,0,6,9,2,1,0,3
5710,142679,2022,Poland,Canada,0,0,0,0,23/06/2022,0,0,0,0,0,0,0,0,0,0,0,0,0,0,0,0,0,0,0,0
5711,142679,2022,Brazil,Poland,2,0,12,14,22/06/2022,0,0,1,1,7,1,6,14,0,1,1,2,7,1,18,26,3,0,0,3
5712,152870,2022,Italy,Poland,1,5,9,15,24/07/2022,0,0,1,1,5,0,1,6,0,3,3,6,1,0,0,1,2,0,0,2
5713,152870,2022,Poland,USA,2,1,10,13,23/07/2022,0,0,0,0,4,1,2,7,1,3,4,8,0,0,0,0,3,0,1,4
5714,152870,2022,Poland,Iran,3,2,7,12,21/07/2022,0,0,0,0,1,1,3,5,2,0,2,4,0,0,1,1,2,0,0,2
5715,152870,2022,Poland,Slovenia,1,2,9,12,10/07/2022,0,0,0,0,4,2,1,7,1,1,0,2,0,0,2,2,2,0,0,2
5716,152870,2022,Poland,Netherlands,0,0,0,0,09/07/2022,0,0,0,0,0,0,0,0,0,0,0,0,0,0,0,0,0,0,0,0
5717,152870,2022,Poland,China,3,2,14,19,07/07/2022,0,0,1,1,5,1,2,8,0,1,0,1,0,0,0,0,1,0,0,1
5718,152870,2022,Iran,Poland,0,3,7,10,05/07/2022,0,0,0,0,3,2,4,9,2,3,0,5,0,0,0,0,0,0,0,0
5719,152870,2022,USA,Poland,0,3,5,8,26/06/2022,0,0,1,1,4,0,1,5,4,3,3,10,0,0,1,1,1,1,0,2
5720,152870,2022,Poland,Australia,0,0,0,0,25/06/2022,0,0,0,0,0,0,0,0,0,0,0,0,0,0,0,0,0,0,0,0
5721,152870,2022,Poland,Canada,0,3,2,5,23/06/2022,0,0,0,0,4,1,1,6,0,1,1,2,0,0,0,0,0,0,0,0
5722,152870,2022,Brazil,Poland,0,3,10,13,22/06/2022,0,0,1,1,8,0,4,12,4,3,5,12,1,0,1,2,1,1,1,3
5723,152870,2022,France,Poland,0,2,9,11,12/06/2022,0,0,1,1,7,0,4,11,3,5,7,15,0,0,0,0,2,0,2,4
5724,152870,2022,Bulgaria,Poland,0,0,0,0,11/06/2022,0,0,0,0,0,0,0,0,0,0,0,0,0,0,0,0,0,0,0,0
5725,152870,2022,Poland,Italy,0,4,8,12,09/06/2022,0,0,0,0,4,2,3,9,1,3,2,6,1,0,2,3,1,0,0,1
5726,152870,2022,Poland,Argentina,1,5,9,15,08/06/2022,0,0,1,1,5,0,1,6,1,6,9,16,0,0,0,0,2,0,0,2
5727,153395,2022,Italy,Poland,2,2,12,16,24/07/2022,0,0,0,0,9,0,12,21,1,6,0,7,3,0,4,7,5,1,1,7
5728,153395,2022,Poland,USA,0,3,4,7,23/07/2022,0,0,0,0,7,5,8,20,0,2,0,2,8,0,14,22,4,0,0,4
5729,153395,2022,Poland,Iran,0,3,10,13,21/07/2022,0,0,1,1,15,3,12,30,2,3,2,7,9,1,12,22,4,1,0,5
5730,153395,2022,Poland,Slovenia,1,3,19,23,10/07/2022,0,0,1,1,11,3,11,25,1,0,0,1,0,0,14,14,4,1,0,5
5731,153395,2022,Poland,Netherlands,1,1,5,7,09/07/2022,0,0,0,0,7,0,3,10,2,1,0,3,1,0,7,8,0,0,0,0
5732,153395,2022,Poland,China,0,4,6,10,07/07/2022,0,0,1,1,5,2,3,10,1,3,0,4,3,1,11,15,1,0,0,1
5733,153395,2022,Iran,Poland,0,1,0,1,05/07/2022,0,0,0,0,0,0,1,1,0,0,0,0,0,1,1,2,0,0,0,0
5734,153395,2022,USA,Poland,1,1,14,16,26/06/2022,0,0,1,1,14,3,11,28,0,2,3,5,5,1,16,22,2,2,0,4
5735,153395,2022,Poland,Australia,0,0,0,0,25/06/2022,0,0,0,0,0,0,0,0,0,0,0,0,0,0,0,0,0,0,0,0
5736,153395,2022,Poland,Canada,0,3,8,11,23/06/2022,0,0,0,0,6,0,3,9,0,0,0,0,1,0,6,7,2,0,0,2
5737,153395,2022,Brazil,Poland,4,1,10,15,22/06/2022,0,0,0,0,12,2,10,24,2,2,2,6,3,0,13,16,1,1,0,2
5738,118614,2022,Italy,Poland,0,0,0,0,24/07/2022,0,0,1,1,0,0,0,0,0,0,0,0,6,1,8,15,5,2,0,7
5739,118614,2022,Poland,USA,0,0,0,0,23/07/2022,0,0,1,1,0,0,0,0,0,0,0,0,3,2,3,8,2,2,0,4
5740,118614,2022,Poland,Iran,0,0,0,0,21/07/2022,0,0,2,2,0,0,0,0,0,0,0,0,9,3,12,24,14,5,1,20
5741,118614,2022,Poland,Slovenia,0,0,0,0,10/07/2022,0,0,2,2,0,0,0,0,0,0,0,0,1,4,12,17,5,5,0,10
5742,118614,2022,Poland,Netherlands,0,0,0,0,09/07/2022,0,0,5,5,0,0,0,0,0,0,0,0,4,2,9,15,3,1,1,5
5743,118614,2022,Poland,China,0,0,0,0,07/07/2022,0,0,0,0,0,0,0,0,0,0,0,0,0,0,0,0,0,0,0,0
5744,118614,2022,Iran,Poland,0,0,0,0,05/07/2022,0,0,5,5,0,0,0,0,0,0,0,0,4,3,18,25,6,3,0,9
5745,118614,2022,USA,Poland,0,0,0,0,26/06/2022,0,0,1,1,0,0,0,0,0,0,0,0,2,0,3,5,5,3,1,9
5746,118614,2022,Poland,Australia,0,0,0,0,25/06/2022,1,0,1,2,0,0,0,0,0,0,0,0,4,1,7,12,3,1,1,5
5747,118614,2022,Poland,Canada,0,0,0,0,23/06/2022,0,0,0,0,0,0,0,0,0,0,0,0,0,0,0,0,0,0,0,0
5748,118614,2022,Brazil,Poland,0,0,0,0,22/06/2022,0,0,0,0,0,0,0,0,0,0,0,0,6,0,13,19,5,3,4,12
5749,152873,2022,USA,Poland,1,1,3,5,26/06/2022,0,0,0,0,0,0,1,1,0,0,0,0,0,0,2,2,2,0,0,2
5750,152873,2022,Poland,Australia,0,4,12,16,25/06/2022,1,0,0,1,8,2,4,14,1,3,1,5,7,0,13,20,2,0,2,4
5751,152873,2022,Poland,Canada,0,0,2,2,23/06/2022,0,0,0,0,2,1,2,5,0,0,1,1,0,0,2,2,1,0,0,1
5752,152873,2022,Brazil,Poland,0,0,0,0,22/06/2022,0,0,0,0,0,0,0,0,0,0,0,0,0,0,0,0,0,0,0,0
5753,152873,2022,France,Poland,1,2,10,13,12/06/2022,1,0,3,4,10,1,5,16,0,1,2,3,7,0,19,26,5,2,0,7
5754,152873,2022,Bulgaria,Poland,2,1,12,15,11/06/2022,0,1,2,3,10,2,8,20,0,3,1,4,7,1,14,22,3,1,2,6
5755,152873,2022,Poland,Italy,0,0,3,3,09/06/2022,0,0,0,0,0,1,0,1,0,1,0,1,0,0,2,2,0,0,0,0
5756,152873,2022,Poland,Argentina,0,3,7,10,08/06/2022,0,0,1,1,7,4,4,15,1,2,2,5,6,2,17,25,5,2,1,8
5757,165942,2022,Italy,Poland,0,2,5,7,24/07/2022,13,1,51,65,0,0,0,0,1,2,5,8,0,0,0,0,4,1,0,5
5758,165942,2022,Poland,USA,0,0,5,5,23/07/2022,11,0,50,61,0,0,0,0,1,0,1,2,0,1,0,1,1,0,2,3
5759,165942,2022,Poland,Iran,0,1,11,12,21/07/2022,14,0,66,80,0,0,0,0,0,3,0,3,0,0,0,0,3,2,0,5
5760,165942,2022,Poland,Slovenia,0,2,7,9,10/07/2022,15,0,61,76,0,0,0,0,0,0,0,0,0,0,0,0,0,1,1,2
5761,165942,2022,Poland,Netherlands,0,0,9,9,09/07/2022,12,0,41,53,0,0,0,0,0,4,0,4,0,0,1,1,2,3,1,6
5762,165942,2022,Poland,China,0,0,0,0,07/07/2022,0,0,4,4,0,0,0,0,0,0,0,0,0,0,0,0,0,0,0,0
5763,165942,2022,Iran,Poland,1,2,5,8,05/07/2022,10,0,57,67,0,0,1,1,1,2,1,4,0,0,1,1,1,2,1,4
5764,165942,2022,USA,Poland,0,2,7,9,26/06/2022,18,2,70,90,0,0,0,0,0,0,1,1,0,0,0,0,5,2,0,7
5765,165942,2022,Poland,Australia,0,0,0,0,25/06/2022,3,0,2,5,0,0,0,0,0,0,0,0,0,0,0,0,0,1,0,1
5766,165942,2022,Poland,Canada,2,1,6,9,23/06/2022,12,0,33,45,0,0,1,1,1,4,2,7,0,0,0,0,0,2,0,2
5767,165942,2022,Brazil,Poland,0,1,8,9,22/06/2022,13,0,75,88,1,0,0,1,0,1,1,2,0,0,0,0,4,3,1,8
5768,150734,2022,Italy,Poland,3,1,8,12,24/07/2022,0,0,3,3,6,2,2,10,1,6,5,12,0,0,0,0,1,0,0,1
5769,150734,2022,Poland,USA,1,3,6,10,23/07/2022,0,0,0,0,4,0,2,6,0,2,3,5,0,0,1,1,1,0,0,1
5770,150734,2022,Poland,Iran,1,3,14,18,21/07/2022,0,0,0,0,6,0,3,9,2,2,4,8,1,0,1,2,3,2,0,5
5771,150734,2022,Poland,Slovenia,1,4,15,20,10/07/2022,0,0,0,0,7,0,2,9,1,5,0,6,0,0,1,1,0,0,0,0
5772,150734,2022,Poland,Netherlands,1,2,10,13,09/07/2022,0,0,0,0,6,2,1,9,0,6,1,7,0,0,0,0,0,0,0,0
5773,150734,2022,Poland,China,2,0,1,3,07/07/2022,0,0,0,0,0,0,0,0,0,0,0,0,0,0,0,0,0,1,0,1
5774,150734,2022,Iran,Poland,4,4,14,22,05/07/2022,0,0,0,0,8,2,3,13,5,4,0,9,0,0,0,0,0,0,1,1
5775,150734,2022,USA,Poland,0,4,15,19,26/06/2022,0,0,0,0,8,2,3,13,0,1,4,5,0,0,1,1,1,0,0,1
5776,150734,2022,Poland,Australia,1,2,4,7,25/06/2022,0,0,0,0,6,1,1,8,0,2,2,4,0,0,0,0,1,0,0,1
5777,150734,2022,Poland,Canada,0,1,0,1,23/06/2022,0,0,0,0,0,0,0,0,0,0,0,0,0,0,0,0,0,0,0,0
5778,150734,2022,Brazil,Poland,7,5,16,28,22/06/2022,1,0,0,1,2,1,5,8,0,5,6,11,0,0,0,0,2,0,0,2
5779,152866,2022,Italy,Poland,0,2,3,5,24/07/2022,0,0,3,3,6,0,2,8,0,0,0,0,9,0,8,17,3,0,0,3
5780,152866,2022,Poland,USA,0,2,1,3,23/07/2022,0,0,0,0,2,0,2,4,0,0,0,0,4,2,5,11,1,0,0,1
5781,152866,2022,Poland,Iran,0,2,0,2,21/07/2022,0,0,0,0,0,0,3,3,0,1,0,1,1,1,2,4,0,2,0,2
5782,152866,2022,Poland,Slovenia,1,1,2,4,10/07/2022,0,0,0,0,5,1,2,8,1,0,0,1,2,0,4,6,3,0,0,3
5783,152866,2022,Poland,Netherlands,0,2,4,6,09/07/2022,0,0,0,0,2,1,2,5,0,0,0,0,0,0,8,8,2,0,0,2
5784,152866,2022,Poland,China,5,1,10,16,07/07/2022,0,0,1,1,14,1,2,17,1,3,0,4,3,1,8,12,1,0,0,1
5785,152866,2022,Iran,Poland,2,0,3,5,05/07/2022,0,0,0,0,1,0,0,1,0,0,0,0,0,1,2,3,2,0,0,2
5786,152866,2022,USA,Poland,0,0,0,0,26/06/2022,0,0,0,0,0,0,0,0,0,0,0,0,0,0,0,0,0,0,0,0
5787,152866,2022,Poland,Australia,0,0,2,2,25/06/2022,0,0,1,1,4,0,3,7,0,0,1,1,2,0,1,3,2,0,0,2
5788,152866,2022,Poland,Canada,1,4,8,13,23/06/2022,0,0,3,3,7,2,5,14,1,2,3,6,7,1,9,17,6,1,0,7
5789,152866,2022,Brazil,Poland,0,0,0,0,22/06/2022,0,0,0,0,0,0,0,0,0,0,0,0,0,0,0,0,0,0,0,0
5790,152866,2022,France,Poland,2,4,8,14,12/06/2022,0,0,1,1,12,6,12,30,2,4,4,10,2,3,13,18,6,1,1,8
5791,152866,2022,Bulgaria,Poland,0,0,0,0,11/06/2022,0,0,0,0,0,0,0,0,0,0,0,0,0,0,0,0,0,0,0,0
5792,152866,2022,Poland,Italy,0,8,3,11,09/06/2022,1,0,3,4,10,4,7,21,2,0,10,12,4,0,14,18,2,3,4,9
5793,152866,2022,Poland,Argentina,0,4,8,12,08/06/2022,0,0,5,5,14,1,12,27,0,2,4,6,2,0,10,12,7,1,0,8
5794,183851,2022,France,Poland,0,0,0,0,12/06/2022,0,0,0,0,0,0,0,0,0,0,0,0,0,0,0,0,0,0,0,0
5795,183851,2022,Bulgaria,Poland,1,1,4,6,11/06/2022,0,0,2,2,3,2,3,8,0,3,4,7,0,0,2,2,1,0,1,2
5796,183851,2022,Poland,Italy,0,0,0,0,09/06/2022,0,0,0,0,0,0,0,0,0,0,0,0,0,0,0,0,0,0,0,0
5797,183851,2022,Poland,Argentina,0,0,0,0,08/06/2022,0,0,0,0,0,0,0,0,0,0,0,0,0,0,0,0,0,0,0,0
5798,181100,2022,Italy,Poland,1,1,2,4,24/07/2022,0,0,0,0,0,0,0,0,0,0,0,0,0,0,0,0,1,0,0,1
5799,181100,2022,Poland,USA,0,0,1,1,23/07/2022,0,0,1,1,0,0,0,0,0,0,0,0,0,0,0,0,0,1,0,1
5800,181100,2022,Poland,Iran,0,2,6,8,21/07/2022,0,0,0,0,0,0,0,0,0,0,0,0,0,0,0,0,1,0,0,1
5801,181100,2022,Poland,Slovenia,0,0,0,0,10/07/2022,0,0,0,0,0,0,0,0,0,0,0,0,0,0,0,0,0,0,0,0
5802,181100,2022,Poland,Netherlands,0,2,9,11,09/07/2022,0,0,0,0,9,4,1,14,0,3,0,3,0,0,0,0,1,1,0,2
5803,181100,2022,Poland,China,0,1,0,1,07/07/2022,0,0,0,0,0,1,0,1,0,0,0,0,0,0,0,0,0,0,0,0
5804,181100,2022,Iran,Poland,0,1,0,1,05/07/2022,0,0,0,0,0,0,0,0,0,0,0,0,0,0,0,0,0,0,0,0
5805,181100,2022,France,Poland,3,3,16,22,12/06/2022,0,0,4,4,16,7,6,29,3,3,1,7,0,0,0,0,6,3,2,11
5806,181100,2022,Bulgaria,Poland,0,0,0,0,11/06/2022,0,0,0,0,0,0,0,0,0,0,0,0,0,0,0,0,0,0,0,0
5807,181100,2022,Poland,Italy,2,3,12,17,09/06/2022,0,0,0,0,16,5,5,26,1,4,4,9,0,0,2,2,1,2,3,6
5808,181100,2022,Poland,Argentina,0,2,1,3,08/06/2022,0,0,0,0,3,0,0,3,0,0,0,0,0,0,0,0,1,0,0,1
5809,164127,2022,France,Poland,0,0,0,0,12/06/2022,0,0,0,0,0,0,0,0,0,0,0,0,0,0,0,0,0,0,0,0
5810,164127,2022,Bulgaria,Poland,0,0,0,0,11/06/2022,0,0,4,4,0,0,0,0,0,0,0,0,1,0,6,7,8,2,3,13
5811,164127,2022,Poland,Italy,0,0,0,0,09/06/2022,0,0,0,0,0,0,0,0,0,0,0,0,0,0,0,0,0,0,0,0
5812,164127,2022,Poland,Argentina,0,0,0,0,08/06/2022,0,0,0,0,0,0,0,0,0,0,0,0,0,0,0,0,0,0,0,0
5813,164124,2022,USA,Poland,0,0,0,0,26/06/2022,0,0,0,0,0,0,0,0,0,0,0,0,0,0,0,0,0,0,0,0
5814,164124,2022,Poland,Australia,1,0,4,5,25/06/2022,0,0,0,0,2,0,1,3,1,2,1,4,0,0,0,0,0,0,0,0
5815,164124,2022,Poland,Canada,1,0,4,5,23/06/2022,1,0,0,1,4,0,0,4,0,0,0,0,0,0,0,0,0,0,0,0
5816,164124,2022,Brazil,Poland,0,0,0,0,22/06/2022,0,0,0,0,0,0,0,0,0,0,0,0,0,0,0,0,0,0,0,0
5817,164124,2022,France,Poland,1,1,12,14,12/06/2022,0,0,3,3,2,0,1,3,0,2,3,5,0,0,0,0,1,1,1,3
5818,164124,2022,Bulgaria,Poland,1,0,12,13,11/06/2022,0,0,0,0,4,1,0,5,1,4,4,9,1,0,0,1,1,1,1,3
5819,164124,2022,Poland,Italy,2,3,14,19,09/06/2022,0,0,1,1,4,3,2,9,2,6,3,11,0,0,1,1,5,0,2,7
5820,164124,2022,Poland,Argentina,0,0,0,0,08/06/2022,0,0,0,0,0,0,0,0,0,0,0,0,0,0,0,0,0,0,0,0
5821,153387,2022,Poland,Slovenia,0,0,0,0,10/07/2022,5,0,4,9,0,0,0,0,0,0,0,0,0,0,0,0,0,0,0,0
5822,153387,2022,Poland,Netherlands,0,0,0,0,09/07/2022,1,0,0,1,0,0,0,0,0,0,0,0,0,0,0,0,0,0,0,0
5823,153387,2022,Poland,China,0,0,6,6,07/07/2022,17,0,33,50,1,0,0,1,1,1,0,2,0,0,1,1,0,1,0,1
5824,153387,2022,Iran,Poland,0,0,2,2,05/07/2022,3,1,26,30,0,0,0,0,0,0,0,0,0,0,0,0,1,2,0,3
5825,153387,2022,France,Poland,0,1,13,14,12/06/2022,25,0,55,80,0,0,1,1,0,3,3,6,0,1,0,1,5,7,4,16
5826,153387,2022,Bulgaria,Poland,0,0,0,0,11/06/2022,0,0,0,0,0,0,0,0,0,0,0,0,0,0,0,0,0,0,0,0
5827,153387,2022,Poland,Italy,0,4,8,12,09/06/2022,43,1,36,80,0,0,2,2,0,5,1,6,0,0,0,0,6,1,1,8
5828,153387,2022,Poland,Argentina,1,0,11,12,08/06/2022,26,0,40,66,2,0,0,2,1,2,3,6,0,1,1,2,9,4,0,13
5829,152869,2022,,,-,-,-,-,-,-,-,-,-,-,-,-,-,-,-,-,-,-,-,-,-,-,-,-,-
5830,181313,2022,Germany,Serbia,0,0,0,0,11/06/2022,0,0,0,0,0,0,0,0,0,0,0,0,0,0,0,0,0,0,0,0
5831,181313,2022,Serbia,Argentina,0,0,0,0,10/06/2022,0,0,0,0,0,0,1,1,0,1,0,1,0,0,0,0,0,0,0,0
5832,181313,2022,Serbia,France,0,2,11,13,09/06/2022,2,0,0,2,2,0,1,3,1,2,3,6,0,0,3,3,1,2,1,4
5833,181313,2022,Bulgaria,Serbia,0,0,0,0,07/06/2022,0,0,0,0,0,0,0,0,0,0,0,0,0,0,0,0,0,0,0,0
5834,120250,2022,China,Serbia,0,0,0,0,10/07/2022,0,0,0,0,0,0,0,0,0,0,0,0,0,0,0,0,0,0,0,0
5835,120250,2022,Iran,Serbia,0,0,0,0,09/07/2022,0,0,0,0,0,0,0,0,0,0,0,0,0,0,0,0,0,0,0,0
5836,120250,2022,Italy,Serbia,0,2,5,7,08/07/2022,0,0,1,1,7,4,8,19,1,0,0,1,2,2,21,25,0,0,1,1
5837,120250,2022,Slovenia,Serbia,0,0,0,0,06/07/2022,0,0,0,0,0,0,0,0,0,0,0,0,0,0,0,0,0,0,0,0
5838,120250,2022,Serbia,Australia,0,0,0,0,26/06/2022,0,0,0,0,0,0,0,0,0,0,0,0,0,0,0,0,0,0,0,0
5839,120250,2022,Serbia,Canada,0,0,0,0,24/06/2022,0,0,0,0,0,0,0,0,0,0,0,0,0,0,0,0,0,1,0,1
5840,120250,2022,Serbia,Brazil,0,0,0,0,23/06/2022,0,0,0,0,0,0,0,0,0,0,0,0,0,0,0,0,0,0,0,0
5841,120250,2022,Serbia,USA,0,0,0,0,22/06/2022,0,0,0,0,0,0,0,0,0,0,0,0,0,0,0,0,0,0,0,0
5842,132458,2022,China,Serbia,0,0,0,0,10/07/2022,0,0,0,0,0,0,0,0,0,0,0,0,0,0,0,0,0,0,0,0
5843,132458,2022,Iran,Serbia,0,0,0,0,09/07/2022,0,0,0,0,0,0,0,0,0,0,0,0,0,1,0,1,0,0,0,0
5844,132458,2022,Italy,Serbia,0,0,0,0,08/07/2022,0,0,0,0,0,0,0,0,0,0,0,0,0,0,0,0,0,0,0,0
5845,132458,2022,Slovenia,Serbia,0,1,1,2,06/07/2022,0,0,1,1,1,1,3,5,0,1,0,1,1,1,0,2,0,0,0,0
5846,132458,2022,Serbia,Australia,0,0,0,0,26/06/2022,0,0,1,1,0,0,0,0,0,0,0,0,1,0,2,3,1,0,0,1
5847,132458,2022,Serbia,Canada,0,2,10,12,24/06/2022,0,0,0,0,6,2,4,12,0,1,1,2,2,2,6,10,2,2,0,4
5848,132458,2022,Serbia,Brazil,0,1,9,10,23/06/2022,0,0,1,1,6,2,9,17,1,1,2,4,7,1,9,17,0,2,0,2
5849,132458,2022,Serbia,USA,0,0,4,4,22/06/2022,0,0,0,0,2,0,1,3,1,0,0,1,1,0,5,6,0,0,0,0
5850,132458,2022,Germany,Serbia,0,0,0,0,11/06/2022,0,0,1,1,1,0,0,1,0,0,1,1,0,0,6,6,0,0,0,0
5851,132458,2022,Serbia,Argentina,1,0,4,5,10/06/2022,0,0,3,3,0,0,2,2,0,0,1,1,1,0,4,5,0,1,0,1
5852,132458,2022,Serbia,France,0,0,0,0,09/06/2022,0,0,1,1,0,0,1,1,0,0,2,2,1,0,2,3,0,0,0,0
5853,132458,2022,Bulgaria,Serbia,0,0,6,6,07/06/2022,0,0,4,4,7,0,4,11,0,2,0,2,1,0,7,8,1,2,1,4
5854,150383,2022,China,Serbia,0,0,0,0,10/07/2022,0,0,3,3,0,0,0,0,0,0,0,0,6,0,10,16,7,4,0,11
5855,150383,2022,Iran,Serbia,0,0,0,0,09/07/2022,0,0,0,0,0,0,0,0,0,0,0,0,0,0,0,0,1,0,0,1
5856,150383,2022,Italy,Serbia,0,0,0,0,08/07/2022,0,0,0,0,0,0,0,0,0,0,0,0,0,0,0,0,1,0,0,1
5857,150383,2022,Slovenia,Serbia,0,0,0,0,06/07/2022,0,0,1,1,0,0,0,0,0,0,0,0,2,1,13,16,4,2,0,6
5858,150383,2022,Serbia,Australia,0,0,0,0,26/06/2022,0,0,0,0,0,0,0,0,0,0,0,0,0,0,0,0,0,0,0,0
5859,150383,2022,Serbia,Canada,0,0,0,0,24/06/2022,0,1,2,3,0,0,0,0,0,0,0,0,5,0,15,20,8,3,0,11
5860,150383,2022,Serbia,Brazil,0,0,0,0,23/06/2022,0,0,0,0,0,0,0,0,0,0,0,0,0,0,0,0,2,0,1,3
5861,150383,2022,Serbia,USA,0,0,0,0,22/06/2022,0,0,0,0,0,0,0,0,0,0,0,0,1,0,17,18,4,1,2,7
5862,150383,2022,Germany,Serbia,0,0,0,0,11/06/2022,0,0,2,2,0,0,0,0,0,0,0,0,0,0,0,0,9,1,2,12
5863,150383,2022,Serbia,Argentina,0,0,0,0,10/06/2022,0,0,5,5,0,0,0,0,0,0,0,0,5,2,13,20,6,3,4,13
5864,150383,2022,Serbia,France,0,0,0,0,09/06/2022,1,0,9,10,0,0,0,0,0,0,0,0,1,4,16,21,14,4,4,22
5865,150383,2022,Bulgaria,Serbia,0,0,0,0,07/06/2022,0,0,3,3,0,0,0,0,0,0,0,0,0,0,0,0,1,12,5,18
5866,146579,2022,China,Serbia,0,1,12,13,10/07/2022,0,1,2,3,5,2,1,8,1,8,0,9,0,0,1,1,3,0,1,4
5867,146579,2022,Iran,Serbia,0,0,1,1,09/07/2022,0,0,0,0,0,0,0,0,0,0,0,0,0,0,0,0,0,0,0,0
5868,146579,2022,Italy,Serbia,0,0,5,5,08/07/2022,0,0,0,0,0,1,3,4,0,0,0,0,0,0,2,2,0,1,0,1
5869,146579,2022,Slovenia,Serbia,0,0,1,1,06/07/2022,0,0,0,0,0,0,0,0,0,0,0,0,0,0,0,0,0,1,0,1
5870,146579,2022,Serbia,Australia,0,0,0,0,26/06/2022,0,0,0,0,0,0,0,0,0,0,0,0,0,0,0,0,0,0,0,0
5871,146579,2022,Serbia,Canada,0,0,2,2,24/06/2022,0,0,0,0,0,0,0,0,0,0,0,0,0,0,0,0,0,0,0,0
5872,146579,2022,Serbia,Brazil,0,3,5,8,23/06/2022,0,0,0,0,4,0,2,6,0,4,5,9,0,0,1,1,1,0,0,1
5873,146579,2022,Serbia,USA,0,1,3,4,22/06/2022,0,0,1,1,0,0,0,0,0,0,0,0,0,0,0,0,0,1,0,1
5874,132022,2022,,,-,-,-,-,-,-,-,-,-,-,-,-,-,-,-,-,-,-,-,-,-,-,-,-,-
5875,124911,2022,China,Serbia,0,0,0,0,10/07/2022,0,0,0,0,0,0,0,0,0,0,0,0,0,0,0,0,0,0,0,0
5876,124911,2022,Iran,Serbia,0,0,10,10,09/07/2022,14,0,64,78,0,0,0,0,0,0,1,1,0,0,1,1,2,1,1,4
5877,124911,2022,Italy,Serbia,0,0,7,7,08/07/2022,14,0,71,85,0,0,0,0,0,1,0,1,0,0,0,0,0,1,0,1
5878,124911,2022,Slovenia,Serbia,0,1,7,8,06/07/2022,15,2,59,76,0,0,1,1,0,1,0,1,0,0,0,0,2,0,0,2
5879,124911,2022,Serbia,Australia,0,0,10,10,26/06/2022,25,0,47,72,2,0,0,2,0,2,1,3,0,0,0,0,3,1,0,4
5880,124911,2022,Serbia,Canada,0,1,11,12,24/06/2022,31,0,56,87,1,0,0,1,0,2,1,3,0,0,0,0,2,3,0,5
5881,124911,2022,Serbia,Brazil,0,0,0,0,23/06/2022,0,0,0,0,0,0,0,0,0,0,0,0,0,0,0,0,0,0,0,0
5882,124911,2022,Serbia,USA,0,1,8,9,22/06/2022,23,0,56,79,0,0,0,0,0,2,1,3,0,1,0,1,2,3,0,5
5883,124911,2022,Germany,Serbia,0,0,13,13,11/06/2022,13,0,99,112,4,1,0,5,1,3,3,7,0,1,0,1,4,3,4,11
5884,124911,2022,Serbia,Argentina,1,0,13,14,10/06/2022,36,0,35,71,0,0,1,1,2,3,7,12,0,0,0,0,3,3,3,9
5885,124911,2022,Serbia,France,0,0,0,0,09/06/2022,0,0,0,0,0,0,0,0,0,0,0,0,0,0,0,0,0,0,0,0
5886,124911,2022,Bulgaria,Serbia,0,0,14,14,07/06/2022,32,0,56,88,0,0,1,1,0,2,4,6,0,0,0,0,0,3,6,9
5887,162122,2022,China,Serbia,1,2,18,21,10/07/2022,0,0,0,0,9,2,2,13,0,3,0,3,1,0,13,14,5,0,1,6
5888,162122,2022,Iran,Serbia,1,2,8,11,09/07/2022,0,0,2,2,7,4,6,17,1,0,0,1,1,0,28,29,2,0,0,2
5889,162122,2022,Italy,Serbia,0,2,3,5,08/07/2022,0,0,1,1,3,7,5,15,1,0,0,1,0,1,7,8,1,0,0,1
5890,162122,2022,Slovenia,Serbia,0,2,5,7,06/07/2022,0,0,0,0,4,3,5,12,0,0,0,0,0,2,11,13,3,1,0,4
5891,162122,2022,Serbia,Australia,0,3,10,13,26/06/2022,0,0,0,0,13,2,2,17,0,1,0,1,4,0,7,11,0,1,0,1
5892,162122,2022,Serbia,Canada,2,5,10,17,24/06/2022,0,0,1,1,12,4,5,21,1,2,1,4,7,4,32,43,2,2,0,4
5893,162122,2022,Serbia,Brazil,0,0,1,1,23/06/2022,0,0,0,0,2,2,0,4,0,2,0,2,0,0,1,1,0,0,0,0
5894,162122,2022,Serbia,USA,1,5,11,17,22/06/2022,0,0,0,0,11,0,7,18,0,3,0,3,9,2,21,32,2,1,2,5
5895,162122,2022,Germany,Serbia,3,6,12,21,11/06/2022,0,0,1,1,13,7,13,33,0,1,0,1,8,3,30,41,9,1,2,12
5896,162122,2022,Serbia,Argentina,1,0,9,10,10/06/2022,0,0,1,1,11,2,7,20,2,3,1,6,4,4,22,30,3,4,1,8
5897,162122,2022,Serbia,France,0,0,0,0,09/06/2022,0,0,0,0,0,0,0,0,0,0,0,0,0,0,0,0,0,0,0,0
5898,162122,2022,Bulgaria,Serbia,6,2,17,25,07/06/2022,0,0,1,1,13,6,6,25,1,1,2,4,2,2,21,25,6,5,5,16
5899,173251,2022,China,Serbia,1,3,13,17,10/07/2022,0,0,2,2,12,2,10,24,2,4,0,6,3,2,25,30,2,2,0,4
5900,173251,2022,Iran,Serbia,0,3,7,10,09/07/2022,0,0,1,1,10,7,9,26,0,3,0,3,0,2,19,21,0,0,0,0
5901,173251,2022,Italy,Serbia,0,1,3,4,08/07/2022,0,0,2,2,4,4,2,10,0,0,0,0,1,0,10,11,0,0,0,0
5902,173251,2022,Slovenia,Serbia,2,1,9,12,06/07/2022,0,0,1,1,7,3,12,22,1,0,0,1,3,0,28,31,0,0,2,2
5903,173251,2022,Serbia,Australia,0,0,10,10,26/06/2022,0,0,0,0,10,2,3,15,1,1,1,3,3,1,21,25,1,1,0,2
5904,173251,2022,Serbia,Canada,0,2,3,5,24/06/2022,0,0,0,0,1,3,2,6,1,0,1,2,0,2,4,6,2,1,0,3
5905,173251,2022,Serbia,Brazil,1,5,3,9,23/06/2022,0,0,2,2,4,2,10,16,1,2,2,5,4,5,13,22,4,0,0,4
5906,173251,2022,Serbia,USA,1,5,5,11,22/06/2022,0,0,1,1,14,3,6,23,1,1,0,2,1,2,18,21,0,1,1,2
5907,173251,2022,Germany,Serbia,3,6,11,20,11/06/2022,0,0,7,7,18,4,14,36,1,0,4,5,1,3,17,21,5,1,3,9
5908,173251,2022,Serbia,Argentina,1,2,9,12,10/06/2022,0,1,0,1,9,5,7,21,2,4,2,8,0,2,14,16,6,5,1,12
5909,173251,2022,Serbia,France,1,3,13,17,09/06/2022,0,1,2,3,19,3,14,36,1,2,5,8,2,2,14,18,10,3,1,14
5910,173251,2022,Bulgaria,Serbia,0,0,1,1,07/06/2022,0,0,0,0,1,1,0,2,0,0,0,0,0,0,2,2,0,0,0,0
5911,124915,2022,China,Serbia,0,0,0,0,10/07/2022,0,0,0,0,0,0,0,0,0,0,0,0,0,0,0,0,0,0,0,0
5912,124915,2022,Iran,Serbia,0,2,11,13,09/07/2022,0,0,1,1,14,5,7,26,0,0,0,0,0,0,0,0,2,1,0,3
5913,124915,2022,Italy,Serbia,2,3,5,10,08/07/2022,0,0,0,0,12,8,11,31,0,1,0,1,0,0,0,0,1,1,2,4
5914,124915,2022,Slovenia,Serbia,0,5,6,11,06/07/2022,0,0,0,0,11,4,9,24,0,2,0,2,0,0,0,0,0,2,0,2
5915,124915,2022,Serbia,Australia,0,4,10,14,26/06/2022,0,0,0,0,14,5,7,26,1,2,4,7,0,0,1,1,3,2,1,6
5916,124915,2022,Serbia,Canada,1,6,15,22,24/06/2022,0,0,3,3,21,6,9,36,0,2,3,5,0,0,0,0,1,4,2,7
5917,124915,2022,Serbia,Brazil,0,0,0,0,23/06/2022,0,0,0,0,0,0,0,0,0,0,0,0,0,0,0,0,0,0,0,0
5918,124915,2022,Serbia,USA,3,4,9,16,22/06/2022,0,0,0,0,17,5,4,26,0,3,0,3,0,0,1,1,0,2,0,2
5919,150382,2022,China,Serbia,0,0,11,11,10/07/2022,0,0,0,0,5,1,6,12,3,3,2,8,0,0,0,0,1,0,0,1
5920,150382,2022,Iran,Serbia,0,0,0,0,09/07/2022,0,0,1,1,0,0,0,0,0,0,0,0,0,0,0,0,0,0,0,0
5921,150382,2022,Italy,Serbia,0,0,8,8,08/07/2022,0,0,0,0,5,1,3,9,0,3,0,3,0,0,0,0,1,2,0,3
5922,150382,2022,Slovenia,Serbia,0,0,0,0,06/07/2022,0,0,0,0,0,0,0,0,0,0,0,0,0,0,0,0,0,0,0,0
5923,150382,2022,Serbia,Australia,0,0,0,0,26/06/2022,0,0,0,0,0,0,0,0,0,0,0,0,0,0,0,0,0,0,0,0
5924,150382,2022,Serbia,Canada,0,1,7,8,24/06/2022,0,0,0,0,3,2,2,7,0,4,1,5,0,0,1,1,0,0,1,1
5925,150382,2022,Serbia,Brazil,1,0,11,12,23/06/2022,0,0,0,0,4,0,3,7,0,2,1,3,0,0,1,1,1,0,1,2
5926,150382,2022,Serbia,USA,0,0,1,1,22/06/2022,1,0,0,1,0,0,1,1,0,1,1,2,0,0,0,0,0,0,0,0
5927,150382,2022,Germany,Serbia,0,0,16,16,11/06/2022,0,0,3,3,9,0,6,15,4,8,13,25,0,0,1,1,5,1,2,8
5928,150382,2022,Serbia,Argentina,0,1,21,22,10/06/2022,0,0,2,2,9,0,3,12,2,4,10,16,0,0,1,1,0,0,1,1
5929,150382,2022,Serbia,France,0,0,10,10,09/06/2022,0,0,2,2,9,1,2,12,2,4,8,14,0,0,0,0,3,1,1,5
5930,150382,2022,Bulgaria,Serbia,1,1,11,13,07/06/2022,0,0,0,0,8,0,3,11,0,6,4,10,0,0,1,1,1,2,1,4
5931,116525,2022,China,Serbia,0,0,0,0,10/07/2022,0,0,0,0,0,0,0,0,0,0,0,0,0,0,0,0,0,0,0,0
5932,116525,2022,Iran,Serbia,0,1,9,10,09/07/2022,0,0,0,0,4,1,2,7,4,4,1,9,0,0,1,1,0,1,0,1
5933,116525,2022,Italy,Serbia,0,0,0,0,08/07/2022,0,0,0,0,0,0,0,0,0,0,0,0,0,0,0,0,0,0,0,0
5934,116525,2022,Slovenia,Serbia,0,1,5,6,06/07/2022,1,0,0,1,4,0,1,5,2,5,0,7,0,0,0,0,0,1,0,1
5935,116525,2022,Serbia,Australia,1,1,13,15,26/06/2022,0,0,0,0,4,0,3,7,1,5,2,8,0,0,0,0,3,0,0,3
5936,116525,2022,Serbia,Canada,0,1,6,7,24/06/2022,0,0,0,0,2,0,0,2,1,2,0,3,0,0,0,0,1,0,0,1
5937,116525,2022,Serbia,Brazil,0,0,0,0,23/06/2022,0,0,0,0,0,0,0,0,0,0,0,0,0,0,0,0,0,0,0,0
5938,116525,2022,Serbia,USA,1,2,11,14,22/06/2022,0,0,1,1,4,2,5,11,0,4,1,5,0,0,1,1,2,0,0,2
5939,136362,2022,China,Serbia,0,0,1,1,10/07/2022,0,0,0,0,0,0,0,0,0,0,0,0,0,0,0,0,0,0,0,0
5940,136362,2022,Iran,Serbia,0,1,10,11,09/07/2022,0,0,0,0,4,1,0,5,1,3,0,4,0,0,1,1,1,0,0,1
5941,136362,2022,Italy,Serbia,0,0,12,12,08/07/2022,0,0,0,0,3,0,1,4,1,0,0,1,0,0,1,1,0,0,1,1
5942,136362,2022,Slovenia,Serbia,0,5,7,12,06/07/2022,0,0,1,1,9,1,2,12,0,3,0,3,0,0,0,0,0,0,0,0
5943,136362,2022,Serbia,Australia,1,2,8,11,26/06/2022,1,0,0,1,8,1,3,12,2,5,1,8,0,0,0,0,2,0,1,3
5944,136362,2022,Serbia,Canada,0,3,14,17,24/06/2022,0,0,0,0,12,1,3,16,3,7,1,11,0,0,0,0,0,0,0,0
5945,136362,2022,Serbia,Brazil,0,0,0,0,23/06/2022,0,0,0,0,0,0,0,0,0,0,0,0,0,0,0,0,0,0,0,0
5946,136362,2022,Serbia,USA,0,2,7,9,22/06/2022,0,0,0,0,4,0,3,7,1,6,4,11,0,0,1,1,0,0,0,0
5947,173250,2022,China,Serbia,0,1,14,15,10/07/2022,20,0,63,83,1,0,0,1,0,3,0,3,0,0,0,0,1,0,1,2
5948,173250,2022,Iran,Serbia,0,0,0,0,09/07/2022,0,0,0,0,0,0,0,0,0,0,0,0,0,0,0,0,0,0,0,0
5949,173250,2022,Italy,Serbia,0,0,1,1,08/07/2022,0,0,4,4,0,0,0,0,0,0,0,0,0,0,0,0,0,0,0,0
5950,173250,2022,Slovenia,Serbia,0,0,0,0,06/07/2022,0,0,4,4,0,0,0,0,0,0,0,0,0,0,0,0,0,0,0,0
5951,173250,2022,Germany,Serbia,0,0,0,0,11/06/2022,0,0,0,0,0,0,0,0,0,0,0,0,0,0,0,0,0,0,0,0
5952,173250,2022,Serbia,Argentina,0,0,1,1,10/06/2022,5,0,4,9,0,0,0,0,0,0,1,1,0,0,0,0,2,0,0,2
5953,173250,2022,Serbia,France,0,1,13,14,09/06/2022,22,0,64,86,0,0,0,0,0,1,3,4,0,1,3,4,5,2,4,11
5954,173250,2022,Bulgaria,Serbia,0,0,0,0,07/06/2022,0,0,0,0,0,0,0,0,0,0,0,0,0,0,0,0,0,0,0,0
5955,168275,2022,,,-,-,-,-,-,-,-,-,-,-,-,-,-,-,-,-,-,-,-,-,-,-,-,-,-
5956,168276,2022,China,Serbia,4,4,11,19,10/07/2022,0,1,0,1,12,6,12,30,2,1,0,3,0,0,0,0,2,0,1,3
5957,168276,2022,Iran,Serbia,0,0,1,1,09/07/2022,0,0,0,0,1,3,1,5,0,1,0,1,0,1,0,1,0,0,0,0
5958,168276,2022,Italy,Serbia,0,0,0,0,08/07/2022,0,0,0,0,0,0,0,0,0,0,0,0,0,0,0,0,0,0,0,0
5959,168276,2022,Slovenia,Serbia,0,0,0,0,06/07/2022,0,0,0,0,0,2,1,3,0,0,0,0,0,0,0,0,0,0,0,0
5960,173252,2022,,,-,-,-,-,-,-,-,-,-,-,-,-,-,-,-,-,-,-,-,-,-,-,-,-,-
5961,189274,2022,Germany,Serbia,0,0,0,0,11/06/2022,0,0,0,0,0,0,0,0,0,0,0,0,0,0,0,0,0,0,0,0
5962,189274,2022,Serbia,Argentina,0,0,1,1,10/06/2022,0,1,1,2,0,0,0,0,0,0,0,0,0,0,0,0,0,0,0,0
5963,189274,2022,Serbia,France,0,4,10,14,09/06/2022,1,0,3,4,8,7,6,21,1,1,6,8,5,3,19,27,6,1,1,8
5964,189274,2022,Bulgaria,Serbia,0,3,2,5,07/06/2022,0,0,2,2,3,4,3,10,0,2,3,5,1,0,9,10,1,1,0,2
5965,164985,2022,Germany,Serbia,0,0,24,24,11/06/2022,0,1,1,2,6,2,3,11,2,12,8,22,0,0,0,0,5,2,0,7
5966,164985,2022,Serbia,Argentina,2,1,14,17,10/06/2022,0,0,0,0,6,3,2,11,2,5,8,15,0,0,0,0,0,0,0,0
5967,164985,2022,Serbia,France,0,0,2,2,09/06/2022,0,0,0,0,1,0,0,1,0,1,0,1,0,0,0,0,0,2,0,2
5968,164985,2022,Bulgaria,Serbia,1,0,16,17,07/06/2022,0,1,0,1,5,1,4,10,3,3,4,10,0,0,1,1,2,4,0,6
5969,124920,2022,China,Serbia,0,0,0,0,10/07/2022,0,0,0,0,0,0,0,0,0,0,0,0,0,0,0,0,0,0,0,0
5970,124920,2022,Iran,Serbia,0,0,0,0,09/07/2022,0,0,4,4,0,0,0,0,0,0,0,0,1,3,13,17,4,3,0,7
5971,124920,2022,Italy,Serbia,0,0,0,0,08/07/2022,0,0,1,1,0,0,0,0,0,0,0,0,0,3,14,17,2,1,0,3
5972,124920,2022,Slovenia,Serbia,0,0,0,0,06/07/2022,0,0,0,0,0,0,0,0,0,0,0,0,0,0,0,0,0,0,0,0
5973,124920,2022,Serbia,Australia,0,0,0,0,26/06/2022,0,0,1,1,0,0,0,0,0,0,0,0,3,0,5,8,5,3,0,8
5974,124920,2022,Serbia,Canada,0,0,0,0,24/06/2022,0,0,0,0,0,0,0,0,0,0,0,0,0,0,0,0,0,0,0,0
5975,124920,2022,Serbia,Brazil,0,0,0,0,23/06/2022,0,0,3,3,0,0,0,0,0,0,0,0,6,1,12,19,1,2,0,3
5976,124920,2022,Serbia,USA,0,0,0,0,22/06/2022,0,0,0,0,0,0,0,0,0,0,0,0,0,0,0,0,0,0,0,0
5977,124920,2022,Germany,Serbia,0,0,0,0,11/06/2022,0,1,3,4,0,0,0,0,0,0,0,0,6,2,18,26,8,0,0,8
5978,124920,2022,Serbia,Argentina,0,0,0,0,10/06/2022,0,0,0,0,0,0,0,0,0,0,0,0,0,0,0,0,0,0,0,0
5979,124920,2022,Serbia,France,0,0,0,0,09/06/2022,0,0,0,0,0,0,0,0,0,0,0,0,0,0,0,0,0,0,0,0
5980,124920,2022,Bulgaria,Serbia,0,0,0,0,07/06/2022,0,0,3,3,0,0,0,0,0,0,0,0,6,1,20,27,3,1,1,5
5981,189272,2022,Serbia,Australia,0,0,0,0,26/06/2022,0,0,0,0,0,0,0,0,0,0,0,0,0,0,0,0,0,0,0,0
5982,189272,2022,Serbia,Canada,0,0,0,0,24/06/2022,0,0,0,0,0,0,0,0,0,0,0,0,0,0,0,0,0,0,0,0
5983,189272,2022,Serbia,Brazil,1,5,5,11,23/06/2022,0,0,1,1,13,8,5,26,0,1,1,2,0,0,0,0,3,1,1,5
5984,189272,2022,Serbia,USA,0,1,5,6,22/06/2022,0,0,0,0,4,3,0,7,0,0,0,0,0,0,0,0,1,0,0,1
5985,189272,2022,Germany,Serbia,0,0,0,0,11/06/2022,0,0,0,0,0,0,0,0,0,0,0,0,0,0,0,0,0,0,0,0
5986,189272,2022,Serbia,Argentina,0,1,1,2,10/06/2022,0,0,0,0,3,1,0,4,0,0,0,0,0,0,0,0,0,1,0,1
5987,189272,2022,Serbia,France,1,6,9,16,09/06/2022,0,0,3,3,18,6,14,38,1,4,2,7,0,0,0,0,1,3,4,8
5988,189272,2022,Bulgaria,Serbia,0,0,1,1,07/06/2022,0,0,0,0,4,0,0,4,0,0,0,0,0,0,0,0,0,1,0,1
5989,124912,2022,Germany,Serbia,4,5,16,25,11/06/2022,0,0,6,6,20,11,9,40,1,4,5,10,0,0,0,0,7,4,2,13
5990,124912,2022,Serbia,Argentina,0,3,6,9,10/06/2022,0,0,0,0,9,5,10,24,1,0,4,5,0,0,0,0,4,2,1,7
5991,124912,2022,Serbia,France,1,1,3,5,09/06/2022,0,0,0,0,0,0,0,0,0,0,0,0,0,0,0,0,0,1,0,1
5992,124912,2022,Bulgaria,Serbia,0,2,9,11,07/06/2022,0,1,2,3,13,9,9,31,0,1,1,2,0,0,0,0,4,2,5,11
5993,189276,2022,Germany,Serbia,0,1,0,1,11/06/2022,0,0,0,0,0,0,0,0,0,0,0,0,0,0,0,0,0,0,0,0
5994,189276,2022,Serbia,Argentina,0,0,0,0,10/06/2022,0,0,0,0,0,0,0,0,0,0,0,0,0,0,0,0,0,0,0,0
5995,189276,2022,Serbia,France,0,0,3,3,09/06/2022,0,0,0,0,0,0,0,0,0,0,0,0,0,0,0,0,0,2,0,2
5996,189276,2022,Bulgaria,Serbia,0,0,0,0,07/06/2022,0,0,0,0,0,0,0,0,0,0,0,0,0,0,0,0,0,0,0,0
5997,166724,2022,Serbia,Australia,0,0,0,0,26/06/2022,0,0,0,0,0,0,0,0,0,0,0,0,0,0,0,0,0,0,0,0
5998,166724,2022,Serbia,Canada,0,0,2,2,24/06/2022,0,0,6,6,0,0,0,0,0,0,0,0,0,0,0,0,1,0,0,1
5999,166724,2022,Serbia,Brazil,0,0,9,9,23/06/2022,13,3,57,73,0,0,2,2,1,0,1,2,0,1,0,1,0,3,0,3
6000,166724,2022,Serbia,USA,0,1,1,2,22/06/2022,1,0,13,14,1,0,0,1,0,0,0,0,0,0,0,0,0,2,2,4
6001,189278,2022,,,-,-,-,-,-,-,-,-,-,-,-,-,-,-,-,-,-,-,-,-,-,-,-,-,-
6002,151390,2022,Poland,Slovenia,3,5,7,15,10/07/2022,0,0,2,2,15,5,4,24,2,6,0,8,0,0,1,1,3,0,2,5
6003,151390,2022,Slovenia,Iran,1,3,7,11,08/07/2022,0,0,0,0,5,3,4,12,1,3,0,4,0,0,1,1,2,2,0,4
6004,151390,2022,Bulgaria,Slovenia,3,3,16,22,07/07/2022,0,0,0,0,14,10,8,32,1,0,0,1,0,0,0,0,2,0,1,3
6005,151390,2022,Slovenia,Serbia,1,2,12,15,06/07/2022,0,0,1,1,8,4,6,18,1,0,0,1,0,0,0,0,1,0,0,1
6006,151390,2022,Japan,Slovenia,1,4,10,15,26/06/2022,0,0,2,2,14,9,3,26,1,6,3,10,0,0,0,0,3,2,0,5
6007,151390,2022,Italy,Slovenia,0,0,4,4,25/06/2022,0,0,0,0,1,0,0,1,0,0,1,1,0,0,0,0,1,0,0,1
6008,151390,2022,Slovenia,China,0,0,2,2,11/06/2022,0,0,0,0,4,1,3,8,0,1,2,3,0,0,0,0,1,0,0,1
6009,151390,2022,Australia,Slovenia,1,4,6,11,11/06/2022,0,0,0,0,9,5,5,19,0,4,1,5,0,0,0,0,2,1,1,4
6010,151390,2022,Brazil,Slovenia,0,1,0,1,10/06/2022,0,0,0,0,1,1,2,4,1,1,0,2,0,0,0,0,0,0,0,0
6011,151390,2022,Slovenia,USA,1,3,4,8,08/06/2022,0,0,2,2,7,6,9,22,0,2,2,4,0,0,0,0,4,2,0,6
6012,114962,2022,Poland,Slovenia,1,3,10,14,10/07/2022,0,0,0,0,6,1,3,10,2,2,0,4,0,0,1,1,1,0,1,2
6013,114962,2022,Slovenia,Iran,0,2,2,4,08/07/2022,0,0,0,0,1,1,1,3,0,1,0,1,0,0,0,0,0,0,0,0
6014,114962,2022,Bulgaria,Slovenia,0,3,12,15,07/07/2022,0,0,0,0,6,0,2,8,3,0,1,4,0,0,1,1,1,2,0,3
6015,114962,2022,Slovenia,Serbia,0,3,9,12,06/07/2022,0,0,0,0,6,1,1,8,1,3,0,4,0,0,0,0,1,0,0,1
6016,114962,2022,Japan,Slovenia,0,6,4,10,26/06/2022,1,0,0,1,6,1,3,10,2,3,6,11,0,0,0,0,2,0,0,2
6017,114962,2022,Italy,Slovenia,0,0,0,0,25/06/2022,0,0,0,0,0,0,0,0,0,0,0,0,0,0,0,0,0,0,0,0
6018,114962,2022,Argentina,Slovenia,0,2,11,13,23/06/2022,1,0,1,2,6,2,5,13,0,2,6,8,0,0,0,0,2,1,0,3
6019,114962,2022,Slovenia,Netherlands,1,2,8,11,21/06/2022,0,0,1,1,5,1,5,11,0,3,5,8,0,0,1,1,2,0,0,2
6020,114962,2022,Slovenia,China,0,1,3,4,11/06/2022,1,0,0,1,5,0,0,5,1,1,2,4,0,0,1,1,1,1,1,3
6021,114962,2022,Australia,Slovenia,0,0,0,0,11/06/2022,0,0,0,0,0,0,0,0,0,0,0,0,0,0,0,0,0,0,0,0
6022,114962,2022,Brazil,Slovenia,0,4,6,10,10/06/2022,1,1,0,2,9,0,4,13,2,3,3,8,0,0,0,0,1,0,0,1
6023,114962,2022,Slovenia,USA,2,2,7,11,08/06/2022,0,0,1,1,4,2,2,8,1,2,3,6,0,0,0,0,2,0,0,2
6024,168715,2022,Slovenia,China,0,0,1,1,11/06/2022,5,1,15,21,0,0,0,0,0,0,2,2,0,0,0,0,0,0,0,0
6025,168715,2022,Australia,Slovenia,0,0,0,0,11/06/2022,0,0,0,0,0,0,0,0,0,0,0,0,0,0,0,0,0,0,0,0
6026,168715,2022,Brazil,Slovenia,0,0,0,0,10/06/2022,2,0,2,4,0,0,0,0,0,0,0,0,0,0,0,0,1,0,0,1
6027,168715,2022,Slovenia,USA,0,0,0,0,08/06/2022,0,0,1,1,0,0,0,0,0,0,0,0,0,0,0,0,0,0,0,0
6028,151391,2022,Poland,Slovenia,1,3,8,12,10/07/2022,0,0,0,0,4,0,1,5,1,2,0,3,0,0,1,1,2,0,0,2
6029,151391,2022,Slovenia,Iran,0,1,10,11,08/07/2022,0,0,1,1,5,0,2,7,2,1,2,5,0,0,0,0,1,0,0,1
6030,151391,2022,Bulgaria,Slovenia,0,0,19,19,07/07/2022,0,0,0,0,5,0,0,5,3,2,0,5,0,0,1,1,1,0,0,1
6031,151391,2022,Slovenia,Serbia,0,1,9,10,06/07/2022,0,0,0,0,2,0,3,5,2,2,0,4,0,0,1,1,0,1,0,1
6032,151391,2022,Japan,Slovenia,0,1,20,21,26/06/2022,0,0,1,1,5,0,4,9,3,5,3,11,0,0,0,0,6,1,0,7
6033,151391,2022,Italy,Slovenia,0,2,7,9,25/06/2022,0,0,1,1,3,2,3,8,0,3,3,6,0,0,2,2,0,1,0,1
6034,151391,2022,Argentina,Slovenia,1,2,14,17,23/06/2022,0,0,0,0,5,1,2,8,3,7,8,18,0,0,0,0,4,1,2,7
6035,151391,2022,Slovenia,Netherlands,0,2,7,9,21/06/2022,0,0,1,1,2,2,3,7,4,4,4,12,0,0,1,1,2,0,1,3
6036,151391,2022,Slovenia,China,0,1,3,4,11/06/2022,0,0,0,0,2,0,0,2,1,2,0,3,0,0,0,0,0,0,0,0
6037,151391,2022,Australia,Slovenia,1,1,6,8,11/06/2022,0,0,1,1,2,0,1,3,3,2,1,6,0,0,0,0,1,0,0,1
6038,151391,2022,Brazil,Slovenia,1,2,12,15,10/06/2022,0,0,0,0,6,0,2,8,0,4,4,8,1,0,0,1,4,0,1,5
6039,151391,2022,Slovenia,USA,0,2,5,7,08/06/2022,0,0,0,0,4,2,0,6,0,2,5,7,0,0,1,1,1,0,0,1
6040,119022,2022,,,-,-,-,-,-,-,-,-,-,-,-,-,-,-,-,-,-,-,-,-,-,-,-,-,-
6041,114952,2022,Poland,Slovenia,0,1,0,1,10/07/2022,0,0,0,0,0,0,0,0,0,0,0,0,0,0,0,0,0,0,0,0
6042,114952,2022,Slovenia,Iran,0,0,0,0,08/07/2022,0,0,0,0,1,0,0,1,0,0,0,0,0,0,0,0,0,0,0,0
6043,114952,2022,Bulgaria,Slovenia,0,0,0,0,07/07/2022,0,0,0,0,0,0,0,0,0,0,0,0,0,0,0,0,0,0,0,0
6044,114952,2022,Slovenia,Serbia,0,0,0,0,06/07/2022,0,0,0,0,0,0,0,0,0,0,0,0,0,0,0,0,0,0,0,0
6045,114952,2022,Slovenia,China,0,3,13,16,11/06/2022,0,1,0,1,12,4,4,20,1,2,2,5,0,0,0,0,3,3,1,7
6046,114952,2022,Australia,Slovenia,0,0,0,0,11/06/2022,0,0,0,0,0,0,0,0,0,0,0,0,0,0,0,0,0,0,0,0
6047,114952,2022,Brazil,Slovenia,3,4,16,23,10/06/2022,1,0,2,3,7,4,9,20,1,2,0,3,0,0,0,0,3,0,0,3
6048,114952,2022,Slovenia,USA,0,0,0,0,08/06/2022,0,0,0,0,0,0,0,0,0,0,0,0,0,0,0,0,0,0,0,0
6049,153301,2022,Poland,Slovenia,0,0,0,0,10/07/2022,0,0,0,0,0,0,0,0,0,0,0,0,0,0,0,0,0,0,0,0
6050,153301,2022,Slovenia,Iran,0,0,0,0,08/07/2022,0,0,0,0,0,0,0,0,0,0,0,0,0,0,0,0,0,0,0,0
6051,153301,2022,Bulgaria,Slovenia,0,0,0,0,07/07/2022,0,0,0,0,0,0,0,0,0,0,0,0,0,0,0,0,0,0,0,0
6052,153301,2022,Slovenia,Serbia,0,0,0,0,06/07/2022,0,0,0,0,0,0,0,0,0,0,0,0,0,0,0,0,0,0,0,0
6053,153301,2022,Japan,Slovenia,0,0,0,0,26/06/2022,0,0,0,0,0,0,0,0,0,0,0,0,0,0,0,0,0,0,0,0
6054,153301,2022,Italy,Slovenia,0,0,0,0,25/06/2022,0,0,1,1,0,0,0,0,0,0,0,0,3,1,14,18,2,9,0,11
6055,153301,2022,Argentina,Slovenia,0,0,0,0,23/06/2022,1,0,4,5,0,0,0,0,0,0,0,0,9,3,22,34,9,3,3,15
6056,153301,2022,Slovenia,Netherlands,0,0,0,0,21/06/2022,0,0,2,2,0,0,0,0,0,0,0,0,2,3,12,17,10,4,0,14
6057,153301,2022,Slovenia,China,0,0,0,0,11/06/2022,0,0,0,0,0,0,0,0,0,0,0,0,0,0,0,0,0,0,0,0
6058,153301,2022,Australia,Slovenia,0,0,0,0,11/06/2022,1,0,1,2,0,0,0,0,0,0,0,0,3,1,14,18,3,2,3,8
6059,153301,2022,Brazil,Slovenia,0,0,0,0,10/06/2022,0,0,0,0,0,0,0,0,0,0,0,0,0,0,0,0,0,0,0,0
6060,153301,2022,Slovenia,USA,0,0,0,0,08/06/2022,0,0,0,0,0,0,0,0,0,0,0,0,0,0,0,0,0,0,0,0
6061,154046,2022,Japan,Slovenia,0,0,0,0,26/06/2022,0,0,0,0,0,0,0,0,0,0,0,0,0,0,0,0,0,0,0,0
6062,154046,2022,Italy,Slovenia,0,1,1,2,25/06/2022,0,0,0,0,2,1,0,3,0,0,0,0,0,0,2,2,1,0,0,1
6063,154046,2022,Argentina,Slovenia,0,0,0,0,23/06/2022,0,0,0,0,0,0,0,0,0,0,0,0,0,0,0,0,0,0,0,0
6064,154046,2022,Slovenia,Netherlands,0,0,0,0,21/06/2022,0,0,0,0,0,0,0,0,0,0,0,0,0,0,0,0,0,0,0,0
6065,154046,2022,Slovenia,China,0,0,0,0,11/06/2022,0,0,0,0,0,0,0,0,0,0,0,0,0,0,0,0,0,0,0,0
6066,154046,2022,Australia,Slovenia,0,2,7,9,11/06/2022,0,0,0,0,7,1,4,12,2,1,2,5,2,0,8,10,6,0,1,7
6067,154046,2022,Brazil,Slovenia,0,1,0,1,10/06/2022,0,0,0,0,0,0,0,0,0,0,0,0,0,0,1,1,0,0,0,0
6068,154046,2022,Slovenia,USA,0,0,0,0,08/06/2022,0,0,0,0,0,2,1,3,0,0,0,0,0,0,0,0,0,0,0,0
6069,114956,2022,Poland,Slovenia,1,0,2,3,10/07/2022,1,0,22,23,0,0,1,1,0,1,0,1,0,0,0,0,0,0,0,0
6070,114956,2022,Slovenia,Iran,1,0,8,9,08/07/2022,15,1,42,58,0,0,1,1,1,1,0,2,0,0,1,1,0,2,0,2
6071,114956,2022,Bulgaria,Slovenia,0,0,0,0,07/07/2022,0,0,0,0,0,0,0,0,0,0,0,0,0,0,0,0,0,0,0,0
6072,114956,2022,Slovenia,Serbia,0,1,9,10,06/07/2022,12,0,48,60,2,0,1,3,0,3,0,3,0,0,0,0,0,0,0,0
6073,114956,2022,Japan,Slovenia,0,0,1,1,26/06/2022,0,0,0,0,0,0,0,0,0,0,0,0,0,0,0,0,0,0,0,0
6074,114956,2022,Italy,Slovenia,0,0,7,7,25/06/2022,12,0,49,61,1,0,1,2,0,0,2,2,0,0,0,0,6,1,1,8
6075,114956,2022,Argentina,Slovenia,0,0,1,1,23/06/2022,0,0,0,0,0,0,0,0,0,0,0,0,0,0,0,0,0,0,0,0
6076,114956,2022,Slovenia,Netherlands,0,0,1,1,21/06/2022,1,0,0,1,0,0,0,0,0,0,0,0,0,0,1,1,0,0,0,0
6077,151404,2022,Japan,Slovenia,0,0,0,0,26/06/2022,0,0,0,0,0,0,0,0,0,1,0,1,0,0,0,0,0,0,0,0
6078,151404,2022,Italy,Slovenia,0,0,9,9,25/06/2022,0,0,1,1,1,0,4,5,1,4,5,10,0,0,3,3,2,0,0,2
6079,151404,2022,Argentina,Slovenia,0,0,0,0,23/06/2022,0,0,0,0,0,0,0,0,0,0,0,0,0,0,0,0,0,0,0,0
6080,151404,2022,Slovenia,Netherlands,0,0,0,0,21/06/2022,0,0,0,0,0,0,0,0,0,0,0,0,0,0,0,0,0,0,0,0
6081,144483,2022,Poland,Slovenia,0,0,0,0,10/07/2022,0,0,0,0,0,0,0,0,0,0,0,0,0,0,0,0,0,0,0,0
6082,144483,2022,Slovenia,Iran,0,1,3,4,08/07/2022,0,0,0,0,1,0,3,4,0,3,0,3,0,0,0,0,0,0,1,1
6083,144483,2022,Bulgaria,Slovenia,0,0,0,0,07/07/2022,0,0,0,0,0,0,0,0,0,0,0,0,0,0,0,0,0,0,0,0
6084,144483,2022,Slovenia,Serbia,0,0,0,0,06/07/2022,0,0,0,0,0,0,0,0,0,0,0,0,0,0,0,0,0,0,0,0
6085,144483,2022,Japan,Slovenia,0,0,0,0,26/06/2022,0,0,0,0,0,0,0,0,0,0,1,1,0,0,0,0,0,0,1,1
6086,144483,2022,Italy,Slovenia,0,2,1,3,25/06/2022,0,0,0,0,1,0,1,2,1,1,0,2,0,0,0,0,0,0,0,0
6087,144483,2022,Argentina,Slovenia,0,0,0,0,23/06/2022,0,0,0,0,0,0,0,0,0,0,0,0,0,0,0,0,0,0,0,0
6088,144483,2022,Slovenia,Netherlands,0,4,4,8,21/06/2022,0,0,1,1,8,3,9,20,0,3,2,5,0,1,0,1,0,2,1,3
6089,144483,2022,Slovenia,China,0,2,9,11,11/06/2022,1,0,0,1,9,1,2,12,1,2,3,6,1,0,0,1,3,0,0,3
6090,144483,2022,Australia,Slovenia,0,4,4,8,11/06/2022,0,0,0,0,6,0,4,10,2,3,5,10,0,1,0,1,2,0,0,2
6091,144483,2022,Brazil,Slovenia,0,0,0,0,10/06/2022,0,0,0,0,0,0,1,1,0,0,0,0,0,0,0,0,0,0,0,0
6092,144483,2022,Slovenia,USA,0,0,0,0,08/06/2022,0,0,0,0,0,0,0,0,0,0,0,0,0,0,0,0,0,0,0,0
6093,154546,2022,Japan,Slovenia,0,0,0,0,26/06/2022,0,0,0,0,0,0,0,0,0,0,0,0,0,0,0,0,0,0,0,0
6094,154546,2022,Italy,Slovenia,0,0,6,6,25/06/2022,0,0,2,2,3,1,5,9,0,1,1,2,4,1,8,13,6,3,0,9
6095,154546,2022,Argentina,Slovenia,0,0,0,0,23/06/2022,0,0,0,0,0,0,0,0,0,0,0,0,0,0,0,0,0,0,0,0
6096,154546,2022,Slovenia,Netherlands,0,0,0,0,21/06/2022,0,0,0,0,0,0,0,0,0,0,0,0,0,0,3,3,0,0,0,0
6097,154546,2022,Slovenia,China,0,0,1,1,11/06/2022,0,0,0,0,0,0,0,0,0,0,0,0,1,0,0,1,0,0,0,0
6098,154546,2022,Australia,Slovenia,0,0,7,7,11/06/2022,0,0,0,0,0,0,0,0,0,0,0,0,1,0,0,1,2,0,0,2
6099,154546,2022,Brazil,Slovenia,0,0,0,0,10/06/2022,0,0,0,0,0,0,3,3,0,0,1,1,0,1,2,3,1,0,0,1
6100,154546,2022,Slovenia,USA,0,1,1,2,08/06/2022,0,0,0,0,2,1,2,5,1,0,0,1,0,2,5,7,1,0,0,1
6101,144415,2022,Poland,Slovenia,0,0,0,0,10/07/2022,0,0,0,0,0,0,0,0,0,0,0,0,2,5,15,22,1,4,0,5
6102,144415,2022,Slovenia,Iran,0,0,0,0,08/07/2022,0,0,3,3,0,0,0,0,0,0,0,0,2,4,21,27,1,2,1,4
6103,144415,2022,Bulgaria,Slovenia,0,0,0,0,07/07/2022,0,0,0,0,0,0,0,0,0,0,0,0,1,0,18,19,8,2,1,11
6104,144415,2022,Slovenia,Serbia,0,0,0,0,06/07/2022,0,0,1,1,0,0,0,0,0,0,0,0,2,0,8,10,4,1,0,5
6105,144415,2022,Japan,Slovenia,0,0,0,0,26/06/2022,0,0,4,4,0,0,0,0,0,0,0,0,11,1,11,23,6,8,2,16
6106,144415,2022,Italy,Slovenia,0,0,0,0,25/06/2022,0,0,0,0,0,0,0,0,0,0,0,0,0,0,0,0,0,0,0,0
6107,144415,2022,Slovenia,China,0,0,0,0,11/06/2022,3,0,1,4,0,0,0,0,0,0,0,0,9,1,18,28,12,4,0,16
6108,144415,2022,Australia,Slovenia,0,0,0,0,11/06/2022,0,0,0,0,0,0,0,0,0,0,0,0,0,0,0,0,0,0,0,0
6109,144415,2022,Brazil,Slovenia,0,0,0,0,10/06/2022,5,0,2,7,0,0,0,0,0,0,0,0,6,0,21,27,9,1,4,14
6110,144415,2022,Slovenia,USA,0,0,0,0,08/06/2022,0,0,5,5,0,0,0,0,0,0,0,0,6,1,11,18,5,4,1,10
6111,155920,2022,Poland,Slovenia,0,0,0,0,10/07/2022,0,0,0,0,0,0,0,0,0,0,0,0,0,0,0,0,0,0,0,0
6112,155920,2022,Slovenia,Iran,0,0,0,0,08/07/2022,0,0,0,0,0,0,0,0,0,0,0,0,0,0,0,0,0,0,0,0
6113,155920,2022,Bulgaria,Slovenia,0,0,0,0,07/07/2022,0,0,0,0,2,0,2,4,0,1,0,1,0,1,1,2,0,0,0,0
6114,155920,2022,Slovenia,Serbia,0,0,0,0,06/07/2022,0,0,0,0,0,0,0,0,0,0,0,0,0,0,0,0,0,0,0,0
6115,155920,2022,Japan,Slovenia,0,1,1,2,26/06/2022,0,0,2,2,0,0,0,0,0,0,0,0,1,0,1,2,2,0,0,2
6116,155920,2022,Italy,Slovenia,0,2,5,7,25/06/2022,0,0,3,3,11,1,6,18,1,0,1,2,2,3,4,9,2,2,1,5
6117,155920,2022,Argentina,Slovenia,0,3,14,17,23/06/2022,0,0,3,3,8,4,5,17,1,0,3,4,3,0,6,9,5,2,1,8
6118,155920,2022,Slovenia,Netherlands,0,3,9,12,21/06/2022,0,0,0,0,11,3,9,23,0,1,3,4,5,2,6,13,6,1,1,8
6119,155920,2022,Slovenia,China,0,2,13,15,11/06/2022,1,0,3,4,9,7,7,23,0,2,0,2,10,1,15,26,5,0,2,7
6120,155920,2022,Australia,Slovenia,0,0,0,0,11/06/2022,0,0,0,0,0,0,0,0,0,0,0,0,0,0,0,0,0,0,0,0
6121,155920,2022,Brazil,Slovenia,0,3,7,10,10/06/2022,1,1,4,6,7,4,6,17,1,1,1,3,7,6,19,32,3,3,1,7
6122,155920,2022,Slovenia,USA,0,1,7,8,08/06/2022,0,0,0,0,2,3,3,8,0,0,0,0,3,1,10,14,7,1,0,8
6123,161754,2022,Poland,Slovenia,0,0,0,0,10/07/2022,0,0,0,0,0,0,0,0,0,0,0,0,0,0,0,0,0,0,0,0
6124,161754,2022,Slovenia,Iran,0,0,1,1,08/07/2022,0,0,0,0,0,0,0,0,0,0,0,0,0,0,1,1,0,0,0,0
6125,161754,2022,Bulgaria,Slovenia,0,0,0,0,07/07/2022,0,0,0,0,0,0,0,0,0,0,0,0,0,0,0,0,0,0,0,0
6126,161754,2022,Slovenia,Serbia,0,0,0,0,06/07/2022,0,0,0,0,0,0,0,0,0,0,0,0,0,0,0,0,0,0,0,0
6127,161754,2022,Slovenia,China,0,0,5,5,11/06/2022,0,0,1,1,1,2,1,4,1,1,2,4,3,0,0,3,1,0,0,1
6128,161754,2022,Australia,Slovenia,1,0,5,6,11/06/2022,0,0,1,1,2,0,0,2,0,0,1,1,0,0,0,0,1,0,0,1
6129,161754,2022,Brazil,Slovenia,0,0,0,0,10/06/2022,0,0,0,0,0,0,0,0,0,0,0,0,0,0,0,0,0,0,0,0
6130,161754,2022,Slovenia,USA,0,0,2,2,08/06/2022,0,0,0,0,0,0,0,0,0,0,0,0,0,0,0,0,0,0,0,0
6131,119018,2022,Poland,Slovenia,0,2,5,7,10/07/2022,11,1,60,72,0,0,0,0,0,1,0,1,0,0,1,1,0,0,1,1
6132,119018,2022,Slovenia,Iran,0,0,0,0,08/07/2022,0,0,0,0,0,0,0,0,0,0,0,0,0,0,0,0,0,0,0,0
6133,119018,2022,Bulgaria,Slovenia,0,2,10,12,07/07/2022,24,2,64,90,0,0,1,1,1,2,0,3,0,1,0,1,1,0,1,2
6134,119018,2022,Slovenia,Serbia,0,0,0,0,06/07/2022,0,0,0,0,0,0,0,0,0,0,0,0,0,0,0,0,0,0,0,0
6135,119018,2022,Japan,Slovenia,0,1,10,11,26/06/2022,24,0,64,88,0,0,0,0,0,2,1,3,0,0,0,0,8,1,1,10
6136,119018,2022,Italy,Slovenia,0,0,1,1,25/06/2022,0,0,4,4,0,0,0,0,0,0,0,0,0,0,1,1,0,1,0,1
6137,119018,2022,Argentina,Slovenia,2,2,16,20,23/06/2022,15,0,76,91,1,0,1,2,1,1,3,5,0,0,1,1,14,3,0,17
6138,119018,2022,Slovenia,Netherlands,0,2,11,13,21/06/2022,16,1,53,70,1,0,0,1,1,2,0,3,0,0,0,0,4,0,1,5
6139,119018,2022,Slovenia,China,2,3,18,23,11/06/2022,37,0,36,73,0,0,1,1,1,0,1,2,0,0,2,2,6,0,1,7
6140,119018,2022,Australia,Slovenia,0,1,12,13,11/06/2022,31,2,29,62,0,0,0,0,0,2,2,4,0,0,0,0,2,1,1,4
6141,119018,2022,Brazil,Slovenia,1,3,7,11,10/06/2022,42,0,38,80,2,1,0,3,0,4,0,4,0,0,0,0,7,2,0,9
6142,119018,2022,Slovenia,USA,0,1,7,8,08/06/2022,20,0,16,36,0,0,0,0,1,0,1,2,0,0,0,0,2,1,0,3
6143,114957,2022,Poland,Slovenia,1,3,9,13,10/07/2022,0,0,0,0,7,2,16,25,1,0,0,1,1,2,18,21,3,1,0,4
6144,114957,2022,Slovenia,Iran,2,1,2,5,08/07/2022,0,0,2,2,2,4,2,8,0,0,0,0,0,0,7,7,0,1,0,1
6145,114957,2022,Bulgaria,Slovenia,0,0,0,0,07/07/2022,0,0,0,0,0,0,0,0,0,0,0,0,0,0,0,0,0,0,0,0
6146,114957,2022,Slovenia,Serbia,0,1,7,8,06/07/2022,0,0,1,1,11,0,4,15,1,3,1,5,0,0,14,14,0,1,0,1
6147,114957,2022,Japan,Slovenia,1,2,11,14,26/06/2022,0,0,2,2,9,3,11,23,1,2,1,4,6,3,22,31,4,4,1,9
6148,114957,2022,Italy,Slovenia,0,0,0,0,25/06/2022,0,0,0,0,0,0,0,0,0,0,0,0,0,0,0,0,0,0,0,0
6149,114957,2022,Argentina,Slovenia,2,3,15,20,23/06/2022,0,0,5,5,17,3,14,34,0,4,3,7,9,0,10,19,9,4,0,13
6150,114957,2022,Slovenia,Netherlands,0,0,0,0,21/06/2022,0,0,1,1,0,0,0,0,0,0,0,0,0,0,5,5,0,0,1,1
6151,136918,2022,Poland,Slovenia,0,4,9,13,10/07/2022,0,0,0,0,9,7,12,28,0,3,0,3,0,2,29,31,2,0,1,3
6152,136918,2022,Slovenia,Iran,0,3,8,11,08/07/2022,0,0,0,0,10,6,6,22,1,3,0,4,2,0,10,12,1,0,0,1
6153,136918,2022,Bulgaria,Slovenia,0,2,9,11,07/07/2022,0,0,0,0,13,2,9,24,1,1,1,3,3,2,26,31,2,0,1,3
6154,136918,2022,Slovenia,Serbia,3,3,12,18,06/07/2022,0,0,0,0,7,1,7,15,1,3,0,4,4,2,12,18,5,0,0,5
6155,168747,2022,Poland,Slovenia,0,0,1,1,10/07/2022,0,0,1,1,0,3,2,5,0,0,0,0,0,0,0,0,0,0,0,0
6156,168747,2022,Slovenia,Iran,0,3,2,5,08/07/2022,0,0,0,0,2,2,1,5,0,0,0,0,0,2,6,8,1,0,0,1
6157,168747,2022,Bulgaria,Slovenia,0,3,14,17,07/07/2022,0,0,4,4,13,3,1,17,1,2,0,3,0,0,9,9,1,1,2,4
6158,168747,2022,Slovenia,Serbia,0,0,0,0,06/07/2022,0,0,0,0,0,0,0,0,0,0,0,0,0,0,0,0,0,0,0,0
6159,168747,2022,Japan,Slovenia,0,4,6,10,26/06/2022,0,0,3,3,18,4,15,37,2,6,3,11,6,1,16,23,0,0,2,2
6160,168747,2022,Italy,Slovenia,0,3,7,10,25/06/2022,0,0,0,0,10,5,9,24,1,1,2,4,3,1,8,12,4,2,1,7
6161,168747,2022,Argentina,Slovenia,1,2,9,12,23/06/2022,0,0,5,5,13,6,19,38,3,4,6,13,0,1,1,2,5,0,0,5
6162,168747,2022,Slovenia,Netherlands,1,4,5,10,21/06/2022,0,0,4,4,8,2,9,19,3,1,2,6,3,3,16,22,7,0,1,8
6163,168747,2022,Slovenia,China,0,3,9,12,11/06/2022,1,0,0,1,14,1,13,28,3,3,1,7,6,1,6,13,6,0,0,6
6164,168747,2022,Australia,Slovenia,0,4,8,12,11/06/2022,0,0,0,0,17,1,3,21,0,3,2,5,11,0,10,21,3,0,2,5
6165,168747,2022,Brazil,Slovenia,1,5,6,12,10/06/2022,0,0,0,0,20,6,8,34,1,1,0,2,6,1,10,17,5,0,2,7
6166,168747,2022,Slovenia,USA,0,2,5,7,08/06/2022,0,0,0,0,8,4,13,25,1,1,1,3,5,3,13,21,4,0,2,6
6167,182325,2022,,,-,-,-,-,-,-,-,-,-,-,-,-,-,-,-,-,-,-,-,-,-,-,-,-,-
6168,181130,2022,,,-,-,-,-,-,-,-,-,-,-,-,-,-,-,-,-,-,-,-,-,-,-,-,-,-
6169,185708,2022,,,-,-,-,-,-,-,-,-,-,-,-,-,-,-,-,-,-,-,-,-,-,-,-,-,-
6170,151399,2022,,,-,-,-,-,-,-,-,-,-,-,-,-,-,-,-,-,-,-,-,-,-,-,-,-,-
6171,132624,2022,France,USA,0,3,13,16,24/07/2022,1,0,2,3,20,4,7,31,0,4,1,5,5,2,17,24,8,4,1,13
6172,132624,2022,Poland,USA,0,3,7,10,23/07/2022,0,0,0,0,9,4,5,18,0,1,1,2,6,1,12,19,5,4,0,9
6173,132624,2022,USA,Brazil,0,2,12,14,20/07/2022,0,0,1,1,14,2,10,26,0,0,1,1,9,1,17,27,12,3,1,16
6174,132624,2022,USA,Argentina,0,0,0,0,10/07/2022,0,0,0,0,0,0,0,0,0,0,0,0,0,0,0,0,0,0,0,0
6175,132624,2022,Canada,USA,0,4,4,8,09/07/2022,1,0,2,3,10,1,12,23,1,3,4,8,4,1,7,12,7,2,1,10
6176,132624,2022,France,USA,2,3,15,20,07/07/2022,0,0,1,1,13,2,15,30,3,5,3,11,7,2,16,25,6,1,1,8
6177,132624,2022,USA,Germany,3,1,12,16,05/07/2022,0,0,4,4,19,3,12,34,1,4,2,7,5,0,6,11,4,1,1,6
6178,132624,2022,USA,Poland,3,4,10,17,26/06/2022,0,0,1,1,13,6,10,29,0,4,0,4,6,0,15,21,1,1,1,3
6179,132624,2022,USA,Bulgaria,4,5,8,17,25/06/2022,0,0,0,0,10,5,8,23,2,3,1,6,5,1,17,23,1,2,0,3
6180,132624,2022,USA,Iran,0,0,0,0,23/06/2022,0,0,0,0,0,0,0,0,0,0,0,0,0,0,0,0,0,0,0,0
6181,132624,2022,Serbia,USA,1,2,11,14,22/06/2022,1,0,1,2,10,3,3,16,1,2,0,3,3,2,12,17,2,4,0,6
6182,132624,2022,USA,Brazil,1,5,9,15,11/06/2022,2,0,0,2,9,6,9,24,0,5,1,6,14,0,20,34,7,2,2,11
6183,132624,2022,Japan,USA,3,4,13,20,10/06/2022,2,0,1,3,16,3,14,33,1,2,7,10,8,0,26,34,7,1,1,9
6184,132624,2022,Netherlands,USA,2,1,11,14,09/06/2022,5,0,5,10,11,2,4,17,1,3,2,6,4,0,3,7,3,3,4,10
6185,132624,2022,Slovenia,USA,2,2,8,12,08/06/2022,0,0,0,0,8,5,7,20,4,2,1,7,3,1,16,20,6,0,3,9
6186,136078,2022,USA,Poland,0,0,1,1,26/06/2022,1,0,3,4,0,0,0,0,0,1,0,1,0,0,0,0,0,0,0,0
6187,136078,2022,USA,Bulgaria,0,1,3,4,25/06/2022,2,0,6,8,0,0,0,0,0,0,0,0,0,0,0,0,0,1,0,1
6188,136078,2022,USA,Iran,0,0,2,2,23/06/2022,5,0,16,21,0,0,1,1,0,1,0,1,0,0,0,0,0,0,0,0
6189,136078,2022,Serbia,USA,0,0,0,0,22/06/2022,0,0,0,0,0,0,0,0,0,0,0,0,0,0,0,0,0,0,0,0
6190,136078,2022,USA,Brazil,0,0,2,2,11/06/2022,3,0,7,10,0,1,0,1,0,0,0,0,0,0,0,0,0,0,0,0
6191,136078,2022,Japan,USA,0,0,0,0,10/06/2022,5,0,6,11,0,0,0,0,0,0,0,0,0,0,0,0,2,0,0,2
6192,136078,2022,Netherlands,USA,0,1,1,2,09/06/2022,6,0,6,12,1,0,1,2,1,0,0,1,0,0,0,0,0,0,0,0
6193,136078,2022,Slovenia,USA,0,0,0,0,08/06/2022,1,0,1,2,1,0,0,1,1,0,1,2,0,0,0,0,0,0,0,0
6194,147721,2022,France,USA,0,3,7,10,24/07/2022,0,0,1,1,6,0,3,9,3,11,3,17,1,0,1,2,3,1,0,4
6195,147721,2022,Poland,USA,1,1,8,10,23/07/2022,0,0,0,0,6,0,2,8,1,4,6,11,0,0,0,0,0,1,0,1
6196,147721,2022,USA,Brazil,0,0,8,8,20/07/2022,0,0,0,0,6,0,4,10,2,6,4,12,0,0,0,0,2,1,0,3
6197,147721,2022,USA,Argentina,0,0,0,0,10/07/2022,0,0,0,0,0,0,0,0,0,0,0,0,0,0,0,0,0,0,0,0
6198,147721,2022,Canada,USA,1,0,13,14,09/07/2022,0,0,1,1,4,0,0,4,1,4,4,9,1,0,1,2,1,2,0,3
6199,147721,2022,France,USA,0,3,9,12,07/07/2022,0,0,0,0,5,2,1,8,1,4,9,14,0,1,0,1,4,1,2,7
6200,147721,2022,USA,Germany,0,1,9,10,05/07/2022,0,0,1,1,5,0,2,7,0,6,9,15,2,0,2,4,2,0,0,2
6201,147721,2022,USA,Poland,0,0,8,8,26/06/2022,0,0,0,0,3,1,1,5,0,2,0,2,0,1,1,2,0,1,0,1
6202,147721,2022,USA,Bulgaria,0,1,14,15,25/06/2022,1,0,0,1,7,0,3,10,1,2,4,7,0,0,0,0,2,1,0,3
6203,147721,2022,USA,Iran,2,2,7,11,23/06/2022,0,0,1,1,5,1,3,9,2,4,2,8,0,0,2,2,0,0,0,0
6204,147721,2022,Serbia,USA,0,1,14,15,22/06/2022,0,0,0,0,5,1,6,12,0,9,3,12,0,0,4,4,0,0,0,0
6205,147721,2022,USA,Brazil,1,3,11,15,11/06/2022,0,0,1,1,9,1,0,10,2,4,3,9,0,0,2,2,1,1,0,2
6206,147721,2022,Japan,USA,1,3,15,19,10/06/2022,0,0,0,0,11,1,5,17,4,8,10,22,0,0,0,0,2,3,1,6
6207,147721,2022,Netherlands,USA,1,1,13,15,09/06/2022,0,0,0,0,3,0,0,3,1,4,1,6,0,0,0,0,4,1,0,5
6208,147721,2022,Slovenia,USA,0,2,7,9,08/06/2022,0,0,1,1,4,0,4,8,3,2,4,9,0,0,0,0,1,0,0,1
6209,147417,2022,France,USA,0,0,1,1,24/07/2022,0,0,0,0,1,0,4,5,0,0,0,0,0,0,0,0,2,0,0,2
6210,147417,2022,Poland,USA,0,2,8,10,23/07/2022,0,0,2,2,8,1,6,15,0,2,2,4,0,0,2,2,3,0,0,3
6211,147417,2022,USA,Brazil,1,2,3,6,20/07/2022,0,0,0,0,4,3,7,14,1,5,2,8,0,0,0,0,3,0,1,4
6212,147417,2022,USA,Argentina,0,2,11,13,10/07/2022,1,0,1,2,7,1,5,13,1,3,4,8,0,0,0,0,6,1,1,8
6213,147417,2022,Canada,USA,2,1,10,13,09/07/2022,0,0,1,1,10,0,6,16,1,3,1,5,0,0,1,1,5,2,3,10
6214,147417,2022,France,USA,2,2,11,15,07/07/2022,0,0,3,3,10,3,12,25,0,8,4,12,0,0,0,0,6,4,2,12
6215,147417,2022,USA,Germany,1,3,6,10,05/07/2022,0,0,1,1,12,5,8,25,0,1,7,8,0,0,0,0,4,0,2,6
6216,147417,2022,USA,Poland,0,3,7,10,26/06/2022,0,0,2,2,8,4,6,18,0,2,0,2,0,0,0,0,0,1,1,2
6217,147417,2022,USA,Bulgaria,1,5,4,10,25/06/2022,0,0,1,1,17,2,3,22,2,0,3,5,0,0,0,0,1,3,0,4
6218,147417,2022,USA,Iran,0,1,8,9,23/06/2022,0,0,0,0,11,6,5,22,0,3,0,3,0,0,0,0,1,1,0,2
6219,147417,2022,Serbia,USA,0,3,11,14,22/06/2022,0,0,0,0,13,4,6,23,0,5,3,8,0,0,0,0,2,1,1,4
6220,147417,2022,USA,Brazil,0,0,0,0,11/06/2022,0,0,0,0,0,0,0,0,0,0,0,0,0,0,0,0,0,0,0,0
6221,147417,2022,Japan,USA,0,4,13,17,10/06/2022,0,0,0,0,19,2,15,36,1,4,8,13,0,0,0,0,5,2,3,10
6222,147417,2022,Netherlands,USA,1,3,9,13,09/06/2022,0,0,0,0,11,3,2,16,2,1,0,3,0,0,0,0,6,0,0,6
6223,147417,2022,Slovenia,USA,2,1,13,16,08/06/2022,0,0,4,4,12,3,4,19,0,0,7,7,0,0,0,0,2,1,0,3
6224,140185,2022,France,USA,0,0,0,0,24/07/2022,0,0,0,0,0,0,0,0,0,0,0,0,0,0,0,0,0,0,0,0
6225,140185,2022,Poland,USA,0,0,0,0,23/07/2022,0,0,0,0,0,0,0,0,0,0,0,0,0,0,0,0,0,0,0,0
6226,140185,2022,USA,Brazil,0,0,0,0,20/07/2022,0,0,0,0,0,0,0,0,0,0,0,0,0,0,0,0,0,0,0,0
6227,140185,2022,USA,Argentina,1,8,9,18,10/07/2022,0,0,0,0,7,1,4,12,3,7,7,17,0,0,2,2,2,0,0,2
6228,140185,2022,Canada,USA,0,0,0,0,09/07/2022,0,0,0,0,0,0,0,0,0,0,0,0,0,0,0,0,0,0,0,0
6229,140185,2022,France,USA,0,0,0,0,07/07/2022,0,0,0,0,0,0,0,0,0,0,0,0,0,0,0,0,0,0,0,0
6230,140185,2022,USA,Germany,0,0,0,0,05/07/2022,0,0,0,0,0,0,0,0,0,0,0,0,0,0,0,0,0,0,0,0
6231,140185,2022,USA,Poland,2,3,5,10,26/06/2022,0,0,1,1,5,0,2,7,1,4,2,7,0,0,2,2,0,2,0,2
6232,140185,2022,USA,Bulgaria,0,0,1,1,25/06/2022,0,0,0,0,0,0,1,1,0,0,0,0,0,0,0,0,0,0,0,0
6233,140185,2022,USA,Iran,0,1,5,6,23/06/2022,0,0,0,0,3,1,3,7,1,2,2,5,0,0,1,1,0,0,0,0
6234,140185,2022,Serbia,USA,0,0,0,0,22/06/2022,0,0,0,0,0,0,0,0,0,0,0,0,0,0,0,0,0,0,0,0
6235,183140,2022,USA,Brazil,0,0,0,0,11/06/2022,0,0,0,0,0,0,0,0,0,0,0,0,0,0,0,0,0,0,0,0
6236,183140,2022,Japan,USA,0,0,0,0,10/06/2022,0,0,0,0,0,0,0,0,0,0,0,0,0,0,0,0,0,0,0,0
6237,183140,2022,Netherlands,USA,0,0,0,0,09/06/2022,0,0,0,0,0,0,0,0,0,0,0,0,0,0,0,0,0,0,0,0
6238,183140,2022,Slovenia,USA,0,0,0,0,08/06/2022,0,0,0,0,0,0,0,0,0,0,0,0,0,0,0,0,0,0,0,0
6239,139254,2022,France,USA,0,2,16,18,24/07/2022,0,1,0,1,13,6,6,25,0,2,4,6,2,1,9,12,2,3,1,6
6240,139254,2022,Poland,USA,6,1,11,18,23/07/2022,0,0,2,2,6,2,6,14,1,2,0,3,2,0,5,7,4,1,1,6
6241,139254,2022,USA,Brazil,1,6,11,18,20/07/2022,0,0,0,0,16,4,9,29,0,5,2,7,11,1,10,22,2,6,0,8
6242,139254,2022,USA,Argentina,0,3,13,16,10/07/2022,0,0,7,7,25,6,12,43,3,7,1,11,5,1,24,30,5,3,1,9
6243,139254,2022,Canada,USA,1,2,8,11,09/07/2022,0,0,5,5,17,1,5,23,0,2,4,6,5,0,9,14,2,1,0,3
6244,139254,2022,France,USA,1,3,13,17,07/07/2022,0,0,7,7,12,5,8,25,2,2,8,12,2,2,16,20,6,2,2,10
6245,139254,2022,USA,Germany,1,4,16,21,05/07/2022,0,0,4,4,11,2,6,19,0,3,7,10,14,1,18,33,4,1,1,6
6246,139254,2022,USA,Poland,2,0,17,19,26/06/2022,0,0,0,0,11,3,12,26,1,2,1,4,9,3,24,36,1,1,1,3
6247,139254,2022,USA,Bulgaria,2,3,17,22,25/06/2022,0,0,1,1,10,4,11,25,0,1,1,2,6,1,17,24,1,2,1,4
6248,139254,2022,USA,Iran,0,3,8,11,23/06/2022,1,0,0,1,13,4,7,24,0,2,0,2,4,2,23,29,0,1,1,2
6249,139254,2022,Serbia,USA,0,6,12,18,22/06/2022,0,0,0,0,23,3,6,32,2,3,1,6,5,3,16,24,0,4,0,4
6250,170104,2022,USA,Argentina,0,2,4,6,10/07/2022,0,0,1,1,7,1,6,14,0,1,2,3,0,0,0,0,2,0,0,2
6251,170104,2022,Canada,USA,0,0,0,0,09/07/2022,0,0,0,0,0,0,0,0,0,0,0,0,0,0,0,0,0,0,0,0
6252,170104,2022,France,USA,0,2,0,2,07/07/2022,0,0,0,0,0,0,1,1,0,2,2,4,0,0,0,0,0,0,1,1
6253,170104,2022,USA,Germany,0,2,4,6,05/07/2022,0,0,0,0,4,3,3,10,0,1,2,3,0,0,0,0,0,0,0,0
6254,170104,2022,USA,Brazil,1,2,18,21,11/06/2022,0,0,0,0,17,4,16,37,2,3,1,6,0,0,0,0,7,3,2,12
6255,170104,2022,Japan,USA,0,1,0,1,10/06/2022,0,0,1,1,2,0,1,3,0,0,0,0,0,0,0,0,0,0,0,0
6256,170104,2022,Netherlands,USA,0,0,2,2,09/06/2022,0,0,0,0,3,0,1,4,0,0,0,0,0,0,0,0,0,0,0,0
6257,170104,2022,Slovenia,USA,0,0,0,0,08/06/2022,0,0,0,0,0,0,0,0,0,0,0,0,0,0,0,0,0,0,0,0
6258,142445,2022,France,USA,0,0,0,0,24/07/2022,0,0,0,0,0,0,0,0,0,0,0,0,0,0,0,0,0,0,0,0
6259,142445,2022,Poland,USA,0,0,0,0,23/07/2022,0,0,0,0,0,0,0,0,0,0,0,0,0,0,1,1,0,0,0,0
6260,142445,2022,USA,Brazil,0,0,0,0,20/07/2022,0,0,0,0,0,0,0,0,0,0,0,0,0,0,0,0,0,0,0,0
6261,142445,2022,USA,Argentina,0,0,0,0,10/07/2022,0,0,5,5,0,0,0,0,0,0,0,0,10,0,12,22,10,6,5,21
6262,142445,2022,Canada,USA,0,0,0,0,09/07/2022,0,0,0,0,0,0,0,0,0,0,0,0,0,0,0,0,0,0,0,0
6263,142445,2022,France,USA,0,0,0,0,07/07/2022,0,0,0,0,0,0,0,0,0,0,0,0,0,0,0,0,0,0,0,0
6264,142445,2022,USA,Germany,0,0,0,0,05/07/2022,0,0,0,0,0,0,0,0,0,0,0,0,0,0,0,0,0,0,0,0
6265,142445,2022,USA,Poland,0,0,0,0,26/06/2022,0,0,0,0,0,0,0,0,0,0,0,0,0,0,0,0,0,0,0,0
6266,142445,2022,USA,Bulgaria,0,0,0,0,25/06/2022,0,0,0,0,0,0,0,0,0,0,0,0,0,0,0,0,0,0,0,0
6267,142445,2022,USA,Iran,0,0,0,0,23/06/2022,1,0,1,2,0,0,0,0,0,0,0,0,5,1,16,22,3,3,2,8
6268,142445,2022,Serbia,USA,0,0,0,0,22/06/2022,0,0,0,0,0,0,0,0,0,0,0,0,0,0,0,0,0,0,0,0
6269,142445,2022,USA,Brazil,0,0,0,0,11/06/2022,7,0,1,8,0,0,0,0,0,0,0,0,11,1,6,18,12,1,0,13
6270,142445,2022,Japan,USA,0,0,0,0,10/06/2022,10,0,3,13,0,0,0,0,0,0,0,0,5,0,7,12,14,4,3,21
6271,142445,2022,Netherlands,USA,0,0,0,0,09/06/2022,3,0,0,3,0,0,0,0,0,0,0,0,6,0,7,13,9,0,0,9
6272,142445,2022,Slovenia,USA,0,0,0,0,08/06/2022,0,0,3,3,0,0,0,0,0,0,0,0,5,2,5,12,5,3,0,8
6273,124879,2022,France,USA,1,3,15,19,24/07/2022,26,1,69,96,1,0,0,1,2,5,4,11,0,0,0,0,4,1,1,6
6274,124879,2022,Poland,USA,0,1,12,13,23/07/2022,12,0,43,55,3,0,1,4,1,1,0,2,0,0,0,0,2,0,0,2
6275,124879,2022,USA,Brazil,2,1,24,27,20/07/2022,34,0,66,100,0,0,1,1,1,0,0,1,0,0,0,0,4,2,0,6
6276,124879,2022,USA,Argentina,0,2,7,9,10/07/2022,28,0,32,60,0,0,1,1,3,3,3,9,0,0,1,1,6,3,1,10
6277,124879,2022,Canada,USA,1,3,11,15,09/07/2022,33,1,22,56,1,0,0,1,1,1,2,4,0,0,0,0,4,1,1,6
6278,124879,2022,France,USA,0,3,11,14,07/07/2022,23,1,53,77,1,0,3,4,2,4,5,11,0,1,1,2,5,2,1,8
6279,124879,2022,USA,Germany,1,3,11,15,05/07/2022,33,1,53,87,3,0,1,4,1,1,4,6,0,0,0,0,10,4,1,15
6280,147542,2022,USA,Brazil,0,0,0,0,11/06/2022,0,0,0,0,0,0,0,0,0,0,0,0,0,0,0,0,0,0,0,0
6281,147542,2022,Japan,USA,0,0,0,0,10/06/2022,0,0,0,0,0,0,0,0,0,0,0,0,0,0,0,0,0,0,0,0
6282,147542,2022,Netherlands,USA,0,0,0,0,09/06/2022,0,0,0,0,0,0,0,0,0,0,0,0,0,0,0,0,0,0,0,0
6283,147542,2022,Slovenia,USA,0,0,0,0,08/06/2022,0,0,0,0,0,0,0,0,0,0,0,0,0,0,0,0,0,0,0,0
6284,189158,2022,,,-,-,-,-,-,-,-,-,-,-,-,-,-,-,-,-,-,-,-,-,-,-,-,-,-
6285,136077,2022,France,USA,0,2,5,7,24/07/2022,0,0,0,0,4,2,5,11,0,1,2,3,0,0,0,0,1,0,0,1
6286,136077,2022,Poland,USA,1,2,4,7,23/07/2022,0,0,0,0,0,0,0,0,0,0,0,0,0,0,0,0,0,0,0,0
6287,136077,2022,USA,Brazil,0,0,7,7,20/07/2022,0,0,0,0,8,2,6,16,0,1,2,3,0,0,0,0,4,1,1,6
6288,136077,2022,USA,Poland,0,1,5,6,26/06/2022,0,0,0,0,3,0,2,5,0,1,0,1,0,0,0,0,0,1,0,1
6289,136077,2022,USA,Bulgaria,0,1,1,2,25/06/2022,0,0,0,0,3,0,0,3,0,1,1,2,0,0,0,0,0,0,0,0
6290,136077,2022,USA,Iran,1,2,2,5,23/06/2022,0,0,0,0,2,0,2,4,0,0,0,0,0,0,0,0,1,0,0,1
6291,136077,2022,Serbia,USA,0,0,0,0,22/06/2022,0,0,0,0,0,0,0,0,0,0,0,0,0,0,0,0,0,0,0,0
6292,147543,2022,France,USA,0,0,0,0,24/07/2022,0,0,0,0,0,0,0,0,0,0,0,0,0,0,0,0,0,0,0,0
6293,147543,2022,Poland,USA,0,0,0,0,23/07/2022,0,0,0,0,0,0,0,0,0,0,0,0,0,0,0,0,0,0,0,0
6294,147543,2022,USA,Brazil,0,0,0,0,20/07/2022,0,0,0,0,0,0,0,0,0,0,0,0,0,0,0,0,0,0,0,0
6295,147543,2022,USA,Argentina,0,0,7,7,10/07/2022,20,0,18,38,0,0,1,1,0,1,2,3,0,0,0,0,1,1,2,4
6296,147543,2022,Canada,USA,0,0,0,0,09/07/2022,0,0,0,0,0,0,0,0,0,0,0,0,0,0,0,0,0,0,0,0
6297,147543,2022,France,USA,0,0,0,0,07/07/2022,5,0,3,8,0,0,0,0,0,0,0,0,0,0,0,0,1,0,0,1
6298,147543,2022,USA,Germany,0,0,0,0,05/07/2022,0,0,0,0,0,0,0,0,0,0,0,0,0,0,0,0,0,0,0,0
6299,147543,2022,USA,Poland,0,3,12,15,26/06/2022,21,0,64,85,1,0,0,1,0,2,3,5,0,0,0,0,2,1,0,3
6300,147543,2022,USA,Bulgaria,0,1,12,13,25/06/2022,24,1,50,75,1,0,1,2,0,5,0,5,0,0,0,0,5,4,3,12
6301,147543,2022,USA,Iran,0,1,8,9,23/06/2022,21,0,41,62,0,1,2,3,0,1,2,3,0,0,0,0,0,2,0,2
6302,147543,2022,Serbia,USA,2,3,14,19,22/06/2022,37,0,52,89,0,0,2,2,0,1,2,3,0,0,0,0,2,4,0,6
6303,147543,2022,USA,Brazil,0,3,10,13,11/06/2022,43,0,42,85,3,0,1,4,2,3,4,9,0,0,1,1,4,2,0,6
6304,147543,2022,Japan,USA,0,5,15,20,10/06/2022,52,0,43,95,2,1,1,4,1,2,6,9,0,0,0,0,7,0,1,8
6305,147543,2022,Netherlands,USA,0,1,6,7,09/06/2022,17,0,20,37,2,1,0,3,0,2,2,4,0,0,0,0,3,0,0,3
6306,147543,2022,Slovenia,USA,1,3,9,13,08/06/2022,17,0,12,29,2,0,0,2,0,3,4,7,0,0,0,0,5,0,1,6
6307,143682,2022,USA,Poland,0,0,0,0,26/06/2022,0,0,0,0,0,0,0,0,0,0,0,0,0,0,0,0,0,0,0,0
6308,143682,2022,USA,Bulgaria,0,0,0,0,25/06/2022,0,0,0,0,0,0,0,0,0,0,0,0,0,0,0,0,0,0,0,0
6309,143682,2022,USA,Iran,0,1,5,6,23/06/2022,0,0,1,1,3,2,6,11,1,0,0,1,3,1,4,8,3,1,1,5
6310,143682,2022,Serbia,USA,0,0,0,0,22/06/2022,0,0,0,0,0,0,0,0,0,0,0,0,0,0,0,0,0,0,0,0
6311,143682,2022,USA,Brazil,0,0,0,0,11/06/2022,0,0,0,0,0,0,0,0,0,0,0,0,0,0,0,0,0,0,0,0
6312,143682,2022,Japan,USA,0,5,11,16,10/06/2022,3,0,0,3,9,2,16,27,2,2,1,5,13,1,20,34,10,1,0,11
6313,143682,2022,Netherlands,USA,1,2,6,9,09/06/2022,1,0,0,1,7,4,5,16,1,2,2,5,3,0,15,18,5,1,0,6
6314,143682,2022,Slovenia,USA,2,3,9,14,08/06/2022,0,0,0,0,6,1,6,13,1,2,1,4,2,0,6,8,5,1,1,7
6315,133463,2022,France,USA,0,1,9,10,24/07/2022,0,0,1,1,11,0,4,15,0,4,3,7,10,2,6,18,6,1,0,7
6316,133463,2022,Poland,USA,0,0,0,0,23/07/2022,0,0,0,0,0,0,0,0,0,0,0,0,0,0,0,0,0,0,0,0
6317,133463,2022,USA,Brazil,0,1,2,3,20/07/2022,0,0,0,0,0,0,0,0,0,0,0,0,0,0,0,0,0,1,0,1
6318,133463,2022,USA,Argentina,0,1,21,22,10/07/2022,1,0,1,2,10,5,7,22,0,3,1,4,11,1,14,26,5,1,3,9
6319,133463,2022,Canada,USA,0,0,0,0,09/07/2022,0,0,0,0,0,0,0,0,0,0,0,0,0,0,0,0,0,0,0,0
6320,133463,2022,France,USA,0,2,0,2,07/07/2022,0,0,0,0,0,0,0,0,0,0,0,0,0,0,0,0,0,0,0,0
6321,133463,2022,USA,Germany,0,2,2,4,05/07/2022,0,0,0,0,0,0,0,0,0,0,0,0,0,0,0,0,1,0,0,1
6322,133463,2022,USA,Poland,0,0,0,0,26/06/2022,0,0,0,0,0,1,0,1,0,1,0,1,0,0,1,1,0,0,0,0
6323,133463,2022,USA,Bulgaria,0,0,1,1,25/06/2022,0,0,0,0,3,0,0,3,0,0,0,0,0,2,2,4,2,1,0,3
6324,133463,2022,USA,Iran,0,0,7,7,23/06/2022,0,1,0,1,3,1,3,7,0,0,0,0,0,1,3,4,0,0,0,0
6325,133463,2022,Serbia,USA,0,0,0,0,22/06/2022,0,0,0,0,0,0,0,0,0,0,0,0,0,0,0,0,0,0,0,0
6326,116069,2022,France,USA,0,0,15,15,24/07/2022,1,0,1,2,4,4,2,10,2,6,6,14,0,0,0,0,1,1,0,2
6327,116069,2022,Poland,USA,1,1,4,6,23/07/2022,0,0,1,1,6,1,1,8,3,4,4,11,0,0,0,0,3,0,0,3
6328,116069,2022,USA,Brazil,0,1,10,11,20/07/2022,0,0,0,0,8,0,3,11,3,6,9,18,1,0,1,2,5,2,0,7
6329,116069,2022,USA,Argentina,2,3,17,22,10/07/2022,0,0,0,0,9,1,2,12,3,2,7,12,0,0,0,0,1,0,0,1
6330,116069,2022,Canada,USA,0,3,10,13,09/07/2022,1,0,2,3,5,0,3,8,1,2,5,8,0,0,0,0,1,1,0,2
6331,116069,2022,France,USA,1,2,17,20,07/07/2022,0,0,3,3,5,0,1,6,1,0,5,6,0,0,2,2,3,1,0,4
6332,116069,2022,USA,Germany,1,2,11,14,05/07/2022,0,0,1,1,5,0,4,9,2,7,5,14,2,0,3,5,3,0,1,4
6333,116069,2022,USA,Poland,1,3,5,9,26/06/2022,0,1,0,1,5,1,3,9,3,7,2,12,1,0,0,1,0,1,0,1
6334,116069,2022,USA,Bulgaria,1,1,8,10,25/06/2022,0,0,1,1,4,0,1,5,2,3,3,8,0,0,0,0,0,0,1,1
6335,116069,2022,USA,Iran,0,0,0,0,23/06/2022,0,0,0,0,0,0,0,0,0,0,0,0,0,0,0,0,0,0,0,0
6336,116069,2022,Serbia,USA,2,2,14,18,22/06/2022,0,0,0,0,5,1,2,8,4,3,1,8,0,0,2,2,2,1,1,4
6337,116069,2022,USA,Brazil,0,0,0,0,11/06/2022,0,0,0,0,0,0,0,0,0,0,0,0,0,0,0,0,0,0,0,0
6338,116069,2022,Japan,USA,0,3,9,12,10/06/2022,1,0,1,2,5,2,4,11,1,6,10,17,0,0,1,1,3,0,2,5
6339,116069,2022,Netherlands,USA,0,0,12,12,09/06/2022,2,0,0,2,3,1,1,5,2,1,4,7,0,0,0,0,1,0,0,1
6340,116069,2022,Slovenia,USA,0,2,8,10,08/06/2022,0,0,1,1,3,0,1,4,5,0,2,7,0,0,1,1,4,0,0,4
6341,168461,2022,USA,Brazil,0,0,0,0,11/06/2022,0,0,0,0,0,0,0,0,0,0,0,0,0,0,0,0,0,0,0,0
6342,168461,2022,Japan,USA,0,0,0,0,10/06/2022,0,0,0,0,0,0,0,0,0,0,0,0,0,0,0,0,0,0,0,0
6343,168461,2022,Netherlands,USA,0,0,0,0,09/06/2022,0,0,0,0,0,0,0,0,0,0,0,0,0,0,0,0,0,0,0,0
6344,168461,2022,Slovenia,USA,0,0,0,0,08/06/2022,0,0,0,0,0,0,0,0,0,0,0,0,0,0,0,0,0,0,0,0
6345,119732,2022,France,USA,0,0,0,0,24/07/2022,0,0,2,2,0,0,0,0,0,0,0,0,9,1,14,24,9,2,2,13
6346,119732,2022,Poland,USA,0,0,0,0,23/07/2022,0,0,3,3,0,0,0,0,0,0,0,0,5,3,6,14,9,2,0,11
6347,119732,2022,USA,Brazil,0,0,0,0,20/07/2022,0,0,3,3,0,0,0,0,0,0,0,0,9,0,9,18,5,5,0,10
6348,119732,2022,USA,Argentina,0,0,0,0,10/07/2022,0,0,0,0,0,0,0,0,0,0,0,0,0,0,0,0,0,0,0,0
6349,119732,2022,Canada,USA,0,0,0,0,09/07/2022,0,1,2,3,0,0,0,0,0,0,0,0,7,1,8,16,8,3,2,13
6350,119732,2022,France,USA,0,0,0,0,07/07/2022,0,1,4,5,0,0,0,0,0,0,0,0,5,1,12,18,7,3,0,10
6351,119732,2022,USA,Germany,0,0,0,0,05/07/2022,1,0,7,8,0,0,0,0,0,0,0,0,10,1,3,14,11,2,2,15
6352,119732,2022,USA,Poland,0,0,0,0,26/06/2022,1,0,1,2,0,0,0,0,0,0,0,0,4,0,12,16,7,4,0,11
6353,119732,2022,USA,Bulgaria,0,0,0,0,25/06/2022,1,0,2,3,0,0,0,0,0,0,0,0,7,2,9,18,8,3,2,13
6354,119732,2022,USA,Iran,0,0,0,0,23/06/2022,0,0,0,0,0,0,0,0,0,0,0,0,0,0,0,0,0,0,0,0
6355,119732,2022,Serbia,USA,0,0,0,0,22/06/2022,0,0,1,1,0,0,0,0,0,0,0,0,9,1,14,24,4,0,2,6
6356,153472,2022,France,USA,0,0,0,0,24/07/2022,0,0,0,0,0,0,0,0,0,0,0,0,0,0,0,0,0,0,0,0
6357,153472,2022,Poland,USA,0,0,0,0,23/07/2022,0,0,0,0,0,0,0,0,0,0,0,0,0,0,0,0,0,0,0,0
6358,153472,2022,USA,Brazil,0,0,0,0,20/07/2022,0,0,0,0,0,0,0,0,0,0,0,0,0,0,0,0,0,0,0,0
6359,153472,2022,USA,Argentina,0,0,0,0,10/07/2022,0,0,0,0,0,0,0,0,0,0,0,0,0,0,0,0,0,0,0,0
6360,153472,2022,Canada,USA,0,0,0,0,09/07/2022,0,0,0,0,0,0,0,0,0,0,0,0,0,0,0,0,0,0,0,0
6361,153472,2022,France,USA,0,0,0,0,07/07/2022,0,0,0,0,0,0,0,0,0,0,0,0,0,0,0,0,0,0,0,0
6362,153472,2022,USA,Germany,0,0,0,0,05/07/2022,0,0,0,0,0,0,0,0,0,0,0,0,0,0,0,0,0,0,0,0
6363,153472,2022,USA,Brazil,0,1,14,15,11/06/2022,0,0,1,1,8,3,9,20,0,4,3,7,6,2,6,14,7,1,1,9
6364,153472,2022,Japan,USA,0,0,2,2,10/06/2022,0,0,0,0,0,0,0,0,0,0,0,0,0,0,0,0,0,0,0,0
6365,153472,2022,Netherlands,USA,0,0,0,0,09/06/2022,0,0,0,0,0,0,0,0,0,0,0,0,0,0,0,0,0,0,0,0
6366,153472,2022,Slovenia,USA,0,0,0,0,08/06/2022,0,0,0,0,0,0,0,0,0,0,0,0,0,0,0,0,0,0,0,0
6367,164133,2022,,,-,-,-,-,-,-,-,-,-,-,-,-,-,-,-,-,-,-,-,-,-,-,-,-,-
6368,182750,2022,,,-,-,-,-,-,-,-,-,-,-,-,-,-,-,-,-,-,-,-,-,-,-,-,-,-
6369,169728,2022,,,-,-,-,-,-,-,-,-,-,-,-,-,-,-,-,-,-,-,-,-,-,-,-,-,-
6370,162551,2022,France,USA,0,0,0,0,24/07/2022,0,0,0,0,0,0,0,0,0,0,0,0,0,0,0,0,0,0,0,0
6371,162551,2022,Poland,USA,0,0,0,0,23/07/2022,0,0,0,0,0,0,0,0,0,0,0,0,0,0,0,0,0,0,0,0
6372,162551,2022,USA,Brazil,0,0,0,0,20/07/2022,0,0,0,0,0,0,0,0,0,0,0,0,0,0,0,0,0,0,0,0
6373,162551,2022,USA,Argentina,0,0,0,0,10/07/2022,0,0,0,0,0,0,0,0,0,0,0,0,0,0,0,0,0,0,0,0
6374,162551,2022,Canada,USA,0,0,0,0,09/07/2022,0,0,0,0,0,0,0,0,0,0,0,0,0,0,0,0,0,0,0,0
6375,162551,2022,France,USA,0,0,0,0,07/07/2022,0,0,0,0,0,0,0,0,0,0,0,0,0,0,0,0,0,0,0,0
6376,162551,2022,USA,Germany,0,0,0,0,05/07/2022,0,0,0,0,0,0,0,0,0,0,0,0,0,0,0,0,0,0,0,0
6377,162551,2022,USA,Poland,0,0,0,0,26/06/2022,0,0,0,0,0,0,0,0,0,0,0,0,0,0,0,0,0,0,0,0
6378,162551,2022,USA,Bulgaria,0,0,0,0,25/06/2022,0,0,0,0,0,0,0,0,0,0,0,0,0,0,0,0,0,0,0,0
6379,162551,2022,USA,Iran,0,1,5,6,23/06/2022,0,0,0,0,2,1,2,5,0,3,0,3,0,0,0,0,0,0,0,0
6380,162551,2022,Serbia,USA,0,0,0,0,22/06/2022,0,0,0,0,0,0,0,0,0,0,0,0,0,0,0,0,0,0,0,0
6381,162551,2022,USA,Brazil,2,2,12,16,11/06/2022,0,0,0,0,9,0,2,11,2,7,4,13,0,0,0,0,5,0,0,5
6382,162551,2022,Japan,USA,0,0,1,1,10/06/2022,0,0,0,0,0,0,0,0,0,0,0,0,0,0,1,1,0,0,0,0
6383,162551,2022,Netherlands,USA,0,0,0,0,09/06/2022,0,0,0,0,1,0,1,2,0,0,0,0,0,0,0,0,0,0,0,0
6384,162551,2022,Slovenia,USA,0,0,0,0,08/06/2022,0,0,0,0,0,0,0,0,0,0,0,0,0,0,0,0,0,0,0,0
6385,156751,2022,,,-,-,-,-,-,-,-,-,-,-,-,-,-,-,-,-,-,-,-,-,-,-,-,-,-
6386,142412,2023,Italy,Argentina,0,0,1,1,19/07/2023,5,0,9,14,0,0,0,0,0,0,0,0,0,0,0,0,1,0,0,1
6387,142412,2023,Argentina,Iran,0,0,2,2,09/07/2023,0,0,1,1,0,0,0,0,0,0,0,0,0,0,0,0,0,0,0,0
6388,142412,2023,USA,Argentina,1,2,2,5,08/07/2023,3,0,5,8,0,0,0,0,0,0,1,1,0,0,1,1,4,1,0,5
6389,142412,2023,Argentina,Germany,0,0,0,0,06/07/2023,2,1,10,13,0,0,0,0,0,0,0,0,0,0,0,0,0,0,0,0
6390,142412,2023,Argentina,Serbia,0,0,0,0,04/07/2023,1,0,3,4,0,0,0,0,0,1,0,1,0,0,0,0,0,0,0,0
6391,142412,2023,Japan,Argentina,0,1,14,15,24/06/2023,29,0,65,94,0,0,0,0,0,7,0,7,0,0,1,1,1,6,0,7
6392,142412,2023,Argentina,Bulgaria,0,0,10,10,23/06/2023,20,0,27,47,0,0,0,0,0,0,1,1,0,0,0,0,5,0,3,8
6393,142412,2023,Argentina,France,0,2,13,15,21/06/2023,38,0,53,91,0,0,0,0,0,2,0,2,0,0,0,0,5,2,0,7
6394,142412,2023,Argentina,Slovenia,0,1,12,13,20/06/2023,28,2,52,82,0,0,1,1,0,0,0,0,0,0,0,0,2,1,2,5
6395,142412,2023,Argentina,Netherlands,0,0,0,0,11/06/2023,1,0,4,5,0,0,0,0,0,0,0,0,0,0,0,0,1,1,1,3
6396,142412,2023,Canada,Argentina,0,0,1,1,10/06/2023,0,0,2,2,0,0,0,0,0,0,0,0,0,1,0,1,1,0,0,1
6397,142412,2023,Argentina,Brazil,0,0,0,0,09/06/2023,1,0,7,8,0,0,0,0,0,0,0,0,0,0,0,0,0,2,0,2
6398,142412,2023,Italy,Argentina,0,0,0,0,06/06/2023,1,0,2,3,0,0,0,0,0,0,0,0,0,0,0,0,0,0,0,0
6399,142410,2023,Italy,Argentina,0,1,1,2,19/07/2023,0,0,2,2,2,0,4,6,0,0,0,0,2,0,4,6,0,0,0,0
6400,142410,2023,Argentina,Iran,1,3,6,10,09/07/2023,0,0,2,2,5,1,9,15,0,2,1,3,4,2,9,15,6,0,0,6
6401,142410,2023,USA,Argentina,0,2,8,10,08/07/2023,0,0,6,6,9,0,6,15,1,1,2,4,3,0,11,14,3,2,2,7
6402,142410,2023,Argentina,Germany,0,0,1,1,06/07/2023,0,0,0,0,2,0,2,4,0,0,2,2,1,0,2,3,3,0,0,3
6403,142410,2023,Argentina,Serbia,0,0,0,0,04/07/2023,0,0,0,0,0,0,0,0,0,0,0,0,0,0,0,0,0,0,0,0
6404,142410,2023,Japan,Argentina,0,0,0,0,24/06/2023,0,0,0,0,0,0,0,0,0,0,0,0,0,0,2,2,0,0,0,0
6405,142410,2023,Argentina,Bulgaria,0,0,0,0,23/06/2023,0,0,0,0,0,0,0,0,0,0,0,0,0,0,0,0,0,0,0,0
6406,142410,2023,Argentina,France,0,0,0,0,21/06/2023,0,0,0,0,0,0,0,0,0,0,0,0,0,0,0,0,0,0,0,0
6407,142410,2023,Argentina,Slovenia,0,2,1,3,20/06/2023,0,0,0,0,0,0,2,2,0,1,0,1,5,1,4,10,3,0,0,3
6408,142410,2023,Argentina,Netherlands,0,0,1,1,11/06/2023,0,0,0,0,2,1,2,5,0,1,1,2,0,0,9,9,2,3,1,6
6409,142410,2023,Canada,Argentina,0,1,4,5,10/06/2023,0,0,1,1,3,0,5,8,1,1,0,2,4,0,6,10,9,1,2,12
6410,142410,2023,Argentina,Brazil,0,2,1,3,09/06/2023,0,0,1,1,2,0,8,10,0,1,1,2,6,0,7,13,4,2,0,6
6411,142410,2023,Italy,Argentina,0,0,0,0,06/06/2023,0,0,0,0,0,0,0,0,0,0,0,0,0,0,0,0,0,0,0,0
6412,142411,2023,Italy,Argentina,0,0,0,0,19/07/2023,0,0,0,0,0,0,0,0,0,0,0,0,0,0,0,0,0,0,0,0
6413,142411,2023,Argentina,Iran,0,0,0,0,09/07/2023,0,0,0,0,0,0,0,0,0,0,0,0,0,0,0,0,0,0,0,0
6414,142411,2023,USA,Argentina,0,0,0,0,08/07/2023,0,0,0,0,0,0,0,0,0,0,0,0,0,0,0,0,0,0,0,0
6415,142411,2023,Argentina,Germany,0,0,0,0,06/07/2023,0,0,0,0,0,0,0,0,0,0,0,0,0,0,0,0,0,0,0,0
6416,142411,2023,Argentina,Serbia,0,0,0,0,04/07/2023,0,0,0,0,0,0,0,0,0,0,0,0,0,0,0,0,0,0,0,0
6417,142411,2023,Japan,Argentina,0,0,0,0,24/06/2023,0,0,0,0,0,0,0,0,0,0,0,0,0,0,0,0,0,0,0,0
6418,142411,2023,Argentina,Bulgaria,0,0,0,0,23/06/2023,0,0,0,0,0,0,0,0,0,0,0,0,0,0,0,0,0,0,0,0
6419,142411,2023,Argentina,France,0,0,0,0,21/06/2023,0,0,0,0,0,0,0,0,0,0,0,0,0,0,0,0,0,0,0,0
6420,142411,2023,Argentina,Slovenia,0,0,0,0,20/06/2023,0,0,0,0,0,0,0,0,0,0,0,0,0,0,0,0,0,0,0,0
6421,142411,2023,Argentina,Netherlands,0,0,0,0,11/06/2023,0,0,0,0,0,0,0,0,0,0,0,0,0,0,0,0,0,0,0,0
6422,142411,2023,Canada,Argentina,0,2,11,13,10/06/2023,0,0,2,2,8,2,5,15,1,3,6,10,0,0,0,0,2,1,1,4
6423,142411,2023,Argentina,Brazil,0,1,21,22,09/06/2023,0,0,1,1,5,0,7,12,3,7,7,17,0,0,1,1,6,1,0,7
6424,142411,2023,Italy,Argentina,0,0,4,4,06/06/2023,0,0,0,0,1,0,2,3,2,1,1,4,0,0,0,0,0,0,0,0
6425,162546,2023,Italy,Argentina,0,4,4,8,19/07/2023,0,0,2,2,5,2,8,15,0,2,0,2,0,1,19,20,3,1,2,6
6426,162546,2023,Argentina,Iran,0,6,10,16,09/07/2023,0,0,5,5,16,7,9,32,1,4,2,7,5,0,18,23,4,1,0,5
6427,162546,2023,USA,Argentina,1,3,16,20,08/07/2023,0,1,2,3,12,4,10,26,0,4,4,8,4,1,25,30,6,4,4,14
6428,162546,2023,Argentina,Germany,2,5,7,14,06/07/2023,0,0,4,4,9,4,10,23,3,2,0,5,2,1,13,16,1,2,0,3
6429,162546,2023,Argentina,Serbia,1,6,9,16,04/07/2023,0,0,3,3,12,2,13,27,1,2,1,4,5,1,13,19,8,4,1,13
6430,162546,2023,Japan,Argentina,1,3,12,16,24/06/2023,0,0,2,2,21,2,10,33,0,5,1,6,9,1,17,27,3,3,3,9
6431,162546,2023,Argentina,Bulgaria,4,2,9,15,23/06/2023,0,0,2,2,12,2,7,21,1,3,1,5,4,1,21,26,5,3,0,8
6432,162546,2023,Argentina,France,3,3,16,22,21/06/2023,0,1,2,3,13,4,11,28,0,4,1,5,4,0,8,12,6,3,0,9
6433,162546,2023,Argentina,Slovenia,0,3,11,14,20/06/2023,0,0,0,0,16,4,7,27,2,0,3,5,10,1,13,24,10,2,1,13
6434,162546,2023,Argentina,Netherlands,3,5,11,19,11/06/2023,0,0,6,6,9,4,3,16,2,2,0,4,1,2,9,12,8,0,0,8
6435,162546,2023,Canada,Argentina,2,1,11,14,10/06/2023,0,0,2,2,4,3,8,15,0,2,0,2,5,0,10,15,4,5,0,9
6436,162546,2023,Argentina,Brazil,0,4,12,16,09/06/2023,0,0,5,5,14,1,12,27,2,4,7,13,2,3,21,26,11,5,0,16
6437,162546,2023,Italy,Argentina,2,3,9,14,06/06/2023,0,0,0,0,8,3,5,16,1,0,2,3,6,1,8,15,4,0,1,5
6438,152692,2023,Italy,Argentina,1,0,10,11,19/07/2023,0,0,0,0,7,2,5,14,2,1,4,7,0,0,2,2,1,0,0,1
6439,152692,2023,Argentina,Iran,0,5,14,19,09/07/2023,0,0,5,5,11,2,8,21,10,10,9,29,1,0,1,2,3,1,0,4
6440,152692,2023,USA,Argentina,0,4,13,17,08/07/2023,0,0,0,0,9,2,5,16,6,3,8,17,2,0,1,3,0,1,3,4
6441,152692,2023,Argentina,Germany,1,2,7,10,06/07/2023,0,0,5,5,6,0,0,6,6,3,0,9,0,1,3,4,2,1,0,3
6442,152692,2023,Argentina,Serbia,1,1,15,17,04/07/2023,0,0,0,0,7,0,3,10,8,4,2,14,0,0,0,0,3,0,0,3
6443,152692,2023,Japan,Argentina,2,2,17,21,24/06/2023,0,0,0,0,6,0,5,11,3,8,4,15,3,0,1,4,2,3,0,5
6444,152692,2023,Argentina,Bulgaria,2,0,11,13,23/06/2023,0,0,1,1,8,2,1,11,6,4,2,12,0,0,0,0,1,1,0,2
6445,152692,2023,Argentina,France,0,2,14,16,21/06/2023,0,0,0,0,11,0,4,15,5,9,1,15,0,0,0,0,5,1,0,6
6446,152692,2023,Argentina,Slovenia,0,5,11,16,20/06/2023,0,0,0,0,10,1,4,15,0,7,4,11,1,0,1,2,2,1,0,3
6447,152692,2023,Argentina,Netherlands,1,2,19,22,11/06/2023,0,0,1,1,7,1,0,8,1,4,4,9,1,0,3,4,5,1,1,7
6448,152692,2023,Canada,Argentina,1,2,17,20,10/06/2023,0,0,0,0,8,0,5,13,2,1,2,5,1,0,0,1,2,0,0,2
6449,152692,2023,Argentina,Brazil,1,3,16,20,09/06/2023,0,0,1,1,10,0,3,13,2,7,3,12,0,0,1,1,4,1,0,5
6450,152692,2023,Italy,Argentina,2,3,9,14,06/06/2023,0,0,0,0,3,1,4,8,2,1,5,8,0,0,2,2,0,0,0,0
6451,153053,2023,Italy,Argentina,0,0,0,0,19/07/2023,0,0,4,4,0,0,0,0,0,0,0,0,4,1,9,14,5,5,0,10
6452,153053,2023,Argentina,Iran,0,0,0,0,09/07/2023,0,0,8,8,0,0,0,0,0,0,0,0,5,0,12,17,6,1,1,8
6453,153053,2023,USA,Argentina,0,0,0,0,08/07/2023,0,0,4,4,0,0,0,0,0,0,0,0,9,2,15,26,8,7,1,16
6454,153053,2023,Argentina,Germany,0,0,0,0,06/07/2023,0,0,0,0,0,0,0,0,0,0,0,0,3,0,10,13,7,4,1,12
6455,153053,2023,Argentina,Serbia,0,0,0,0,04/07/2023,0,0,6,6,0,0,0,0,0,0,0,0,9,1,14,24,7,4,2,13
6456,153053,2023,Japan,Argentina,0,0,0,0,24/06/2023,0,0,6,6,0,0,0,0,0,0,0,0,5,0,17,22,8,6,3,17
6457,153053,2023,Argentina,Bulgaria,0,0,0,0,23/06/2023,0,0,6,6,0,0,0,0,0,0,0,0,2,1,7,10,13,3,1,17
6458,153053,2023,Argentina,France,0,0,0,0,21/06/2023,0,0,7,7,0,0,0,0,0,0,0,0,8,0,10,18,11,1,0,12
6459,153053,2023,Argentina,Slovenia,0,0,0,0,20/06/2023,0,0,2,2,0,0,0,0,0,0,0,0,10,1,9,20,11,3,0,14
6460,153053,2023,Argentina,Netherlands,0,0,0,0,11/06/2023,0,0,10,10,0,0,0,0,0,0,0,0,3,2,24,29,9,7,0,16
6461,153053,2023,Canada,Argentina,0,0,0,0,10/06/2023,0,0,9,9,0,0,0,0,0,0,0,0,11,0,13,24,13,9,2,24
6462,153053,2023,Argentina,Brazil,0,0,0,0,09/06/2023,0,0,4,4,0,0,0,0,0,0,0,0,5,0,10,15,9,8,1,18
6463,153053,2023,Italy,Argentina,0,0,0,0,06/06/2023,0,0,4,4,0,0,0,0,0,0,0,0,6,1,10,17,6,5,2,13
6464,160816,2023,Italy,Argentina,0,1,0,1,19/07/2023,0,0,0,0,1,0,0,1,0,0,0,0,0,0,0,0,0,0,0,0
6465,160816,2023,Argentina,Iran,0,0,0,0,09/07/2023,0,0,0,0,0,0,0,0,0,0,0,0,0,0,0,0,0,0,0,0
6466,160816,2023,USA,Argentina,0,0,0,0,08/07/2023,0,0,0,0,0,0,0,0,0,0,0,0,0,0,0,0,0,0,0,0
6467,160816,2023,Argentina,Germany,0,0,0,0,06/07/2023,0,0,0,0,0,0,0,0,0,0,0,0,0,0,0,0,0,0,0,0
6468,160816,2023,Argentina,Serbia,0,0,0,0,04/07/2023,0,0,0,0,0,0,0,0,0,0,0,0,0,0,0,0,0,0,0,0
6469,160816,2023,Japan,Argentina,0,0,0,0,24/06/2023,0,0,0,0,0,0,0,0,0,0,0,0,0,0,0,0,0,0,0,0
6470,160816,2023,Argentina,Bulgaria,0,0,0,0,23/06/2023,0,0,0,0,0,0,0,0,0,0,0,0,0,0,0,0,0,0,0,0
6471,160816,2023,Argentina,France,0,0,0,0,21/06/2023,0,0,0,0,0,0,0,0,0,0,0,0,0,0,0,0,0,0,0,0
6472,160816,2023,Argentina,Slovenia,0,0,0,0,20/06/2023,0,0,0,0,0,0,0,0,0,0,0,0,0,0,0,0,0,0,0,0
6473,160816,2023,Argentina,Netherlands,0,0,0,0,11/06/2023,0,0,0,0,0,0,0,0,0,0,0,0,0,0,0,0,0,0,0,0
6474,160816,2023,Canada,Argentina,0,0,0,0,10/06/2023,0,0,0,0,0,0,0,0,0,0,0,0,0,0,0,0,0,0,0,0
6475,160816,2023,Argentina,Brazil,0,0,0,0,09/06/2023,0,0,0,0,0,0,0,0,0,0,0,0,0,0,0,0,0,0,0,0
6476,160816,2023,Italy,Argentina,0,0,0,0,06/06/2023,0,0,0,0,0,0,0,0,0,0,0,0,0,0,0,0,0,0,0,0
6477,174853,2023,Italy,Argentina,1,0,2,3,19/07/2023,0,0,0,0,1,3,3,7,0,1,0,1,1,0,6,7,0,0,1,1
6478,174853,2023,Argentina,Iran,2,1,1,4,09/07/2023,0,0,0,0,2,1,0,3,0,0,1,1,0,0,3,3,0,0,0,0
6479,174853,2023,USA,Argentina,0,1,3,4,08/07/2023,0,0,2,2,1,1,1,3,0,1,0,1,0,0,2,2,0,0,0,0
6480,174853,2023,Argentina,Germany,0,0,0,0,06/07/2023,0,0,0,0,0,0,0,0,0,0,0,0,0,0,0,0,0,0,0,0
6481,174853,2023,Argentina,Serbia,0,0,3,3,04/07/2023,0,0,3,3,4,0,2,6,1,0,0,1,1,0,3,4,0,0,0,0
6482,174853,2023,Japan,Argentina,0,0,0,0,24/06/2023,0,0,0,0,0,0,0,0,0,0,0,0,0,0,0,0,0,0,0,0
6483,174853,2023,Argentina,Bulgaria,0,0,0,0,23/06/2023,0,0,0,0,0,0,0,0,0,0,0,0,0,0,0,0,0,0,0,0
6484,174853,2023,Argentina,France,0,1,2,3,21/06/2023,0,0,0,0,0,0,0,0,0,0,0,0,0,0,0,0,0,0,0,0
6485,174853,2023,Argentina,Slovenia,0,0,0,0,20/06/2023,0,0,0,0,0,0,0,0,0,0,0,0,0,0,0,0,0,0,0,0
6486,174853,2023,Argentina,Netherlands,0,0,1,1,11/06/2023,0,0,1,1,1,1,0,2,0,0,0,0,0,0,0,0,0,0,0,0
6487,174853,2023,Canada,Argentina,0,0,0,0,10/06/2023,0,0,0,0,0,0,0,0,0,0,0,0,0,0,0,0,0,0,0,0
6488,174853,2023,Argentina,Brazil,0,0,1,1,09/06/2023,0,0,0,0,1,0,0,1,0,0,0,0,0,0,3,3,0,2,1,3
6489,174853,2023,Italy,Argentina,0,0,0,0,06/06/2023,0,0,0,0,0,0,0,0,0,0,0,0,0,0,0,0,0,0,0,0
6490,142415,2023,Italy,Argentina,0,0,0,0,19/07/2023,0,0,0,0,0,0,0,0,0,0,0,0,0,0,0,0,0,0,0,0
6491,142415,2023,Argentina,Iran,1,0,3,4,09/07/2023,0,0,0,0,1,0,2,3,0,0,1,1,0,0,0,0,2,0,0,2
6492,142415,2023,USA,Argentina,0,4,11,15,08/07/2023,0,0,1,1,13,3,8,24,1,3,1,5,0,0,0,0,2,1,1,4
6493,142415,2023,Argentina,Germany,2,2,11,15,06/07/2023,0,0,2,2,8,3,5,16,0,3,4,7,0,0,0,0,4,1,0,5
6494,142415,2023,Argentina,Serbia,1,3,14,18,04/07/2023,0,0,1,1,16,3,5,24,1,6,6,13,0,0,1,1,3,1,0,4
6495,142415,2023,Japan,Argentina,0,0,6,6,24/06/2023,0,0,2,2,11,2,7,20,1,3,0,4,0,0,3,3,1,1,0,2
6496,142415,2023,Argentina,Bulgaria,1,3,8,12,23/06/2023,0,2,0,2,7,2,6,15,0,3,4,7,0,0,0,0,4,1,1,6
6497,142415,2023,Argentina,France,0,3,2,5,21/06/2023,0,0,0,0,6,3,6,15,0,1,1,2,0,0,0,0,1,1,1,3
6498,142415,2023,Argentina,Slovenia,2,4,10,16,20/06/2023,0,0,1,1,14,6,11,31,0,3,2,5,0,0,0,0,3,1,0,4
6499,142415,2023,Argentina,Netherlands,0,2,1,3,11/06/2023,0,0,0,0,2,2,4,8,2,1,2,5,0,0,0,0,0,2,1,3
6500,142415,2023,Canada,Argentina,0,2,7,9,10/06/2023,0,0,2,2,6,0,3,9,0,2,0,2,0,0,0,0,2,0,0,2
6501,142415,2023,Argentina,Brazil,0,3,15,18,09/06/2023,0,0,2,2,18,10,11,39,2,4,4,10,2,0,0,2,5,7,0,12
6502,142415,2023,Italy,Argentina,0,2,11,13,06/06/2023,0,0,0,0,17,0,5,22,0,0,0,0,0,0,1,1,3,0,0,3
6503,117457,2023,Italy,Argentina,0,0,6,6,19/07/2023,19,0,36,55,0,0,0,0,0,0,0,0,0,0,0,0,3,5,0,8
6504,117457,2023,Argentina,Iran,0,1,25,26,09/07/2023,37,0,70,107,2,0,0,2,1,2,3,6,0,0,0,0,14,3,1,18
6505,117457,2023,USA,Argentina,0,2,17,19,08/07/2023,37,1,80,118,0,0,2,2,0,5,4,9,0,0,0,0,7,0,0,7
6506,117457,2023,Argentina,Germany,1,0,15,16,06/07/2023,23,0,27,50,1,0,0,1,1,1,0,2,0,0,0,0,4,2,2,8
6507,117457,2023,Argentina,Serbia,0,1,14,15,04/07/2023,39,0,41,80,0,0,1,1,0,2,2,4,0,1,0,1,8,2,0,10
6508,117457,2023,Argentina,Netherlands,1,0,10,11,11/06/2023,24,3,78,105,1,1,1,3,1,4,4,9,0,0,0,0,7,3,1,11
6509,117457,2023,Canada,Argentina,0,1,8,9,10/06/2023,16,0,84,100,2,0,0,2,0,2,1,3,0,0,0,0,5,2,1,8
6510,117457,2023,Argentina,Brazil,2,1,13,16,09/06/2023,28,0,79,107,1,0,1,2,1,3,1,5,0,0,0,0,6,3,0,9
6511,117457,2023,Italy,Argentina,0,2,12,14,06/06/2023,19,0,46,65,0,0,1,1,1,1,1,3,0,0,1,1,3,0,2,5
6512,141282,2023,Italy,Argentina,0,1,5,6,19/07/2023,0,0,1,1,5,6,12,23,1,2,1,4,0,0,0,0,0,0,0,0
6513,141282,2023,Argentina,Iran,0,3,8,11,09/07/2023,0,0,1,1,8,9,5,22,1,2,1,4,0,0,0,0,2,0,0,2
6514,141282,2023,USA,Argentina,1,0,7,8,08/07/2023,0,0,1,1,12,4,11,27,1,0,0,1,1,0,0,1,2,0,1,3
6515,141282,2023,Argentina,Germany,1,0,3,4,06/07/2023,0,0,0,0,2,2,3,7,0,1,0,1,0,0,0,0,0,0,0,0
6516,141282,2023,Argentina,Serbia,0,0,1,1,04/07/2023,0,0,0,0,0,0,1,1,0,0,0,0,0,0,0,0,0,0,0,0
6517,141282,2023,Japan,Argentina,0,2,6,8,24/06/2023,0,0,0,0,7,0,6,13,0,0,2,2,2,1,1,4,2,2,0,4
6518,141282,2023,Argentina,Bulgaria,0,1,4,5,23/06/2023,0,0,0,0,2,1,1,4,0,1,0,1,0,0,0,0,0,0,0,0
6519,141282,2023,Argentina,France,0,2,5,7,21/06/2023,0,0,0,0,8,2,11,21,1,1,3,5,1,0,0,1,2,0,0,2
6520,141282,2023,Argentina,Slovenia,0,0,3,3,20/06/2023,0,0,0,0,2,2,2,6,0,0,0,0,0,0,0,0,1,0,0,1
6521,141282,2023,Argentina,Netherlands,1,3,17,21,11/06/2023,0,0,1,1,24,1,12,37,0,4,2,6,0,0,0,0,7,1,1,9
6522,141282,2023,Canada,Argentina,0,1,8,9,10/06/2023,0,1,1,2,9,3,11,23,2,1,2,5,1,0,0,1,9,1,1,11
6523,141282,2023,Argentina,Brazil,0,1,0,1,09/06/2023,0,0,0,0,1,0,2,3,0,0,0,0,0,0,0,0,1,0,0,1
6524,141282,2023,Italy,Argentina,0,0,0,0,06/06/2023,0,0,0,0,1,0,0,1,0,0,0,0,0,0,0,0,0,0,0,0
6525,163555,2023,Italy,Argentina,0,1,2,3,19/07/2023,0,0,2,2,3,3,7,13,0,3,1,4,2,2,10,14,3,0,0,3
6526,163555,2023,Argentina,Iran,0,4,4,8,09/07/2023,0,0,3,3,14,6,5,25,0,5,6,11,2,1,20,23,8,1,1,10
6527,163555,2023,USA,Argentina,0,3,4,7,08/07/2023,0,0,1,1,5,3,10,18,3,0,3,6,5,3,10,18,4,2,3,9
6528,163555,2023,Argentina,Germany,0,3,2,5,06/07/2023,0,0,2,2,7,4,5,16,0,1,1,2,4,0,7,11,5,0,0,5
6529,163555,2023,Argentina,Serbia,2,2,5,9,04/07/2023,0,0,1,1,5,6,7,18,1,3,2,6,5,2,7,14,4,3,0,7
6530,163555,2023,Japan,Argentina,0,9,15,24,24/06/2023,0,0,2,2,15,3,11,29,0,1,1,2,8,1,23,32,2,6,1,9
6531,163555,2023,Argentina,Bulgaria,0,2,9,11,23/06/2023,0,0,0,0,9,2,9,20,0,3,4,7,2,0,9,11,5,3,1,9
6532,163555,2023,Argentina,France,1,4,13,18,21/06/2023,0,0,2,2,7,3,7,17,1,2,2,5,7,2,29,38,6,1,0,7
6533,163555,2023,Argentina,Slovenia,0,5,2,7,20/06/2023,0,0,1,1,5,2,10,17,0,0,3,3,6,2,10,18,5,1,1,7
6534,163555,2023,Argentina,Netherlands,2,5,16,23,11/06/2023,0,0,1,1,10,8,16,34,4,3,2,9,7,3,22,32,9,4,3,16
6535,163555,2023,Canada,Argentina,0,5,10,15,10/06/2023,0,0,2,2,15,2,20,37,4,5,5,14,4,2,15,21,7,2,1,10
6536,163555,2023,Argentina,Brazil,1,4,4,9,09/06/2023,0,0,3,3,8,2,13,23,0,4,0,4,1,4,25,30,8,4,0,12
6537,163555,2023,Italy,Argentina,0,5,6,11,06/06/2023,0,0,0,0,9,3,11,23,2,0,2,4,3,0,12,15,6,1,0,7
6538,125047,2023,Italy,Argentina,0,1,4,5,19/07/2023,0,0,1,1,2,0,2,4,1,4,3,8,0,1,1,2,0,2,0,2
6539,125047,2023,Argentina,Iran,0,0,10,10,09/07/2023,0,0,0,0,3,0,0,3,0,1,2,3,0,0,1,1,1,0,1,2
6540,125047,2023,USA,Argentina,0,0,0,0,08/07/2023,0,0,0,0,0,0,0,0,0,0,0,0,0,0,0,0,0,0,0,0
6541,125047,2023,Argentina,Germany,0,0,0,0,06/07/2023,0,0,0,0,0,0,0,0,0,0,0,0,0,0,0,0,0,0,0,0
6542,125047,2023,Argentina,Serbia,0,0,0,0,04/07/2023,0,0,0,0,0,0,0,0,0,0,0,0,0,0,0,0,0,0,0,0
6543,125047,2023,Japan,Argentina,0,1,11,12,24/06/2023,0,0,1,1,6,0,0,6,2,4,3,9,0,0,0,0,1,0,0,1
6544,125047,2023,Argentina,Bulgaria,0,0,0,0,23/06/2023,0,0,0,0,0,0,0,0,0,0,0,0,0,0,0,0,0,0,0,0
6545,125047,2023,Argentina,France,0,0,0,0,21/06/2023,0,0,0,0,0,0,0,0,0,0,0,0,0,0,0,0,0,0,0,0
6546,125047,2023,Argentina,Slovenia,0,0,3,3,20/06/2023,0,0,0,0,0,0,0,0,0,0,0,0,0,0,0,0,0,1,0,1
6547,125047,2023,Argentina,Netherlands,0,2,16,18,11/06/2023,0,0,2,2,7,0,10,17,5,4,3,12,0,0,2,2,3,1,2,6
6548,125047,2023,Canada,Argentina,0,0,0,0,10/06/2023,0,0,0,0,0,0,0,0,0,0,0,0,0,0,0,0,0,0,0,0
6549,125047,2023,Argentina,Brazil,0,0,0,0,09/06/2023,0,0,0,0,0,0,0,0,0,0,0,0,0,0,0,0,0,0,0,0
6550,125047,2023,Italy,Argentina,0,0,0,0,06/06/2023,0,0,0,0,0,0,0,0,0,0,0,0,0,0,0,0,0,0,0,0
6551,162543,2023,Italy,Argentina,0,0,0,0,19/07/2023,0,0,0,0,0,0,0,0,0,0,0,0,0,0,0,0,0,0,0,0
6552,162543,2023,Argentina,Iran,1,3,7,11,09/07/2023,0,0,0,0,3,0,2,5,1,1,5,7,0,0,0,0,1,1,0,2
6553,162543,2023,USA,Argentina,1,2,21,24,08/07/2023,0,0,0,0,12,0,6,18,1,6,10,17,1,0,0,1,0,2,1,3
6554,162543,2023,Argentina,Germany,0,1,7,8,06/07/2023,0,0,2,2,3,0,4,7,1,1,5,7,0,0,0,0,2,0,0,2
6555,162543,2023,Argentina,Serbia,0,2,12,14,04/07/2023,0,0,2,2,3,1,7,11,4,5,3,12,0,0,2,2,1,1,0,2
6556,162543,2023,Japan,Argentina,1,1,5,7,24/06/2023,0,0,1,1,1,0,2,3,1,3,4,8,1,0,1,2,0,1,0,1
6557,162543,2023,Argentina,Bulgaria,0,0,7,7,23/06/2023,0,0,1,1,4,1,2,7,0,2,7,9,0,0,0,0,1,1,0,2
6558,162543,2023,Argentina,France,0,1,10,11,21/06/2023,0,0,1,1,6,1,4,11,0,10,4,14,1,0,0,1,2,1,1,4
6559,162543,2023,Argentina,Slovenia,0,1,12,13,20/06/2023,0,0,0,0,7,1,2,10,1,2,3,6,0,0,2,2,6,2,0,8
6560,162543,2023,Argentina,Netherlands,0,0,0,0,11/06/2023,0,0,0,0,0,0,0,0,0,0,0,0,0,0,0,0,0,0,0,0
6561,162543,2023,Canada,Argentina,0,0,0,0,10/06/2023,0,0,0,0,0,0,0,0,0,0,0,0,0,0,0,0,0,0,0,0
6562,162543,2023,Argentina,Brazil,0,0,0,0,09/06/2023,0,0,0,0,0,0,0,0,0,0,0,0,0,0,0,0,0,0,0,0
6563,162543,2023,Italy,Argentina,0,2,2,4,06/06/2023,0,0,0,0,1,0,2,3,0,1,5,6,0,0,0,0,1,0,0,1
6564,116099,2023,Poland,Brazil,0,0,5,5,20/07/2023,9,0,25,34,0,0,0,0,0,1,0,1,0,0,0,0,1,2,0,3
6565,116099,2023,Brazil,China,0,0,13,13,08/07/2023,12,1,42,55,0,0,0,0,0,3,5,8,0,0,0,0,4,2,2,8
6566,116099,2023,Poland,Brazil,0,0,11,11,07/07/2023,17,0,51,68,2,0,0,2,0,4,1,5,0,0,0,0,7,2,2,11
6567,116099,2023,Brazil,Netherlands,0,0,12,12,06/07/2023,11,1,40,52,1,0,1,2,0,2,2,4,0,0,0,0,4,1,0,5
6568,116099,2023,Brazil,Italy,0,0,8,8,04/07/2023,22,0,64,86,1,0,2,3,0,1,6,7,0,0,1,1,3,3,2,8
6569,116099,2023,Brazil,France,0,3,14,17,25/06/2023,28,1,60,89,0,0,0,0,1,0,2,3,0,0,1,1,3,6,2,11
6570,116099,2023,Brazil,Slovenia,1,2,13,16,24/06/2023,30,0,69,99,1,0,1,2,1,2,3,6,0,0,0,0,7,3,2,12
6571,116099,2023,Japan,Brazil,0,1,2,3,22/06/2023,8,0,16,24,0,0,0,0,1,2,0,3,0,0,0,0,1,2,0,3
6572,116099,2023,Brazil,Bulgaria,0,1,6,7,20/06/2023,17,0,36,53,0,0,0,0,2,1,3,6,0,0,0,0,3,1,0,4
6573,116099,2023,USA,Brazil,2,2,20,24,11/06/2023,22,0,62,84,0,0,0,0,1,3,5,9,0,0,0,0,2,3,1,6
6574,116099,2023,Brazil,Cuba,0,2,14,16,10/06/2023,33,1,57,91,0,0,0,0,0,2,3,5,0,0,0,0,4,3,0,7
6575,116099,2023,Argentina,Brazil,1,1,7,9,09/06/2023,12,1,51,64,0,0,1,1,0,1,1,2,0,0,0,0,6,3,0,9
6576,116099,2023,Brazil,Germany,0,1,19,20,08/06/2023,18,1,47,66,0,0,1,1,0,4,0,4,0,0,1,1,8,5,1,14
6577,125010,2023,Poland,Brazil,0,2,0,2,20/07/2023,0,0,0,0,0,0,0,0,0,1,1,2,0,0,0,0,0,0,0,0
6578,125010,2023,Brazil,China,2,2,11,15,08/07/2023,0,0,1,1,8,0,0,8,2,1,3,6,0,0,0,0,1,0,0,1
6579,125010,2023,Poland,Brazil,0,1,0,1,07/07/2023,0,0,0,0,0,0,0,0,0,0,0,0,0,0,0,0,0,0,0,0
6580,125010,2023,Brazil,Netherlands,0,0,0,0,06/07/2023,0,0,0,0,0,0,0,0,0,0,0,0,0,0,0,0,0,0,0,0
6581,125010,2023,Brazil,Italy,0,2,2,4,04/07/2023,0,0,0,0,1,0,2,3,0,0,1,1,0,0,0,0,2,0,0,2
6582,125010,2023,Brazil,France,1,4,12,17,25/06/2023,0,0,0,0,4,1,0,5,0,5,5,10,0,0,0,0,2,0,0,2
6583,125010,2023,Brazil,Slovenia,1,4,12,17,24/06/2023,0,0,0,0,8,0,1,9,1,4,2,7,0,0,1,1,2,2,0,4
6584,125010,2023,Japan,Brazil,0,2,5,7,22/06/2023,0,0,1,1,3,0,2,5,2,3,2,7,0,0,0,0,0,0,0,0
6585,125010,2023,Brazil,Bulgaria,0,1,4,5,20/06/2023,0,0,1,1,1,0,0,1,0,1,0,1,0,0,0,0,1,0,0,1
6586,125010,2023,USA,Brazil,0,1,5,6,11/06/2023,0,0,0,0,2,1,3,6,0,3,1,4,0,0,1,1,0,0,0,0
6587,125010,2023,Brazil,Cuba,0,5,11,16,10/06/2023,0,0,0,0,8,2,3,13,3,3,5,11,0,0,1,1,1,1,0,2
6588,125010,2023,Argentina,Brazil,2,4,15,21,09/06/2023,0,0,0,0,5,1,4,10,3,4,10,17,0,0,1,1,5,1,0,6
6589,125010,2023,Brazil,Germany,2,2,10,14,08/06/2023,0,0,0,0,7,0,3,10,2,4,8,14,0,0,1,1,1,2,1,4
6590,174908,2023,Poland,Brazil,0,0,0,0,20/07/2023,0,0,0,0,0,0,0,0,0,0,0,0,0,0,0,0,0,0,0,0
6591,174908,2023,Brazil,China,0,0,15,15,08/07/2023,0,0,1,1,7,2,4,13,0,2,5,7,1,2,14,17,3,0,2,5
6592,174908,2023,Poland,Brazil,0,0,1,1,07/07/2023,0,0,0,0,0,1,0,1,1,1,0,2,1,0,1,2,0,0,0,0
6593,174908,2023,Brazil,Netherlands,0,1,0,1,06/07/2023,0,0,0,0,1,0,1,2,0,2,0,2,0,0,2,2,1,0,0,1
6594,174908,2023,Brazil,Italy,0,0,1,1,04/07/2023,0,0,0,0,0,0,1,1,0,0,0,0,1,1,3,5,0,0,0,0
6595,174908,2023,Brazil,France,0,0,11,11,25/06/2023,0,0,2,2,11,1,4,16,0,2,1,3,2,2,19,23,3,2,0,5
6596,174908,2023,Brazil,Slovenia,0,0,1,1,24/06/2023,0,0,1,1,1,1,2,4,0,1,0,1,1,0,3,4,0,0,0,0
6597,174908,2023,Japan,Brazil,0,1,0,1,22/06/2023,0,0,0,0,0,1,2,3,0,1,0,1,0,0,1,1,0,0,0,0
6598,174908,2023,Brazil,Bulgaria,0,0,0,0,20/06/2023,0,0,0,0,0,0,0,0,0,0,0,0,0,0,0,0,1,0,0,1
6599,174908,2023,USA,Brazil,0,0,0,0,11/06/2023,0,0,0,0,0,0,0,0,0,0,0,0,0,0,0,0,0,0,0,0
6600,174908,2023,Brazil,Cuba,0,0,1,1,10/06/2023,0,0,0,0,1,0,2,3,0,0,1,1,2,0,4,6,0,0,1,1
6601,174908,2023,Argentina,Brazil,0,0,1,1,09/06/2023,0,0,1,1,3,4,6,13,1,2,0,3,0,0,5,5,0,2,0,2
6602,174908,2023,Brazil,Germany,1,1,13,15,08/06/2023,0,0,5,5,6,3,8,17,1,3,0,4,3,0,11,14,3,3,1,7
6603,161930,2023,Poland,Brazil,0,0,6,6,20/07/2023,0,0,2,2,4,4,5,13,2,1,1,4,4,3,10,17,4,1,1,6
6604,161930,2023,Brazil,China,0,0,0,0,08/07/2023,0,0,2,2,0,0,0,0,1,0,0,1,0,0,0,0,1,0,0,1
6605,161930,2023,Poland,Brazil,0,3,14,17,07/07/2023,0,1,3,4,8,2,9,19,1,4,2,7,1,1,13,15,5,4,0,9
6606,161930,2023,Brazil,Netherlands,1,3,7,11,06/07/2023,0,0,1,1,7,1,5,13,2,4,0,6,2,0,13,15,3,3,0,6
6607,161930,2023,Brazil,Italy,1,4,8,13,04/07/2023,0,0,4,4,14,7,15,36,0,5,4,9,2,3,8,13,1,4,1,6
6608,161930,2023,Brazil,France,0,1,3,4,25/06/2023,0,0,2,2,0,0,2,2,1,1,0,2,0,0,2,2,1,0,0,1
6609,161930,2023,Brazil,Slovenia,0,6,9,15,24/06/2023,0,0,5,5,6,1,10,17,2,4,1,7,2,0,18,20,4,0,0,4
6610,161930,2023,Japan,Brazil,1,3,16,20,22/06/2023,0,0,4,4,11,2,8,21,4,3,3,10,8,3,13,24,3,2,0,5
6611,161930,2023,Brazil,Bulgaria,0,2,8,10,20/06/2023,0,0,1,1,5,2,5,12,0,1,3,4,3,0,3,6,3,1,0,4
6612,161930,2023,USA,Brazil,1,2,12,15,11/06/2023,0,0,2,2,4,5,7,16,2,5,0,7,3,1,10,14,4,0,0,4
6613,161930,2023,Brazil,Cuba,0,5,11,16,10/06/2023,0,0,4,4,8,5,3,16,0,4,2,6,10,0,18,28,7,3,2,12
6614,161930,2023,Argentina,Brazil,1,2,10,13,09/06/2023,0,0,2,2,10,2,6,18,0,1,0,1,4,1,23,28,6,2,0,8
6615,161930,2023,Brazil,Germany,0,1,1,2,08/06/2023,0,0,0,0,0,0,0,0,0,0,0,0,0,0,0,0,0,0,0,0
6616,118928,2023,Poland,Brazil,0,2,1,3,20/07/2023,0,0,0,0,2,0,2,4,0,1,0,1,0,1,9,10,0,0,0,0
6617,142744,2023,Poland,Brazil,0,0,3,3,20/07/2023,9,0,29,38,0,0,0,0,0,0,2,2,0,0,0,0,3,2,2,7
6618,142744,2023,Brazil,China,0,0,0,0,08/07/2023,1,0,0,1,0,0,0,0,0,0,0,0,0,0,0,0,0,0,0,0
6619,142744,2023,Poland,Brazil,0,1,3,4,07/07/2023,5,0,10,15,0,0,0,0,0,1,0,1,0,0,0,0,1,0,0,1
6620,142744,2023,Brazil,Netherlands,0,0,3,3,06/07/2023,5,0,7,12,0,0,0,0,0,1,1,2,0,0,0,0,0,0,0,0
6621,142744,2023,Brazil,Italy,0,0,4,4,04/07/2023,5,0,13,18,0,0,0,0,0,0,0,0,0,0,0,0,1,1,0,2
6622,142744,2023,Brazil,France,0,0,0,0,25/06/2023,1,0,1,2,0,0,0,0,0,0,0,0,0,0,0,0,0,2,0,2
6623,142744,2023,Brazil,Slovenia,0,0,0,0,24/06/2023,2,0,4,6,0,0,0,0,0,0,0,0,0,0,0,0,0,0,0,0
6624,142744,2023,Japan,Brazil,0,0,12,12,22/06/2023,24,1,55,80,1,0,0,1,0,1,4,5,0,0,0,0,2,1,0,3
6625,142744,2023,Brazil,Bulgaria,0,0,0,0,20/06/2023,0,0,0,0,0,0,0,0,0,0,0,0,0,0,0,0,2,1,0,3
6626,142744,2023,USA,Brazil,0,0,0,0,11/06/2023,0,0,3,3,0,0,0,0,0,0,0,0,0,0,0,0,0,0,0,0
6627,142744,2023,Brazil,Cuba,0,1,1,2,10/06/2023,14,0,10,24,0,0,0,0,0,0,1,1,0,0,0,0,0,0,0,0
6628,142744,2023,Argentina,Brazil,0,1,10,11,09/06/2023,14,0,33,47,0,0,2,2,0,1,1,2,0,0,0,0,6,5,0,11
6629,142744,2023,Brazil,Germany,0,0,2,2,08/06/2023,3,0,8,11,0,0,0,0,0,0,0,0,0,0,0,0,3,0,0,3
6630,161939,2023,Poland,Brazil,0,0,0,0,20/07/2023,0,0,0,0,0,0,0,0,0,0,0,0,0,0,0,0,0,0,0,0
6631,161939,2023,Brazil,China,0,0,0,0,08/07/2023,0,0,0,0,0,0,0,0,0,0,0,0,0,0,0,0,0,0,0,0
6632,161939,2023,Poland,Brazil,0,0,0,0,07/07/2023,0,0,2,2,0,0,0,0,0,0,0,0,6,1,19,26,8,5,1,14
6633,161939,2023,Brazil,Netherlands,0,0,0,0,06/07/2023,0,0,2,2,0,0,0,0,0,0,0,0,4,0,8,12,9,2,3,14
6634,161939,2023,Brazil,Italy,0,0,0,0,04/07/2023,0,0,0,0,0,0,0,0,0,0,0,0,0,1,2,3,4,3,0,7
6635,161939,2023,Brazil,France,0,0,0,0,25/06/2023,0,0,2,2,0,0,0,0,0,0,0,0,5,2,16,23,7,5,2,14
6636,161939,2023,Brazil,Slovenia,0,0,0,0,24/06/2023,0,0,2,2,0,0,0,0,0,0,0,0,5,1,16,22,10,5,0,15
6637,161939,2023,Japan,Brazil,0,0,0,0,22/06/2023,0,0,1,1,0,0,0,0,0,0,0,0,2,1,5,8,4,3,1,8
6638,161939,2023,Brazil,Bulgaria,0,0,0,0,20/06/2023,0,0,0,0,0,0,0,0,0,0,0,0,0,0,0,0,0,0,0,0
6639,161939,2023,USA,Brazil,0,0,0,0,11/06/2023,0,0,0,0,0,0,0,0,0,0,0,0,0,0,0,0,0,0,0,0
6640,161939,2023,Brazil,Cuba,0,0,0,0,10/06/2023,0,0,3,3,0,0,0,0,0,0,0,0,6,2,23,31,11,7,1,19
6641,161939,2023,Argentina,Brazil,0,0,0,0,09/06/2023,0,0,0,0,0,0,0,0,0,0,0,0,0,0,0,0,0,0,0,0
6642,161939,2023,Brazil,Germany,0,0,0,0,08/06/2023,0,0,3,3,0,0,0,0,0,0,0,0,4,2,16,22,13,4,0,17
6643,116081,2023,Poland,Brazil,2,4,9,15,20/07/2023,0,0,0,0,3,1,5,9,1,3,2,6,0,0,1,1,1,0,0,1
6644,116081,2023,Brazil,China,0,0,0,0,08/07/2023,0,0,0,0,0,0,0,0,0,0,0,0,0,0,0,0,0,0,0,0
6645,116081,2023,Poland,Brazil,2,3,11,16,07/07/2023,0,0,0,0,6,0,2,8,1,5,6,12,0,0,0,0,0,1,0,1
6646,116081,2023,Brazil,Netherlands,0,1,5,6,06/07/2023,0,0,0,0,4,2,8,14,6,3,10,19,0,0,1,1,1,0,0,1
6647,116081,2023,Brazil,Italy,0,3,7,10,04/07/2023,0,0,0,0,5,1,4,10,0,3,1,4,0,0,1,1,3,0,0,3
6648,116081,2023,Brazil,France,0,2,12,14,25/06/2023,0,0,0,0,5,3,1,9,1,2,6,9,0,0,1,1,3,1,1,5
6649,116081,2023,Brazil,Slovenia,0,0,0,0,24/06/2023,0,0,0,0,0,0,0,0,0,0,0,0,0,0,0,0,0,0,0,0
6650,116081,2023,Japan,Brazil,0,2,4,6,22/06/2023,0,0,0,0,5,0,4,9,0,4,3,7,0,0,0,0,1,1,1,3
6651,116081,2023,Brazil,Bulgaria,1,4,3,8,20/06/2023,0,0,0,0,4,0,2,6,0,3,4,7,0,0,0,0,1,0,0,1
6652,118916,2023,Poland,Brazil,0,0,0,0,20/07/2023,0,0,3,3,0,0,0,0,0,0,0,0,2,2,7,11,6,3,0,9
6653,118916,2023,Brazil,China,0,0,0,0,08/07/2023,0,0,3,3,0,0,0,0,0,0,0,0,2,0,7,9,9,2,0,11
6654,118916,2023,Poland,Brazil,0,0,0,0,07/07/2023,0,0,0,0,0,0,0,0,0,0,0,0,0,0,0,0,0,0,0,0
6655,118916,2023,Brazil,Netherlands,0,0,0,0,06/07/2023,0,0,0,0,0,0,0,0,0,0,0,0,0,0,0,0,0,0,0,0
6656,118916,2023,Brazil,Italy,0,0,0,0,04/07/2023,0,0,3,3,0,0,0,0,0,0,0,0,3,0,13,16,9,3,0,12
6657,118916,2023,Brazil,France,0,0,0,0,25/06/2023,0,0,0,0,0,0,0,0,0,0,0,0,0,0,0,0,0,0,0,0
6658,118916,2023,Brazil,Slovenia,0,0,0,0,24/06/2023,0,0,0,0,0,0,0,0,0,0,0,0,0,0,0,0,0,0,0,0
6659,118916,2023,Japan,Brazil,0,0,0,0,22/06/2023,0,0,1,1,0,0,0,0,0,0,0,0,4,0,4,8,7,2,0,9
6660,118916,2023,Brazil,Bulgaria,0,0,0,0,20/06/2023,0,0,2,2,0,0,0,0,0,0,0,0,1,1,10,12,3,4,2,9
6661,118916,2023,USA,Brazil,0,0,0,0,11/06/2023,0,0,1,1,0,0,0,0,0,0,0,0,4,1,13,18,13,3,1,17
6662,118916,2023,Brazil,Cuba,0,0,0,0,10/06/2023,0,0,0,0,0,0,0,0,0,0,0,0,0,0,0,0,0,0,0,0
6663,118916,2023,Argentina,Brazil,0,0,0,0,09/06/2023,0,0,9,9,0,0,0,0,0,0,0,0,5,1,16,22,8,5,2,15
6664,118916,2023,Brazil,Germany,0,0,0,0,08/06/2023,0,0,0,0,0,0,0,0,0,0,0,0,0,0,1,1,0,0,0,0
6665,136468,2023,Poland,Brazil,2,1,7,10,20/07/2023,0,0,5,5,7,4,9,20,1,2,3,6,2,3,16,21,3,3,0,6
6666,136468,2023,Brazil,China,0,2,7,9,08/07/2023,0,0,2,2,6,2,6,14,2,1,3,6,2,1,6,9,4,0,0,4
6667,136468,2023,Poland,Brazil,2,5,11,18,07/07/2023,1,1,3,5,12,7,5,24,0,0,3,3,5,1,20,26,3,0,0,3
6668,136468,2023,Brazil,Netherlands,2,2,12,16,06/07/2023,0,0,4,4,6,4,4,14,1,2,1,4,2,1,8,11,5,1,1,7
6669,136468,2023,Brazil,Italy,2,1,12,15,04/07/2023,0,0,9,9,9,1,9,19,0,2,2,4,6,8,26,40,4,0,1,5
6670,136468,2023,Brazil,France,3,4,12,19,25/06/2023,0,0,3,3,11,6,12,29,1,4,1,6,2,1,20,23,10,1,1,12
6671,136468,2023,Brazil,Slovenia,1,3,11,15,24/06/2023,0,0,8,8,18,2,17,37,0,6,2,8,4,0,22,26,5,2,0,7
6672,136468,2023,Japan,Brazil,1,2,20,23,22/06/2023,0,0,4,4,11,3,10,24,0,4,1,5,6,3,31,40,8,4,0,12
6673,136468,2023,Brazil,Bulgaria,2,2,7,11,20/06/2023,0,0,5,5,10,1,3,14,0,1,0,1,7,0,14,21,1,1,2,4
6674,136468,2023,USA,Brazil,1,4,11,16,11/06/2023,0,0,2,2,14,3,9,26,3,3,1,7,3,2,23,28,3,0,2,5
6675,136468,2023,Brazil,Cuba,1,2,15,18,10/06/2023,0,1,4,5,19,7,12,38,0,4,3,7,2,2,18,22,6,8,1,15
6676,136468,2023,Argentina,Brazil,0,3,16,19,09/06/2023,0,0,2,2,15,8,7,30,2,3,3,8,6,2,23,31,12,5,1,18
6677,136468,2023,Brazil,Germany,2,1,15,18,08/06/2023,1,0,4,5,16,3,4,23,2,4,2,8,0,1,17,18,6,4,0,10
6678,161921,2023,Poland,Brazil,0,0,1,1,20/07/2023,0,0,0,0,1,0,2,3,0,1,1,2,0,0,0,0,0,0,0,0
6679,161921,2023,Brazil,China,1,1,9,11,08/07/2023,0,0,3,3,12,2,8,22,4,2,0,6,0,0,1,1,1,1,0,2
6680,161921,2023,Poland,Brazil,0,0,2,2,07/07/2023,0,0,0,0,4,1,0,5,0,0,1,1,0,0,0,0,0,1,0,1
6681,161921,2023,Brazil,Netherlands,0,1,1,2,06/07/2023,0,0,0,0,2,1,1,4,0,0,0,0,0,0,0,0,0,0,0,0
6682,161921,2023,Brazil,Italy,0,1,6,7,04/07/2023,0,0,1,1,7,1,4,12,1,1,2,4,0,0,0,0,4,0,1,5
6683,161921,2023,Brazil,France,0,0,0,0,25/06/2023,0,0,1,1,1,0,0,1,0,0,0,0,0,0,0,0,0,0,0,0
6684,161921,2023,Brazil,Slovenia,0,0,0,0,24/06/2023,0,0,0,0,1,0,0,1,0,1,0,1,0,0,0,0,0,0,0,0
6685,161921,2023,Japan,Brazil,0,0,2,2,22/06/2023,0,0,0,0,3,0,2,5,0,0,0,0,0,0,0,0,0,0,0,0
6686,161921,2023,Brazil,Bulgaria,0,0,0,0,20/06/2023,0,0,1,1,1,0,0,1,1,0,2,3,0,0,0,0,0,0,0,0
6687,136947,2023,Poland,Brazil,1,2,6,9,20/07/2023,0,0,2,2,14,5,10,29,0,2,3,5,0,0,1,1,3,2,0,5
6688,136947,2023,Brazil,China,0,0,0,0,08/07/2023,0,0,0,0,0,0,0,0,0,0,0,0,0,0,0,0,0,0,0,0
6689,136947,2023,Poland,Brazil,0,4,3,7,07/07/2023,0,0,2,2,15,3,11,29,2,4,2,8,0,0,0,0,3,1,1,5
6690,136947,2023,Brazil,Netherlands,0,0,7,7,06/07/2023,0,0,1,1,8,3,5,16,1,1,4,6,0,0,0,0,7,2,0,9
6691,136947,2023,Brazil,Italy,0,4,3,7,04/07/2023,0,0,1,1,9,5,8,22,0,2,5,7,0,0,0,0,4,2,0,6
6692,136947,2023,Brazil,France,0,2,9,11,25/06/2023,0,0,1,1,23,6,10,39,1,5,6,12,0,0,1,1,5,2,1,8
6693,136947,2023,Brazil,Slovenia,1,3,10,14,24/06/2023,0,0,1,1,18,7,12,37,0,4,3,7,0,0,0,0,7,5,1,13
6694,136947,2023,Japan,Brazil,0,4,14,18,22/06/2023,0,0,2,2,20,2,10,32,0,5,2,7,0,0,2,2,9,5,0,14
6695,136947,2023,Brazil,Bulgaria,2,3,11,16,20/06/2023,0,0,0,0,12,3,8,23,0,4,0,4,0,0,0,0,6,2,0,8
6696,136947,2023,USA,Brazil,1,3,12,16,11/06/2023,0,0,2,2,15,2,13,30,1,2,1,4,0,0,0,0,5,2,0,7
6697,136947,2023,Brazil,Cuba,0,0,0,0,10/06/2023,0,0,1,1,0,0,1,1,1,0,0,1,0,0,0,0,0,0,0,0
6698,136947,2023,Argentina,Brazil,2,1,8,11,09/06/2023,0,0,3,3,10,2,8,20,1,6,7,14,0,0,0,0,3,4,0,7
6699,136947,2023,Brazil,Germany,0,3,10,13,08/06/2023,0,0,3,3,18,2,10,30,1,3,10,14,0,0,0,0,2,5,0,7
6700,136956,2023,Poland,Brazil,0,2,10,12,20/07/2023,0,0,0,0,4,1,2,7,1,1,4,6,0,0,2,2,1,0,1,2
6701,136956,2023,Brazil,China,0,2,8,10,08/07/2023,0,0,1,1,5,1,2,8,1,8,8,17,0,0,4,4,2,0,0,2
6702,136956,2023,Poland,Brazil,0,0,1,1,07/07/2023,0,0,1,1,0,1,0,1,0,1,0,1,0,0,0,0,0,0,0,0
6703,136956,2023,Brazil,Netherlands,0,0,0,0,06/07/2023,0,0,0,0,0,0,0,0,0,0,0,0,0,0,0,0,0,0,0,0
6704,136956,2023,Brazil,Italy,0,1,6,7,04/07/2023,0,1,1,2,8,1,2,11,2,3,7,12,1,0,4,5,1,2,0,3
6705,136956,2023,Brazil,France,0,0,1,1,25/06/2023,0,0,1,1,1,0,0,1,2,0,0,2,0,0,0,0,0,0,0,0
6706,136956,2023,Brazil,Slovenia,0,3,14,17,24/06/2023,0,0,1,1,10,0,1,11,2,4,2,8,1,0,2,3,1,1,0,2
6707,136956,2023,Japan,Brazil,0,0,10,10,22/06/2023,0,0,0,0,5,0,4,9,3,3,5,11,0,0,0,0,0,1,1,2
6708,136956,2023,Brazil,Bulgaria,1,1,15,17,20/06/2023,0,0,0,0,5,1,2,8,3,3,5,11,0,0,0,0,1,1,0,2
6709,136956,2023,USA,Brazil,0,1,5,6,11/06/2023,0,0,0,0,3,0,2,5,1,3,2,6,0,0,0,0,0,1,0,1
6710,136956,2023,Brazil,Cuba,0,0,14,14,10/06/2023,0,0,0,0,7,0,8,15,3,4,2,9,0,0,0,0,0,2,0,2
6711,136956,2023,Argentina,Brazil,1,2,5,8,09/06/2023,0,0,0,0,6,2,2,10,0,5,6,11,0,0,0,0,2,2,0,4
6712,136956,2023,Brazil,Germany,0,0,9,9,08/06/2023,0,0,0,0,2,0,3,5,4,7,5,16,0,1,2,3,2,4,0,6
6713,187493,2023,Poland,Brazil,0,0,0,0,20/07/2023,0,0,0,0,0,0,0,0,0,0,0,0,0,0,0,0,0,0,0,0
6714,187493,2023,Brazil,China,0,0,0,0,08/07/2023,0,0,0,0,0,0,0,0,0,0,0,0,0,0,0,0,0,0,0,0
6715,187493,2023,Poland,Brazil,0,4,8,12,07/07/2023,0,0,1,1,5,2,4,11,2,5,3,10,2,0,2,4,0,2,0,2
6716,187493,2023,Brazil,Netherlands,0,2,9,11,06/07/2023,0,0,1,1,5,0,0,5,1,4,3,8,0,0,0,0,2,1,0,3
6717,187493,2023,Brazil,Italy,0,1,5,6,04/07/2023,0,0,0,0,5,0,1,6,1,1,0,2,2,0,0,2,1,1,0,2
6718,187493,2023,Brazil,France,0,0,0,0,25/06/2023,0,0,0,0,0,0,0,0,0,0,0,0,0,0,0,0,0,0,0,0
6719,187493,2023,Brazil,Slovenia,0,2,1,3,24/06/2023,0,0,0,0,3,0,2,5,0,2,2,4,0,0,0,0,2,0,0,2
6720,187493,2023,Japan,Brazil,0,3,7,10,22/06/2023,0,0,0,0,8,0,4,12,1,5,5,11,1,0,1,2,1,0,0,1
6721,187493,2023,Brazil,Bulgaria,0,0,0,0,20/06/2023,0,0,0,0,0,0,0,0,0,0,0,0,0,0,0,0,0,0,0,0
6722,187493,2023,USA,Brazil,0,1,11,12,11/06/2023,0,0,0,0,12,0,0,12,1,3,6,10,0,0,0,0,3,0,0,3
6723,187493,2023,Brazil,Cuba,0,0,4,4,10/06/2023,0,0,0,0,0,1,0,1,0,1,0,1,0,0,0,0,0,0,0,0
6724,187493,2023,Argentina,Brazil,0,1,4,5,09/06/2023,0,0,0,0,7,1,2,10,0,1,3,4,0,0,0,0,1,1,0,2
6725,187493,2023,Brazil,Germany,0,0,0,0,08/06/2023,0,0,0,0,0,0,0,0,0,0,0,0,0,0,0,0,0,0,0,0
6726,173067,2023,USA,Bulgaria,0,1,4,5,10/07/2023,0,1,2,3,4,1,0,5,0,2,4,6,0,0,0,0,1,0,0,1
6727,173067,2023,Bulgaria,Serbia,0,0,7,7,08/07/2023,0,0,1,1,6,0,1,7,2,1,5,8,0,0,0,0,0,0,0,0
6728,173067,2023,Bulgaria,Iran,0,5,7,12,07/07/2023,0,0,0,0,6,0,2,8,3,4,5,12,0,0,0,0,2,0,0,2
6729,173067,2023,Germany,Bulgaria,0,2,5,7,06/07/2023,0,0,1,1,5,0,3,8,0,4,9,13,0,0,0,0,1,1,0,2
6730,173067,2023,Bulgaria,Cuba,0,0,18,18,25/06/2023,0,0,2,2,8,1,2,11,2,5,2,9,0,0,0,0,1,2,0,3
6731,173067,2023,Argentina,Bulgaria,0,0,0,0,23/06/2023,0,0,0,0,0,0,0,0,0,0,0,0,0,0,0,0,0,0,0,0
6732,173067,2023,Canada,Bulgaria,1,2,4,7,22/06/2023,0,0,0,0,4,0,2,6,1,2,0,3,0,0,0,0,0,0,0,0
6733,173067,2023,Brazil,Bulgaria,0,0,0,0,20/06/2023,0,0,0,0,0,0,0,0,0,0,0,0,0,0,0,0,0,0,0,0
6734,173067,2023,Japan,Bulgaria,0,2,5,7,10/06/2023,0,0,1,1,4,0,5,9,0,4,3,7,0,0,0,0,2,0,0,2
6735,173067,2023,Poland,Bulgaria,0,2,2,4,09/06/2023,0,0,0,0,1,1,2,4,0,3,3,6,0,0,0,0,0,0,0,0
6736,173067,2023,Slovenia,Bulgaria,3,1,9,13,08/06/2023,0,0,0,0,3,1,2,6,0,1,5,6,0,0,0,0,3,0,0,3
6737,173067,2023,Bulgaria,China,0,0,5,5,06/06/2023,0,0,0,0,0,1,0,1,1,0,0,1,0,0,0,0,0,0,0,0
6738,156676,2023,USA,Bulgaria,0,3,6,9,10/07/2023,0,0,1,1,7,0,5,12,2,0,4,6,4,1,12,17,3,1,1,5
6739,156676,2023,Bulgaria,Serbia,0,1,5,6,08/07/2023,0,0,2,2,4,1,4,9,0,4,0,4,1,1,8,10,2,2,0,4
6740,156676,2023,Bulgaria,Iran,2,6,14,22,07/07/2023,0,0,5,5,15,8,5,28,1,2,2,5,7,3,19,29,1,1,1,3
6741,156676,2023,Germany,Bulgaria,0,4,5,9,06/07/2023,0,0,1,1,11,1,5,17,1,1,0,2,5,0,13,18,6,2,0,8
6742,156676,2023,Bulgaria,Cuba,1,7,14,22,25/06/2023,0,0,6,6,8,1,7,16,3,7,3,13,10,1,20,31,4,4,0,8
6743,156676,2023,Argentina,Bulgaria,0,0,0,0,23/06/2023,0,0,0,0,0,0,0,0,0,0,0,0,0,0,1,1,0,1,0,1
6744,156676,2023,Canada,Bulgaria,1,7,6,14,22/06/2023,0,0,3,3,12,5,9,26,0,6,0,6,5,0,11,16,5,4,0,9
6745,156676,2023,Brazil,Bulgaria,0,2,4,6,20/06/2023,0,0,0,0,4,2,6,12,1,2,0,3,3,4,6,13,2,1,1,4
6746,156676,2023,Japan,Bulgaria,1,3,6,10,10/06/2023,0,0,1,1,4,3,2,9,2,0,1,3,4,2,11,17,4,0,1,5
6747,156676,2023,Poland,Bulgaria,1,5,6,12,09/06/2023,0,0,4,4,14,5,12,31,0,1,1,2,10,2,5,17,6,0,0,6
6748,156676,2023,Slovenia,Bulgaria,0,4,5,9,08/06/2023,0,0,3,3,11,2,10,23,2,2,2,6,7,1,8,16,4,0,0,4
6749,156676,2023,Bulgaria,China,2,4,7,13,06/06/2023,0,0,2,2,10,5,4,19,1,1,1,3,7,3,10,20,1,0,2,3
6750,132035,2023,USA,Bulgaria,0,1,9,10,10/07/2023,1,0,0,1,4,0,3,7,3,1,4,8,0,0,0,0,0,0,0,0
6751,132035,2023,Bulgaria,Serbia,0,0,0,0,08/07/2023,0,0,0,0,0,0,0,0,0,0,0,0,0,0,0,0,0,0,0,0
6752,132035,2023,Bulgaria,Iran,0,0,0,0,07/07/2023,0,0,0,0,0,0,0,0,0,0,0,0,0,0,0,0,0,0,0,0
6753,132035,2023,Germany,Bulgaria,0,0,0,0,06/07/2023,0,0,0,0,0,0,0,0,0,0,0,0,0,0,0,0,0,0,0,0
6754,132035,2023,Bulgaria,Cuba,0,0,0,0,25/06/2023,0,0,0,0,0,0,0,0,0,0,0,0,0,0,0,0,0,0,0,0
6755,132035,2023,Argentina,Bulgaria,0,0,4,4,23/06/2023,0,0,1,1,1,1,2,4,0,0,1,1,0,0,0,0,0,0,0,0
6756,132035,2023,Canada,Bulgaria,0,0,9,9,22/06/2023,0,0,3,3,4,2,4,10,3,3,3,9,0,0,0,0,1,0,0,1
6757,132035,2023,Brazil,Bulgaria,0,1,4,5,20/06/2023,0,0,0,0,2,0,1,3,1,4,1,6,0,0,0,0,0,0,0,0
6758,132035,2023,Japan,Bulgaria,0,0,0,0,10/06/2023,0,0,0,0,0,0,0,0,0,0,0,0,0,0,0,0,0,0,0,0
6759,132035,2023,Poland,Bulgaria,0,0,0,0,09/06/2023,0,0,0,0,0,0,0,0,0,0,0,0,0,0,0,0,0,0,0,0
6760,132035,2023,Slovenia,Bulgaria,0,0,0,0,08/06/2023,0,0,0,0,0,0,0,0,0,0,0,0,0,0,0,0,0,0,0,0
6761,132035,2023,Bulgaria,China,0,1,9,10,06/06/2023,0,0,0,0,4,1,2,7,2,5,1,8,0,0,0,0,3,0,0,3
6762,168269,2023,USA,Bulgaria,0,3,4,7,10/07/2023,0,0,0,0,3,1,8,12,0,0,0,0,0,0,0,0,1,1,0,2
6763,168269,2023,Bulgaria,Serbia,1,5,3,9,08/07/2023,0,0,2,2,8,4,9,21,3,1,3,7,0,0,0,0,3,1,0,4
6764,168269,2023,Bulgaria,Iran,0,2,9,11,07/07/2023,0,0,1,1,21,6,21,48,2,1,1,4,0,0,2,2,4,0,1,5
6765,168269,2023,Germany,Bulgaria,0,3,5,8,06/07/2023,0,0,1,1,9,3,7,19,0,1,1,2,0,0,1,1,1,0,0,1
6766,168269,2023,Bulgaria,Cuba,0,3,4,7,25/06/2023,0,0,1,1,7,2,4,13,0,6,3,9,0,0,0,0,1,1,0,2
6767,168269,2023,Argentina,Bulgaria,0,2,4,6,23/06/2023,0,0,3,3,2,2,5,9,0,2,0,2,1,2,11,14,5,4,0,9
6768,168269,2023,Canada,Bulgaria,0,1,2,3,22/06/2023,0,0,1,1,6,0,0,6,0,0,1,1,0,1,2,3,2,0,0,2
6769,168269,2023,Brazil,Bulgaria,0,1,0,1,20/06/2023,0,0,0,0,0,0,1,1,0,1,0,1,0,0,0,0,0,0,0,0
6770,168269,2023,Japan,Bulgaria,1,1,9,11,10/06/2023,0,0,0,0,7,2,8,17,1,1,5,7,0,0,0,0,1,1,0,2
6771,168269,2023,Poland,Bulgaria,0,3,3,6,09/06/2023,0,0,0,0,8,1,4,13,0,0,1,1,0,0,0,0,3,0,0,3
6772,168269,2023,Slovenia,Bulgaria,0,0,0,0,08/06/2023,0,0,0,0,0,0,0,0,0,0,0,0,0,0,0,0,0,0,0,0
6773,168269,2023,Bulgaria,China,0,1,0,1,06/06/2023,0,0,0,0,0,1,1,2,0,0,0,0,0,0,0,0,1,0,0,1
6774,137012,2023,USA,Bulgaria,0,0,9,9,10/07/2023,23,1,44,68,0,1,0,1,1,3,2,6,0,0,1,1,2,1,2,5
6775,137012,2023,Bulgaria,Serbia,1,1,6,8,08/07/2023,21,1,47,69,0,0,0,0,0,1,2,3,0,0,1,1,4,4,1,9
6776,137012,2023,Bulgaria,Iran,0,1,18,19,07/07/2023,24,1,77,102,0,1,1,2,1,3,2,6,0,0,2,2,7,2,0,9
6777,137012,2023,Germany,Bulgaria,0,0,7,7,06/07/2023,16,0,39,55,0,1,0,1,0,0,1,1,0,0,0,0,4,3,0,7
6778,137012,2023,Bulgaria,Cuba,0,0,9,9,25/06/2023,13,0,26,39,0,0,0,0,0,1,1,2,0,0,0,0,1,5,0,6
6779,137012,2023,Argentina,Bulgaria,0,0,7,7,23/06/2023,11,1,50,62,0,0,2,2,0,0,0,0,0,0,0,0,5,5,1,11
6780,137012,2023,Canada,Bulgaria,0,1,11,12,22/06/2023,24,0,58,82,1,1,1,3,1,2,1,4,0,0,0,0,5,0,1,6
6781,137012,2023,Brazil,Bulgaria,0,1,8,9,20/06/2023,16,0,48,64,0,0,2,2,0,3,2,5,0,1,0,1,2,1,0,3
6782,137012,2023,Japan,Bulgaria,0,0,10,10,10/06/2023,15,1,55,71,0,1,0,1,0,1,1,2,0,0,0,0,2,0,0,2
6783,137012,2023,Poland,Bulgaria,0,1,14,15,09/06/2023,25,1,80,106,1,0,1,2,2,2,0,4,0,0,0,0,2,0,0,2
6784,137012,2023,Slovenia,Bulgaria,0,1,10,11,08/06/2023,19,0,52,71,0,0,1,1,0,3,3,6,0,0,0,0,1,0,0,1
6785,137012,2023,Bulgaria,China,0,0,7,7,06/06/2023,8,0,20,28,0,0,0,0,0,0,1,1,0,0,0,0,1,0,0,1
6786,174445,2023,USA,Bulgaria,0,0,2,2,10/07/2023,0,0,1,1,3,0,1,4,0,0,4,4,0,0,0,0,2,1,0,3
6787,174445,2023,Bulgaria,Serbia,0,5,5,10,08/07/2023,0,0,1,1,10,2,13,25,0,2,1,3,5,2,21,28,2,2,1,5
6788,174445,2023,Bulgaria,Iran,0,0,0,0,07/07/2023,0,0,0,0,0,0,0,0,2,0,0,2,0,0,0,0,0,0,0,0
6789,174445,2023,Germany,Bulgaria,0,4,2,6,06/07/2023,0,0,1,1,8,1,5,14,1,0,0,1,1,2,18,21,1,1,0,2
6790,174445,2023,Bulgaria,Cuba,0,0,0,0,25/06/2023,0,0,0,0,0,0,0,0,0,0,0,0,0,0,0,0,0,0,0,0
6791,174445,2023,Argentina,Bulgaria,0,1,1,2,23/06/2023,0,0,0,0,1,0,4,5,1,1,0,2,0,0,1,1,0,0,0,0
6792,174445,2023,Canada,Bulgaria,0,0,0,0,22/06/2023,0,0,0,0,0,0,0,0,0,0,0,0,0,0,0,0,0,0,0,0
6793,174445,2023,Brazil,Bulgaria,0,5,2,7,20/06/2023,0,0,2,2,5,3,7,15,0,5,3,8,2,1,26,29,6,2,1,9
6794,174445,2023,Japan,Bulgaria,0,0,2,2,10/06/2023,0,0,0,0,3,0,1,4,0,1,0,1,3,0,2,5,1,0,1,2
6795,174445,2023,Poland,Bulgaria,1,2,10,13,09/06/2023,0,0,2,2,6,3,6,15,1,1,0,2,2,0,15,17,6,0,0,6
6796,174445,2023,Slovenia,Bulgaria,0,0,0,0,08/06/2023,0,0,0,0,0,0,0,0,0,0,0,0,0,0,0,0,0,0,0,0
6797,174445,2023,Bulgaria,China,0,0,0,0,06/06/2023,0,0,0,0,0,0,0,0,0,0,0,0,0,0,0,0,0,0,0,0
6798,152619,2023,USA,Bulgaria,0,0,0,0,10/07/2023,0,0,0,0,0,0,0,0,0,0,0,0,0,0,0,0,0,0,0,0
6799,152619,2023,Bulgaria,Serbia,0,0,13,13,08/07/2023,0,0,3,3,7,3,3,13,2,2,3,7,0,0,1,1,2,1,0,3
6800,152619,2023,Bulgaria,Iran,1,6,14,21,07/07/2023,0,0,5,5,4,3,4,11,1,3,3,7,0,0,2,2,1,0,0,1
6801,152619,2023,Germany,Bulgaria,1,0,13,14,06/07/2023,0,0,1,1,5,1,3,9,1,3,3,7,0,0,0,0,1,1,0,2
6802,152619,2023,Bulgaria,Cuba,1,2,11,14,25/06/2023,0,0,0,0,5,2,4,11,6,4,3,13,0,0,0,0,1,1,0,2
6803,152619,2023,Argentina,Bulgaria,0,1,10,11,23/06/2023,0,0,1,1,2,2,3,7,1,3,4,8,0,0,0,0,1,0,0,1
6804,152619,2023,Canada,Bulgaria,0,0,11,11,22/06/2023,0,0,0,0,7,0,1,8,5,7,8,20,0,0,1,1,2,1,0,3
6805,152619,2023,Brazil,Bulgaria,0,1,8,9,20/06/2023,0,0,3,3,3,2,3,8,0,0,1,1,0,0,0,0,0,0,0,0
6806,152619,2023,Japan,Bulgaria,0,1,10,11,10/06/2023,0,0,1,1,3,0,3,6,2,3,1,6,0,0,1,1,1,0,0,1
6807,152619,2023,Poland,Bulgaria,0,3,11,14,09/06/2023,0,0,2,2,7,0,2,9,1,3,4,8,0,0,0,0,4,0,0,4
6808,152619,2023,Slovenia,Bulgaria,0,1,12,13,08/06/2023,0,0,0,0,5,0,3,8,4,3,4,11,0,0,1,1,1,0,0,1
6809,152619,2023,Bulgaria,China,0,1,17,18,06/06/2023,0,0,1,1,5,1,1,7,0,4,4,8,0,0,0,0,2,0,0,2
6810,180587,2023,USA,Bulgaria,1,1,8,10,10/07/2023,0,0,0,0,5,7,9,21,0,0,2,2,0,0,0,0,2,3,0,5
6811,180587,2023,Bulgaria,Serbia,0,2,0,2,08/07/2023,0,0,0,0,2,1,0,3,1,0,0,1,0,0,0,0,0,2,0,2
6812,180587,2023,Bulgaria,Iran,1,1,1,3,07/07/2023,0,0,0,0,6,2,4,12,1,0,0,1,0,0,0,0,2,0,1,3
6813,180587,2023,Germany,Bulgaria,0,1,5,6,06/07/2023,0,0,0,0,4,3,2,9,0,1,1,2,0,0,0,0,3,0,0,3
6814,180587,2023,Bulgaria,Cuba,0,1,7,8,25/06/2023,0,0,1,1,5,3,9,17,1,0,4,5,1,0,0,1,2,1,0,3
6815,180587,2023,Argentina,Bulgaria,0,4,5,9,23/06/2023,0,0,1,1,13,2,14,29,0,0,2,2,0,0,0,0,3,1,0,4
6816,180587,2023,Canada,Bulgaria,0,5,8,13,22/06/2023,0,0,3,3,5,5,10,20,0,1,1,2,0,0,0,0,4,2,0,6
6817,180587,2023,Brazil,Bulgaria,0,0,0,0,20/06/2023,0,0,0,0,0,0,0,0,0,0,0,0,0,0,0,0,0,0,0,0
6818,180587,2023,Japan,Bulgaria,0,1,1,2,10/06/2023,0,0,0,0,1,2,4,7,1,1,1,3,0,0,0,0,3,0,0,3
6819,180587,2023,Poland,Bulgaria,1,6,6,13,09/06/2023,0,0,0,0,9,1,10,20,1,2,2,5,0,0,0,0,5,0,0,5
6820,180587,2023,Slovenia,Bulgaria,1,2,13,16,08/06/2023,0,0,0,0,7,4,8,19,1,0,0,1,0,0,0,0,8,0,0,8
6821,180587,2023,Bulgaria,China,1,4,11,16,06/06/2023,0,0,3,3,12,7,10,29,2,4,1,7,0,0,0,0,6,1,1,8
6822,113691,2023,USA,Bulgaria,0,0,0,0,10/07/2023,0,0,3,3,0,0,0,0,0,0,0,0,2,1,12,15,3,0,0,3
6823,113691,2023,Bulgaria,Serbia,0,0,0,0,08/07/2023,0,0,6,6,0,0,0,0,0,0,0,0,3,1,7,11,4,2,0,6
6824,113691,2023,Bulgaria,Iran,0,0,0,0,07/07/2023,0,0,6,6,0,0,0,0,0,0,0,0,5,1,15,21,2,0,1,3
6825,113691,2023,Germany,Bulgaria,0,0,0,0,06/07/2023,0,0,5,5,0,0,0,0,0,0,0,0,3,1,10,14,5,3,3,11
6826,113691,2023,Bulgaria,Cuba,0,0,0,0,25/06/2023,0,1,4,5,0,0,0,0,0,0,0,0,6,5,15,26,9,4,0,13
6827,113691,2023,Argentina,Bulgaria,0,0,0,0,23/06/2023,0,0,6,6,0,0,0,0,0,0,0,0,4,0,8,12,5,0,0,5
6828,113691,2023,Canada,Bulgaria,0,0,0,0,22/06/2023,0,0,7,7,0,0,0,0,0,0,0,0,6,1,29,36,7,2,1,10
6829,113691,2023,Brazil,Bulgaria,0,0,0,0,20/06/2023,0,1,8,9,0,0,0,0,0,0,0,0,1,0,8,9,5,4,2,11
6830,135372,2023,USA,Bulgaria,0,0,0,0,10/07/2023,0,0,2,2,0,0,0,0,0,0,0,0,0,0,0,0,5,3,1,9
6831,135372,2023,Bulgaria,Serbia,0,0,0,0,08/07/2023,0,0,1,1,0,0,0,0,0,0,0,0,0,0,0,0,1,1,0,2
6832,135372,2023,Bulgaria,Iran,0,0,0,0,07/07/2023,0,0,6,6,0,0,0,0,0,0,0,0,0,2,0,2,2,4,2,8
6833,135372,2023,Germany,Bulgaria,0,0,0,0,06/07/2023,0,0,0,0,0,0,0,0,0,0,0,0,0,0,0,0,0,0,0,0
6834,135372,2023,Japan,Bulgaria,0,0,0,0,10/06/2023,0,0,3,3,0,0,0,0,0,0,0,0,4,0,9,13,5,1,2,8
6835,135372,2023,Poland,Bulgaria,0,0,0,0,09/06/2023,0,0,4,4,0,0,0,0,0,0,0,0,3,2,22,27,8,0,1,9
6836,135372,2023,Slovenia,Bulgaria,0,0,0,0,08/06/2023,0,0,1,1,0,0,0,0,0,0,0,0,8,0,7,15,3,0,1,4
6837,135372,2023,Bulgaria,China,0,0,0,0,06/06/2023,0,0,3,3,0,0,0,0,0,0,0,0,9,1,14,24,9,1,1,11
6838,124986,2023,USA,Bulgaria,0,0,0,0,10/07/2023,0,0,0,0,0,0,0,0,0,0,0,0,0,0,0,0,0,0,0,0
6839,124986,2023,Bulgaria,Serbia,0,0,0,0,08/07/2023,0,0,0,0,0,0,0,0,0,0,0,0,0,0,0,0,0,0,0,0
6840,124986,2023,Bulgaria,Iran,0,0,0,0,07/07/2023,0,0,0,0,0,0,0,0,0,0,0,0,0,0,0,0,0,0,0,0
6841,124986,2023,Germany,Bulgaria,0,0,1,1,06/07/2023,6,0,10,16,0,0,0,0,0,0,0,0,0,0,0,0,0,1,0,1
6842,124986,2023,Bulgaria,Cuba,0,0,10,10,25/06/2023,21,0,26,47,0,0,0,0,0,2,1,3,0,0,0,0,3,2,0,5
6843,124986,2023,Argentina,Bulgaria,0,0,2,2,23/06/2023,6,0,6,12,0,0,0,0,0,1,0,1,0,0,0,0,1,1,0,2
6844,124986,2023,Canada,Bulgaria,0,0,0,0,22/06/2023,1,0,1,2,0,0,0,0,0,0,0,0,0,0,0,0,0,0,0,0
6845,124986,2023,Brazil,Bulgaria,0,0,0,0,20/06/2023,0,0,1,1,0,0,0,0,0,0,0,0,0,0,0,0,0,0,0,0
6846,132033,2023,USA,Bulgaria,0,0,1,1,10/07/2023,0,0,2,2,0,0,2,2,0,0,1,1,0,0,2,2,2,2,1,5
6847,132033,2023,Bulgaria,Serbia,0,0,1,1,08/07/2023,0,0,1,1,1,0,3,4,0,0,0,0,1,0,3,4,0,1,0,1
6848,132033,2023,Bulgaria,Iran,0,1,12,13,07/07/2023,0,0,3,3,7,3,10,20,1,3,2,6,7,0,18,25,7,1,3,11
6849,132033,2023,Germany,Bulgaria,0,1,0,1,06/07/2023,0,0,0,0,2,0,1,3,0,1,1,2,1,1,3,5,0,0,0,0
6850,132033,2023,Japan,Bulgaria,0,0,0,0,10/06/2023,0,0,0,0,0,0,0,0,0,0,0,0,0,0,3,3,0,0,0,0
6851,132033,2023,Poland,Bulgaria,0,0,3,3,09/06/2023,0,0,1,1,1,0,0,1,0,0,0,0,4,0,2,6,1,0,0,1
6852,132033,2023,Slovenia,Bulgaria,0,0,0,0,08/06/2023,0,0,0,0,0,0,0,0,0,0,0,0,1,0,2,3,1,0,0,1
6853,132033,2023,Bulgaria,China,0,1,3,4,06/06/2023,0,0,2,2,2,3,1,6,1,2,2,5,2,1,2,5,3,0,0,3
6854,118486,2023,USA,Bulgaria,0,2,9,11,10/07/2023,0,0,2,2,3,3,5,11,1,3,0,4,6,2,13,21,7,0,0,7
6855,118486,2023,Bulgaria,Serbia,1,0,5,6,08/07/2023,0,0,3,3,1,1,1,3,0,1,0,1,2,1,6,9,2,0,0,2
6856,118486,2023,Bulgaria,Iran,0,2,1,3,07/07/2023,0,0,0,0,0,0,0,0,0,0,0,0,1,0,0,1,0,0,0,0
6857,118486,2023,Germany,Bulgaria,0,0,2,2,06/07/2023,0,0,1,1,1,1,1,3,0,2,0,2,0,0,6,6,0,2,0,2
6858,168268,2023,USA,Bulgaria,0,5,0,5,10/07/2023,0,0,0,0,2,0,2,4,0,3,2,5,0,0,0,0,0,0,0,0
6859,168268,2023,Bulgaria,Serbia,0,2,1,3,08/07/2023,0,0,0,0,0,0,0,0,0,0,0,0,0,0,0,0,1,0,0,1
6860,168268,2023,Bulgaria,Iran,0,1,3,4,07/07/2023,0,0,0,0,0,0,0,0,0,0,0,0,0,0,0,0,0,1,0,1
6861,168268,2023,Germany,Bulgaria,0,1,2,3,06/07/2023,0,0,0,0,0,0,0,0,0,0,0,0,0,0,0,0,0,0,0,0
6862,168268,2023,Bulgaria,Cuba,0,2,0,2,25/06/2023,0,0,0,0,0,0,0,0,0,0,0,0,0,0,0,0,0,0,0,0
6863,168268,2023,Argentina,Bulgaria,1,2,5,8,23/06/2023,0,0,0,0,5,0,3,8,1,2,4,7,0,0,0,0,2,0,0,2
6864,168268,2023,Canada,Bulgaria,0,1,4,5,22/06/2023,0,0,0,0,0,0,0,0,0,0,0,0,0,0,0,0,0,0,0,0
6865,168268,2023,Brazil,Bulgaria,0,0,5,5,20/06/2023,0,0,0,0,2,0,0,2,0,0,0,0,0,0,0,0,0,1,0,1
6866,168268,2023,Japan,Bulgaria,2,2,0,4,10/06/2023,0,0,0,0,0,0,0,0,0,0,0,0,0,0,0,0,0,0,0,0
6867,168268,2023,Poland,Bulgaria,0,4,7,11,09/06/2023,0,0,1,1,3,1,4,8,1,2,4,7,0,0,1,1,3,0,0,3
6868,168268,2023,Slovenia,Bulgaria,0,1,0,1,08/06/2023,0,0,0,0,0,0,0,0,0,0,0,0,0,0,0,0,0,0,0,0
6869,168268,2023,Bulgaria,China,0,0,1,1,06/06/2023,0,0,0,0,0,0,0,0,0,0,0,0,0,0,0,0,1,0,0,1
6870,157324,2023,China,Canada,0,0,0,0,09/07/2023,0,0,0,0,0,0,0,0,0,0,0,0,0,0,0,0,0,0,0,0
6871,157324,2023,Poland,Canada,0,1,7,8,08/07/2023,0,0,0,0,1,1,2,4,0,2,3,5,2,0,1,3,0,1,0,1
6872,157324,2023,Canada,Italy,0,0,0,0,06/07/2023,0,0,0,0,0,0,0,0,0,0,0,0,0,0,0,0,0,0,0,0
6873,157324,2023,Canada,Netherlands,0,2,9,11,05/07/2023,0,0,0,0,7,0,4,11,1,7,6,14,0,0,3,3,3,1,1,5
6874,157324,2023,Canada,France,0,1,5,6,24/06/2023,0,0,0,0,3,0,1,4,0,3,3,6,0,0,2,2,2,0,0,2
6875,157324,2023,Canada,Bulgaria,1,2,13,16,22/06/2023,0,0,1,1,6,1,3,10,0,2,4,6,0,0,1,1,1,0,0,1
6876,157324,2023,Slovenia,Canada,0,0,12,12,21/06/2023,0,0,1,1,4,0,1,5,0,1,5,6,0,0,4,4,3,0,2,5
6877,157324,2023,Japan,Canada,1,1,4,6,20/06/2023,0,0,1,1,0,1,2,3,0,3,1,4,1,0,2,3,1,0,0,1
6878,157324,2023,Canada,Germany,0,1,5,6,11/06/2023,0,0,0,0,3,0,0,3,2,4,2,8,0,1,0,1,2,0,0,2
6879,157324,2023,Canada,USA,0,1,12,13,11/06/2023,0,0,0,0,6,0,2,8,0,6,2,8,0,0,0,0,2,1,1,4
6880,157324,2023,Canada,Argentina,0,0,0,0,10/06/2023,0,0,0,0,0,0,0,0,0,0,0,0,0,0,0,0,0,0,0,0
6881,157324,2023,Canada,Cuba,0,0,8,8,07/06/2023,0,0,1,1,1,0,1,2,3,2,3,8,0,0,0,0,1,2,1,4
6882,165212,2023,China,Canada,0,0,12,12,09/07/2023,18,1,59,78,0,0,0,0,1,3,3,7,0,0,0,0,5,2,0,7
6883,165212,2023,Poland,Canada,0,0,0,0,08/07/2023,0,0,0,0,0,0,0,0,0,0,0,0,0,0,0,0,0,0,0,0
6884,165212,2023,Canada,Italy,1,3,10,14,06/07/2023,23,1,79,103,0,0,0,0,1,0,4,5,0,0,0,0,6,2,0,8
6885,165212,2023,Canada,Netherlands,1,1,11,13,05/07/2023,24,0,48,72,0,0,0,0,2,2,3,7,0,0,0,0,6,5,0,11
6886,165212,2023,Canada,France,0,0,8,8,24/06/2023,16,1,40,57,0,0,0,0,0,2,0,2,0,0,0,0,4,2,0,6
6887,165212,2023,Canada,Bulgaria,0,0,14,14,22/06/2023,23,1,60,84,0,0,0,0,2,1,1,4,0,0,0,0,5,1,0,6
6888,165212,2023,Slovenia,Canada,0,1,4,5,21/06/2023,11,0,34,45,0,0,0,0,0,2,2,4,0,0,0,0,1,0,0,1
6889,165212,2023,Japan,Canada,1,0,5,6,20/06/2023,8,0,38,46,0,0,0,0,1,1,1,3,0,0,0,0,0,1,0,1
6890,165212,2023,Canada,Germany,0,2,3,5,11/06/2023,16,0,50,66,0,0,0,0,1,1,1,3,0,0,1,1,1,2,1,4
6891,165212,2023,Canada,USA,0,1,6,7,11/06/2023,13,1,40,54,0,1,0,1,0,0,1,1,0,0,0,0,5,1,0,6
6892,165212,2023,Canada,Argentina,0,1,9,10,10/06/2023,16,0,82,98,1,0,1,2,0,0,5,5,0,0,0,0,7,4,0,11
6893,165212,2023,Canada,Cuba,0,1,19,20,07/06/2023,24,1,74,99,1,0,0,1,0,1,2,3,0,0,0,0,8,7,0,15
6894,136291,2023,China,Canada,3,2,18,23,09/07/2023,0,0,3,3,9,2,7,18,0,3,2,5,1,3,20,24,2,0,0,2
6895,136291,2023,Poland,Canada,0,0,4,4,08/07/2023,0,0,0,0,0,0,0,0,0,0,0,0,0,0,0,0,1,0,0,1
6896,136291,2023,Canada,Italy,2,3,16,21,06/07/2023,0,0,4,4,12,3,12,27,0,1,3,4,6,2,20,28,6,3,0,9
6897,136291,2023,Canada,Netherlands,1,1,17,19,05/07/2023,0,0,4,4,9,2,12,23,1,5,3,9,1,0,16,17,3,1,1,5
6898,136291,2023,Canada,France,1,1,9,11,24/06/2023,0,0,4,4,7,2,5,14,0,1,2,3,2,2,12,16,2,2,1,5
6899,136291,2023,Canada,Bulgaria,1,3,13,17,22/06/2023,0,0,3,3,8,4,10,22,1,1,0,2,1,0,11,12,7,3,1,11
6900,136291,2023,Slovenia,Canada,0,0,1,1,21/06/2023,0,0,0,0,0,0,0,0,0,0,0,0,0,0,0,0,0,0,0,0
6901,136291,2023,Japan,Canada,1,2,12,15,20/06/2023,0,0,3,3,7,3,8,18,1,5,1,7,8,2,25,35,7,4,2,13
6902,136291,2023,Canada,Germany,1,6,16,23,11/06/2023,0,0,4,4,8,4,7,19,0,2,1,3,7,0,19,26,7,1,4,12
6903,136291,2023,Canada,USA,0,1,4,5,11/06/2023,0,0,2,2,2,3,3,8,0,0,2,2,3,2,10,15,0,3,1,4
6904,136291,2023,Canada,Argentina,0,3,10,13,10/06/2023,0,0,5,5,10,6,10,26,0,3,4,7,10,1,20,31,9,1,0,10
6905,136291,2023,Canada,Cuba,0,2,15,17,07/06/2023,0,0,15,15,12,2,10,24,1,1,0,2,3,3,13,19,5,5,1,11
6906,168914,2023,China,Canada,0,0,0,0,09/07/2023,0,0,0,0,0,0,0,0,0,0,0,0,0,0,0,0,0,0,0,0
6907,168914,2023,Poland,Canada,1,1,10,12,08/07/2023,0,1,8,9,8,4,8,20,0,3,0,3,4,0,7,11,4,4,0,8
6908,168914,2023,Canada,Italy,0,0,2,2,06/07/2023,0,0,0,0,0,0,0,0,0,0,0,0,0,0,0,0,0,0,0,0
6909,168914,2023,Canada,Netherlands,0,0,0,0,05/07/2023,0,0,0,0,0,0,0,0,0,0,0,0,0,0,0,0,0,0,0,0
6910,168914,2023,Canada,France,0,0,3,3,24/06/2023,0,0,0,0,0,0,0,0,0,0,0,0,0,0,0,0,0,0,0,0
6911,168914,2023,Canada,Bulgaria,0,0,0,0,22/06/2023,0,0,0,0,0,0,0,0,0,0,0,0,0,0,0,0,0,0,0,0
6912,168914,2023,Slovenia,Canada,0,2,5,7,21/06/2023,0,0,1,1,9,4,15,28,0,1,1,2,3,2,12,17,3,1,0,4
6913,168914,2023,Japan,Canada,0,0,2,2,20/06/2023,0,0,0,0,0,0,0,0,0,0,0,0,0,0,0,0,0,0,0,0
6914,168914,2023,Canada,Germany,0,0,2,2,11/06/2023,0,0,0,0,0,0,0,0,0,0,0,0,0,0,0,0,0,0,0,0
6915,168914,2023,Canada,USA,0,0,2,2,11/06/2023,0,0,1,1,1,0,1,2,0,1,1,2,2,1,4,7,2,0,0,2
6916,168914,2023,Canada,Argentina,0,0,3,3,10/06/2023,0,0,0,0,0,0,0,0,0,0,0,0,0,0,0,0,0,2,0,2
6917,168914,2023,Canada,Cuba,0,1,2,3,07/06/2023,0,0,0,0,0,0,0,0,0,0,0,0,0,0,0,0,1,0,0,1
6918,140042,2023,China,Canada,2,3,12,17,09/07/2023,0,0,0,0,8,0,1,9,4,3,4,11,0,0,0,0,0,2,0,2
6919,140042,2023,Poland,Canada,0,0,0,0,08/07/2023,0,0,0,0,0,0,0,0,0,0,0,0,0,0,0,0,0,0,0,0
6920,140042,2023,Canada,Italy,1,4,13,18,06/07/2023,0,0,1,1,6,2,3,11,0,6,4,10,0,1,1,2,1,2,2,5
6921,140042,2023,Canada,Netherlands,1,2,13,16,05/07/2023,0,0,2,2,6,4,1,11,0,8,5,13,0,0,2,2,1,0,1,2
6922,140042,2023,Canada,France,0,3,6,9,24/06/2023,0,0,0,0,4,0,2,6,0,6,5,11,0,0,0,0,0,2,0,2
6923,140042,2023,Canada,Bulgaria,3,2,7,12,22/06/2023,0,0,2,2,10,1,3,14,2,5,10,17,0,0,2,2,4,1,0,5
6924,140042,2023,Slovenia,Canada,0,0,0,0,21/06/2023,0,0,0,0,0,0,0,0,0,0,0,0,0,0,0,0,0,0,0,0
6925,140042,2023,Japan,Canada,0,4,9,13,20/06/2023,0,0,1,1,6,0,2,8,1,5,4,10,2,0,3,5,5,0,0,5
6926,140042,2023,Canada,Germany,0,1,6,7,11/06/2023,0,0,0,0,1,1,1,3,2,0,0,2,1,0,0,1,0,1,0,1
6927,140042,2023,Canada,USA,0,1,7,8,11/06/2023,0,0,1,1,2,1,1,4,2,3,5,10,0,0,1,1,2,3,1,6
6928,140042,2023,Canada,Argentina,0,3,11,14,10/06/2023,0,0,3,3,8,1,5,14,1,1,3,5,0,0,0,0,4,2,0,6
6929,140042,2023,Canada,Cuba,0,7,16,23,07/06/2023,0,0,1,1,6,1,5,12,4,4,2,10,1,0,3,4,3,2,0,5
6930,140061,2023,China,Canada,0,4,10,14,09/07/2023,0,0,4,4,14,3,5,22,4,3,4,11,7,2,28,37,9,3,1,13
6931,140061,2023,Poland,Canada,0,0,0,0,08/07/2023,0,0,0,0,0,0,0,0,0,0,0,0,0,0,0,0,0,0,0,0
6932,140061,2023,Canada,Italy,1,1,9,11,06/07/2023,0,0,7,7,15,6,22,43,2,2,5,9,2,4,22,28,7,3,0,10
6933,140061,2023,Canada,Netherlands,0,2,0,2,05/07/2023,0,0,0,0,1,0,1,2,0,2,1,3,2,0,5,7,0,0,0,0
6934,140061,2023,Canada,France,1,2,8,11,24/06/2023,0,0,3,3,13,3,12,28,0,6,3,9,6,0,14,20,5,2,1,8
6935,140061,2023,Canada,Bulgaria,1,3,10,14,22/06/2023,1,0,5,6,14,4,10,28,1,1,2,4,10,2,24,36,6,3,3,12
6936,140061,2023,Slovenia,Canada,0,0,0,0,21/06/2023,0,0,0,0,0,0,0,0,0,0,0,0,0,0,0,0,0,0,0,0
6937,140061,2023,Japan,Canada,1,3,8,12,20/06/2023,0,0,3,3,16,4,15,35,0,4,2,6,3,2,12,17,4,5,2,11
6938,140061,2023,Canada,Germany,0,0,13,13,11/06/2023,0,0,4,4,10,3,13,26,2,2,2,6,5,2,12,19,6,2,0,8
6939,140061,2023,Canada,USA,1,3,5,9,11/06/2023,1,1,2,4,8,5,8,21,3,5,0,8,4,0,9,13,4,6,0,10
6940,140061,2023,Canada,Argentina,1,3,10,14,10/06/2023,0,0,7,7,12,8,12,32,1,3,2,6,9,1,14,24,6,0,3,9
6941,140061,2023,Canada,Cuba,2,4,11,17,07/06/2023,0,0,5,5,14,5,26,45,2,7,2,11,9,0,23,32,9,6,3,18
6942,143745,2023,China,Canada,0,0,0,0,09/07/2023,0,0,0,0,0,0,0,0,0,0,0,0,0,0,0,0,0,0,0,0
6943,143745,2023,Poland,Canada,2,3,7,12,08/07/2023,16,0,53,69,0,0,0,0,0,3,1,4,0,0,0,0,3,3,2,8
6944,143745,2023,Canada,Italy,0,0,0,0,06/07/2023,0,0,6,6,0,0,0,0,0,0,0,0,0,0,0,0,0,0,0,0
6945,143745,2023,Canada,Netherlands,0,0,1,1,05/07/2023,1,0,5,6,0,0,0,0,0,0,0,0,0,0,0,0,1,0,0,1
6946,143745,2023,Canada,France,0,0,0,0,24/06/2023,1,0,6,7,0,0,0,0,0,0,1,1,0,0,0,0,0,0,0,0
6947,143745,2023,Canada,Bulgaria,0,0,1,1,22/06/2023,0,0,2,2,0,0,0,0,0,0,0,0,0,0,0,0,0,0,0,0
6948,143745,2023,Slovenia,Canada,0,1,2,3,21/06/2023,10,0,24,34,0,0,0,0,0,0,2,2,0,0,0,0,2,3,0,5
6949,143745,2023,Japan,Canada,0,1,5,6,20/06/2023,21,0,30,51,0,0,0,0,1,2,3,6,0,0,0,0,1,2,1,4
6950,140428,2023,China,Canada,0,2,11,13,09/07/2023,0,0,2,2,20,3,13,36,0,4,2,6,0,0,2,2,5,0,1,6
6951,140428,2023,Poland,Canada,0,0,0,0,08/07/2023,0,0,0,0,0,0,0,0,0,0,0,0,0,0,0,0,0,0,0,0
6952,140428,2023,Canada,Italy,1,3,10,14,06/07/2023,0,0,5,5,16,7,15,38,5,4,3,12,0,1,5,6,10,3,1,14
6953,140428,2023,Canada,Netherlands,2,3,11,16,05/07/2023,0,0,4,4,18,2,13,33,0,2,2,4,0,0,0,0,5,2,0,7
6954,140428,2023,Canada,France,0,0,0,0,24/06/2023,0,0,0,0,0,0,0,0,0,0,0,0,0,0,0,0,0,0,0,0
6955,140428,2023,Canada,Bulgaria,1,2,1,4,22/06/2023,0,0,0,0,2,4,3,9,0,0,2,2,0,0,0,0,2,1,0,3
6956,140428,2023,Slovenia,Canada,0,0,3,3,21/06/2023,0,0,1,1,3,0,4,7,1,2,0,3,0,0,0,0,5,3,1,9
6957,140428,2023,Japan,Canada,0,0,4,4,20/06/2023,0,0,2,2,3,3,4,10,0,1,0,1,0,0,0,0,2,0,1,3
6958,140428,2023,Canada,Germany,0,1,10,11,11/06/2023,0,0,0,0,15,4,12,31,1,1,0,2,0,0,1,1,3,1,1,5
6959,140428,2023,Canada,USA,0,0,0,0,11/06/2023,0,0,0,0,1,0,0,1,0,0,1,1,0,0,0,0,0,0,0,0
6960,140428,2023,Canada,Argentina,2,1,11,14,10/06/2023,0,0,0,0,14,9,9,32,0,0,2,2,0,0,0,0,6,3,1,10
6961,140428,2023,Canada,Cuba,1,2,15,18,07/06/2023,0,0,1,1,22,3,20,45,4,4,4,12,0,0,2,2,13,7,1,21
6962,136296,2023,China,Canada,0,1,15,16,09/07/2023,0,0,1,1,4,0,2,6,0,2,8,10,0,0,0,0,0,1,1,2
6963,136296,2023,Poland,Canada,0,1,5,6,08/07/2023,0,0,3,3,3,0,3,6,0,5,6,11,0,0,0,0,1,2,0,3
6964,136296,2023,Canada,Italy,0,0,9,9,06/07/2023,0,0,6,6,6,0,4,10,1,5,6,12,0,0,1,1,1,2,0,3
6965,136296,2023,Canada,Netherlands,0,0,1,1,05/07/2023,0,0,0,0,0,0,0,0,1,0,0,1,0,0,0,0,0,0,0,0
6966,136296,2023,Canada,France,0,0,0,0,24/06/2023,0,0,0,0,0,0,0,0,0,0,0,0,0,0,0,0,0,0,0,0
6967,136296,2023,Canada,Bulgaria,0,0,0,0,22/06/2023,0,0,0,0,0,0,0,0,0,0,0,0,0,0,0,0,0,0,0,0
6968,136296,2023,Slovenia,Canada,0,0,11,11,21/06/2023,0,0,1,1,4,0,2,6,1,6,3,10,0,0,1,1,4,0,0,4
6969,136296,2023,Japan,Canada,0,0,5,5,20/06/2023,0,1,1,2,2,1,2,5,2,2,1,5,1,0,2,3,2,0,1,3
6970,136296,2023,Canada,Germany,0,0,11,11,11/06/2023,0,0,0,0,7,2,2,11,0,8,2,10,0,0,1,1,1,0,0,1
6971,136296,2023,Canada,USA,0,0,0,0,11/06/2023,0,0,0,0,0,0,0,0,0,0,0,0,0,0,0,0,0,0,0,0
6972,136296,2023,Canada,Argentina,0,0,11,11,10/06/2023,0,1,1,2,4,0,4,8,1,7,5,13,0,0,1,1,3,0,0,3
6973,136296,2023,Canada,Cuba,0,0,6,6,07/06/2023,0,0,3,3,0,0,4,4,3,4,7,14,0,0,1,1,2,2,0,4
6974,182679,2023,China,Canada,0,0,0,0,09/07/2023,0,0,0,0,0,0,0,0,0,0,0,0,0,0,0,0,0,0,0,0
6975,182679,2023,Poland,Canada,3,3,6,12,08/07/2023,0,0,3,3,15,4,12,31,1,1,0,2,4,1,24,29,3,4,0,7
6976,182679,2023,Canada,Italy,0,0,0,0,06/07/2023,0,0,0,0,0,0,0,0,0,0,0,0,0,0,0,0,0,0,0,0
6977,182679,2023,Canada,Netherlands,0,0,0,0,05/07/2023,0,0,1,1,1,0,1,2,0,0,0,0,0,0,3,3,0,0,0,0
6978,182679,2023,Canada,France,0,0,0,0,24/06/2023,0,0,0,0,0,0,0,0,0,0,0,0,0,0,0,0,0,0,0,0
6979,182679,2023,Canada,Bulgaria,0,0,0,0,22/06/2023,0,0,0,0,0,0,0,0,0,0,0,0,0,0,0,0,0,0,0,0
6980,182679,2023,Slovenia,Canada,1,2,1,4,21/06/2023,0,0,3,3,5,5,5,15,1,0,1,2,2,0,7,9,2,1,1,4
6981,182679,2023,Japan,Canada,0,0,0,0,20/06/2023,0,0,0,0,0,0,1,1,0,0,0,0,0,0,0,0,0,0,0,0
6982,151871,2023,China,Canada,0,0,0,0,09/07/2023,0,0,0,0,0,0,0,0,0,0,0,0,0,0,0,0,0,0,0,0
6983,151871,2023,Poland,Canada,0,5,8,13,08/07/2023,0,0,3,3,14,7,6,27,2,1,1,4,1,0,0,1,3,3,2,8
6984,151871,2023,Canada,Italy,0,0,1,1,06/07/2023,0,0,0,0,0,2,0,2,0,0,1,1,0,0,0,0,0,1,0,1
6985,151871,2023,Canada,Netherlands,0,0,0,0,05/07/2023,0,0,0,0,0,0,0,0,0,0,0,0,0,0,0,0,0,0,0,0
6986,151871,2023,Canada,France,2,2,9,13,24/06/2023,0,0,1,1,11,4,8,23,0,2,1,3,0,0,0,0,3,6,0,9
6987,151871,2023,Canada,Bulgaria,2,4,7,13,22/06/2023,0,0,1,1,12,4,3,19,1,3,1,5,0,0,0,0,3,1,0,4
6988,151871,2023,Slovenia,Canada,1,0,7,8,21/06/2023,0,0,1,1,10,2,5,17,0,3,0,3,0,0,0,0,1,1,1,3
6989,151871,2023,Japan,Canada,4,0,7,11,20/06/2023,0,0,0,0,12,5,8,25,1,2,0,3,0,0,1,1,3,1,0,4
6990,151871,2023,Canada,Germany,0,1,3,4,11/06/2023,0,0,0,0,3,2,6,11,1,1,0,2,0,0,0,0,0,2,1,3
6991,151871,2023,Canada,USA,0,0,12,12,11/06/2023,0,0,2,2,12,4,5,21,1,1,1,3,0,0,0,0,6,4,0,10
6992,151871,2023,Canada,Argentina,0,0,4,4,10/06/2023,0,0,1,1,4,2,4,10,1,0,4,5,0,0,0,0,3,2,1,6
6993,151871,2023,Canada,Cuba,0,0,1,1,07/06/2023,0,0,0,0,2,1,1,4,0,0,0,0,0,0,0,0,0,0,0,0
6994,168925,2023,China,Canada,0,0,0,0,09/07/2023,0,0,2,2,0,0,0,0,0,0,0,0,0,1,6,7,4,7,0,11
6995,168925,2023,Poland,Canada,0,0,0,0,08/07/2023,0,0,2,2,0,0,0,0,0,0,0,0,3,2,13,18,7,1,1,9
6996,168925,2023,Canada,Italy,0,0,0,0,06/07/2023,0,0,2,2,0,0,0,0,0,0,0,0,5,0,13,18,13,6,0,19
6997,168925,2023,Canada,Netherlands,0,0,0,0,05/07/2023,0,0,0,0,0,0,0,0,0,0,0,0,0,0,0,0,0,0,0,0
6998,168925,2023,Canada,France,0,0,0,0,24/06/2023,0,0,0,0,0,0,0,0,0,0,0,0,2,0,5,7,3,0,0,3
6999,168925,2023,Canada,Bulgaria,0,0,0,0,22/06/2023,0,0,0,0,0,0,0,0,0,0,0,0,0,0,0,0,0,0,0,0
7000,168925,2023,Slovenia,Canada,0,0,0,0,21/06/2023,0,0,1,1,0,0,0,0,0,0,0,0,0,1,4,5,2,0,0,2
7001,168925,2023,Japan,Canada,0,0,0,0,20/06/2023,0,0,0,0,0,0,0,0,0,0,0,0,0,0,1,1,0,0,0,0
7002,168925,2023,Canada,Germany,0,0,0,0,11/06/2023,0,0,0,0,0,0,0,0,0,0,0,0,0,0,0,0,0,0,0,0
7003,168925,2023,Canada,USA,0,0,0,0,11/06/2023,0,0,0,0,0,0,0,0,0,0,0,0,0,0,0,0,0,0,0,0
7004,168925,2023,Canada,Argentina,0,0,0,0,10/06/2023,0,0,0,0,0,0,0,0,0,0,0,0,0,0,0,0,0,0,0,0
7005,168925,2023,Canada,Cuba,0,0,0,0,07/06/2023,0,0,0,0,0,0,0,0,0,0,0,0,0,0,0,0,0,0,0,0
7006,168923,2023,China,Canada,0,0,0,0,09/07/2023,0,0,0,0,0,0,0,0,0,0,0,0,0,0,0,0,0,0,0,0
7007,168923,2023,Poland,Canada,0,0,0,0,08/07/2023,0,0,0,0,0,0,0,0,0,0,0,0,0,0,0,0,0,0,0,0
7008,168923,2023,Canada,Italy,0,0,0,0,06/07/2023,0,0,0,0,0,0,0,0,0,0,0,0,0,0,0,0,0,0,0,0
7009,168923,2023,Canada,Netherlands,0,0,0,0,05/07/2023,0,0,3,3,0,0,0,0,0,0,0,0,2,5,21,28,5,4,1,10
7010,168923,2023,Canada,France,0,0,0,0,24/06/2023,0,0,2,2,0,0,0,0,0,0,0,0,0,2,13,15,4,3,0,7
7011,168923,2023,Canada,Bulgaria,0,0,0,0,22/06/2023,0,0,4,4,0,0,0,0,0,0,0,0,2,2,16,20,7,4,1,12
7012,168923,2023,Slovenia,Canada,0,0,0,0,21/06/2023,0,0,1,1,0,0,0,0,0,0,0,0,2,1,4,7,6,4,1,11
7013,168923,2023,Japan,Canada,0,0,0,0,20/06/2023,0,0,1,1,0,0,0,0,0,0,0,0,2,2,15,19,5,12,0,17
7014,168923,2023,Canada,Germany,0,0,0,0,11/06/2023,0,0,0,0,0,0,0,0,0,0,0,0,4,1,19,24,14,6,3,23
7015,168923,2023,Canada,USA,0,0,0,0,11/06/2023,0,0,3,3,0,0,0,0,0,0,0,0,2,1,7,10,5,8,0,13
7016,168923,2023,Canada,Argentina,0,0,0,0,10/06/2023,0,0,2,2,0,0,0,0,0,0,0,0,5,1,14,20,14,4,1,19
7017,168923,2023,Canada,Cuba,0,0,0,0,07/06/2023,0,0,6,6,0,0,0,0,0,0,0,0,3,0,24,27,12,16,1,29
7018,168908,2023,China,Canada,0,0,2,2,09/07/2023,0,0,1,1,0,0,0,0,0,0,0,0,0,0,0,0,1,0,0,1
7019,168908,2023,Poland,Canada,0,0,4,4,08/07/2023,0,0,0,0,0,0,0,0,0,0,0,0,0,0,0,0,0,1,0,1
7020,168908,2023,Canada,Italy,0,2,1,3,06/07/2023,0,0,0,0,1,0,3,4,0,0,0,0,2,0,7,9,1,0,0,1
7021,168908,2023,Canada,Netherlands,0,0,9,9,05/07/2023,0,0,1,1,5,4,5,14,1,2,2,5,3,1,7,11,3,0,0,3
7022,168908,2023,Canada,France,0,0,0,0,24/06/2023,0,0,0,0,0,0,0,0,0,0,0,0,0,0,0,0,0,0,0,0
7023,168908,2023,Canada,Bulgaria,0,0,5,5,22/06/2023,0,0,0,0,0,0,0,0,0,0,0,0,0,0,0,0,0,1,0,1
7024,168908,2023,Slovenia,Canada,0,1,5,6,21/06/2023,0,0,1,1,6,2,4,12,1,1,1,3,6,3,12,21,5,1,0,6
7025,168908,2023,Japan,Canada,0,1,0,1,20/06/2023,0,0,0,0,2,0,3,5,0,0,0,0,0,2,2,4,1,1,0,2
7026,168908,2023,Canada,Germany,0,0,0,0,11/06/2023,0,0,0,0,0,0,0,0,0,0,0,0,1,0,4,5,0,0,0,0
7027,168908,2023,Canada,USA,0,0,5,5,11/06/2023,0,0,0,0,3,0,6,9,0,1,2,3,4,1,10,15,0,2,1,3
7028,168908,2023,Canada,Argentina,0,0,1,1,10/06/2023,0,0,1,1,0,0,1,1,0,1,0,1,2,0,2,4,0,0,0,0
7029,168908,2023,Canada,Cuba,0,0,0,0,07/06/2023,0,0,0,0,0,0,0,0,0,0,0,0,0,0,0,0,0,0,0,0
7030,173184,2023,China,Canada,0,0,0,0,09/07/2023,0,0,0,0,0,0,0,0,0,0,0,0,0,0,0,0,0,0,0,0
7031,173184,2023,Brazil,China,0,1,6,7,08/07/2023,0,0,1,1,4,1,2,7,2,3,0,5,0,0,1,1,2,0,2,4
7032,173184,2023,China,Slovenia,2,3,6,11,06/07/2023,0,0,1,1,3,0,2,5,2,3,2,7,0,1,2,3,1,0,0,1
7033,173184,2023,Japan,China,0,0,0,0,04/07/2023,0,0,0,0,0,0,0,0,0,0,0,0,0,0,0,0,0,0,0,0
7034,173184,2023,China,Germany,0,1,11,12,24/06/2023,0,0,0,0,3,1,5,9,0,0,2,2,0,0,0,0,1,1,0,2
7035,173184,2023,China,Italy,0,1,9,10,22/06/2023,0,0,1,1,3,1,3,7,1,5,3,9,1,0,0,1,0,2,0,2
7036,173184,2023,USA,China,0,1,11,12,21/06/2023,0,0,0,0,3,2,2,7,0,1,2,3,0,0,0,0,0,1,0,1
7037,173184,2023,Netherlands,China,0,0,0,0,20/06/2023,0,0,0,0,0,0,0,0,0,0,0,0,0,0,0,0,0,0,0,0
7038,173184,2023,Iran,China,0,0,0,0,10/06/2023,0,0,0,0,0,0,0,0,0,0,0,0,0,0,0,0,0,0,0,0
7039,173184,2023,China,France,0,0,0,0,09/06/2023,0,0,0,0,0,0,0,0,0,0,0,0,0,0,0,0,0,0,0,0
7040,173184,2023,Serbia,China,0,0,10,10,08/06/2023,0,1,2,3,4,0,4,8,1,4,2,7,0,0,1,1,1,0,1,2
7041,173184,2023,Bulgaria,China,1,0,6,7,06/06/2023,0,0,0,0,1,1,1,3,2,0,1,3,0,0,1,1,0,0,0,0
7042,142855,2023,China,Canada,2,1,6,9,09/07/2023,0,0,0,0,7,8,4,19,0,3,0,3,0,0,0,0,5,0,2,7
7043,142855,2023,Brazil,China,0,1,1,2,08/07/2023,0,0,1,1,2,3,2,7,0,0,0,0,0,0,0,0,0,0,0,0
7044,142855,2023,China,Slovenia,1,3,3,7,06/07/2023,0,0,0,0,7,2,5,14,1,1,4,6,0,0,0,0,3,2,1,6
7045,142855,2023,Japan,China,0,2,2,4,04/07/2023,0,1,2,3,2,3,7,12,2,0,1,3,0,0,0,0,2,0,0,2
7046,142855,2023,China,Germany,0,3,7,10,24/06/2023,0,0,0,0,16,3,5,24,2,1,2,5,0,0,0,0,2,6,0,8
7047,142855,2023,China,Italy,0,3,4,7,22/06/2023,0,0,1,1,9,5,9,23,0,1,3,4,0,0,1,1,3,3,0,6
7048,142855,2023,USA,China,0,0,0,0,21/06/2023,0,0,0,0,0,0,0,0,0,0,0,0,0,0,0,0,0,0,0,0
7049,142855,2023,Netherlands,China,0,1,7,8,20/06/2023,0,0,0,0,6,5,7,18,0,1,4,5,0,0,0,0,4,0,1,5
7050,142855,2023,Iran,China,1,2,3,6,10/06/2023,0,0,0,0,8,1,6,15,0,1,0,1,0,0,0,0,3,0,0,3
7051,142855,2023,China,France,0,3,11,14,09/06/2023,0,0,1,1,14,5,7,26,1,2,3,6,0,0,0,0,2,1,0,3
7052,142855,2023,Serbia,China,0,2,12,14,08/06/2023,0,0,0,0,13,8,9,30,0,0,2,2,0,0,0,0,3,0,2,5
7053,142855,2023,Bulgaria,China,0,5,9,14,06/06/2023,0,1,0,1,10,7,6,23,0,5,3,8,0,0,0,0,6,0,1,7
7054,174297,2023,China,Canada,1,0,13,14,09/07/2023,16,0,53,69,0,0,2,2,0,3,1,4,0,0,0,0,4,0,0,4
7055,174297,2023,Brazil,China,0,1,5,6,08/07/2023,6,0,27,33,0,0,0,0,0,0,1,1,0,0,0,0,1,0,0,1
7056,174297,2023,China,Slovenia,0,0,4,4,06/07/2023,9,0,36,45,1,0,0,1,0,2,4,6,0,0,0,0,3,2,0,5
7057,174297,2023,Japan,China,0,0,21,21,04/07/2023,23,1,67,91,0,0,0,0,3,4,5,12,0,1,0,1,3,2,3,8
7058,174297,2023,China,Germany,1,0,15,16,24/06/2023,14,0,66,80,0,0,0,0,2,3,2,7,0,0,1,1,3,1,0,4
7059,174297,2023,China,Italy,0,0,2,2,22/06/2023,8,0,11,19,0,0,0,0,1,0,0,1,0,0,1,1,0,0,0,0
7060,174297,2023,USA,China,0,1,11,12,21/06/2023,18,0,47,65,1,0,2,3,0,1,1,2,0,0,0,0,1,9,0,10
7061,174297,2023,Netherlands,China,0,1,9,10,20/06/2023,21,0,54,75,0,0,1,1,2,0,2,4,0,0,0,0,3,2,0,5
7062,174297,2023,Iran,China,0,0,8,8,10/06/2023,5,0,45,50,0,0,0,0,0,4,0,4,0,0,0,0,1,0,0,1
7063,174297,2023,China,France,0,0,10,10,09/06/2023,10,2,67,79,1,1,0,2,0,2,1,3,0,0,0,0,4,0,1,5
7064,174297,2023,Serbia,China,0,2,8,10,08/06/2023,12,2,72,86,1,1,0,2,0,0,1,1,0,0,0,0,5,0,0,5
7065,174297,2023,Bulgaria,China,1,1,11,13,06/06/2023,8,1,62,71,1,0,2,3,0,0,2,2,0,0,0,0,2,0,1,3
7066,174295,2023,China,Canada,0,0,0,0,09/07/2023,0,0,0,0,0,0,0,0,0,0,0,0,0,0,0,0,0,0,0,0
7067,174295,2023,Brazil,China,0,0,0,0,08/07/2023,0,0,0,0,0,0,0,0,0,0,0,0,0,0,0,0,0,0,0,0
7068,174295,2023,China,Slovenia,0,0,0,0,06/07/2023,0,0,0,0,0,0,0,0,0,0,0,0,0,0,2,2,0,0,0,0
7069,174295,2023,Japan,China,0,0,0,0,04/07/2023,0,0,0,0,0,0,0,0,0,0,0,0,0,0,0,0,0,0,0,0
7070,174295,2023,China,Germany,0,0,0,0,24/06/2023,0,0,1,1,0,0,0,0,0,0,0,0,0,0,0,0,0,0,0,0
7071,174295,2023,China,Italy,0,0,0,0,22/06/2023,0,0,6,6,0,0,0,0,0,0,0,0,2,3,11,16,4,3,1,8
7072,174295,2023,USA,China,0,0,0,0,21/06/2023,0,0,0,0,0,0,0,0,0,0,0,0,0,0,0,0,0,0,0,0
7073,174295,2023,Netherlands,China,0,0,0,0,20/06/2023,0,0,0,0,0,0,0,0,0,0,0,0,0,0,0,0,0,0,0,0
7074,152518,2023,China,Canada,0,2,9,11,09/07/2023,0,0,3,3,5,6,7,18,1,3,0,4,4,2,21,27,3,5,0,8
7075,152518,2023,Brazil,China,0,0,5,5,08/07/2023,0,0,1,1,6,2,4,12,0,1,1,2,0,1,10,11,2,0,0,2
7076,152518,2023,China,Slovenia,0,3,13,16,06/07/2023,0,0,3,3,15,2,15,32,0,5,3,8,7,2,14,23,9,6,1,16
7077,152518,2023,Japan,China,2,5,9,16,04/07/2023,0,0,4,4,15,2,9,26,0,1,1,2,4,1,16,21,5,3,2,10
7078,152518,2023,China,Germany,1,6,12,19,24/06/2023,0,0,3,3,13,1,5,19,0,0,1,1,8,1,16,25,4,6,1,11
7079,152518,2023,China,Italy,0,4,3,7,22/06/2023,0,1,1,2,7,3,3,13,0,1,0,1,5,0,10,15,4,1,0,5
7080,152518,2023,USA,China,0,0,0,0,21/06/2023,0,0,0,0,0,0,0,0,0,0,0,0,0,0,0,0,0,0,0,0
7081,152518,2023,Netherlands,China,0,0,1,1,20/06/2023,0,0,0,0,0,0,1,1,0,1,0,1,1,0,0,1,2,0,0,2
7082,152518,2023,Iran,China,0,1,2,3,10/06/2023,0,0,1,1,2,1,0,3,0,0,1,1,2,1,2,5,0,0,1,1
7083,152518,2023,China,France,0,0,1,1,09/06/2023,0,0,0,0,1,1,2,4,0,0,0,0,1,2,6,9,0,0,1,1
7084,152518,2023,Serbia,China,0,3,6,9,08/06/2023,0,0,0,0,8,3,6,17,1,0,1,2,7,3,21,31,5,0,1,6
7085,152518,2023,Bulgaria,China,2,5,12,19,06/06/2023,0,0,3,3,11,2,5,18,2,0,2,4,16,1,37,54,3,0,1,4
7086,164632,2023,China,Canada,0,0,0,0,09/07/2023,0,0,0,0,0,0,0,0,0,0,0,0,0,0,0,0,0,0,0,0
7087,164632,2023,Brazil,China,0,0,0,0,08/07/2023,0,0,0,0,0,0,0,0,0,0,0,0,0,0,0,0,0,0,0,0
7088,164632,2023,China,Slovenia,0,0,0,0,06/07/2023,0,0,0,0,0,0,0,0,0,0,0,0,0,0,0,0,0,0,0,0
7089,164632,2023,Japan,China,0,0,0,0,04/07/2023,0,0,0,0,0,0,0,0,0,0,0,0,0,0,0,0,0,0,0,0
7090,164632,2023,China,Germany,0,0,0,0,24/06/2023,0,0,0,0,0,0,0,0,0,0,0,0,0,0,0,0,0,0,0,0
7091,164632,2023,China,Italy,0,0,0,0,22/06/2023,0,0,0,0,0,0,0,0,0,0,0,0,0,0,0,0,0,0,0,0
7092,164632,2023,USA,China,0,0,0,0,21/06/2023,0,0,0,0,0,0,0,0,0,0,0,0,0,0,0,0,0,0,0,0
7093,164632,2023,Netherlands,China,0,0,0,0,20/06/2023,0,0,0,0,0,0,0,0,0,0,0,0,0,0,0,0,0,0,0,0
7094,164632,2023,Iran,China,0,1,3,4,10/06/2023,5,0,21,26,0,0,1,1,1,2,2,5,0,0,0,0,1,0,1,2
7095,164632,2023,China,France,0,1,0,1,09/06/2023,0,0,0,0,0,0,0,0,0,0,0,0,0,0,0,0,0,0,0,0
7096,164632,2023,Serbia,China,0,0,0,0,08/06/2023,0,0,0,0,0,0,0,0,1,1,0,2,0,0,0,0,1,0,0,1
7097,164632,2023,Bulgaria,China,0,0,0,0,06/06/2023,0,0,0,0,0,0,0,0,0,0,0,0,0,0,0,0,0,0,0,0
7098,181103,2023,China,Canada,2,4,5,11,09/07/2023,0,0,4,4,8,1,3,12,0,7,4,11,0,0,1,1,1,0,0,1
7099,181103,2023,Brazil,China,0,1,2,3,08/07/2023,0,0,1,1,0,0,1,1,0,0,3,3,0,0,1,1,0,0,0,0
7100,181103,2023,China,Slovenia,0,0,4,4,06/07/2023,0,0,0,0,1,0,1,2,0,0,0,0,0,0,1,1,0,0,0,0
7101,181103,2023,Japan,China,0,7,6,13,04/07/2023,0,0,1,1,8,2,4,14,8,5,9,22,0,0,1,1,3,0,0,3
7102,181103,2023,China,Germany,0,1,2,3,24/06/2023,0,0,0,0,2,0,0,2,1,1,0,2,0,0,0,0,1,1,0,2
7103,181103,2023,China,Italy,0,0,0,0,22/06/2023,0,0,0,0,0,0,0,0,0,0,0,0,0,0,0,0,0,0,0,0
7104,181103,2023,USA,China,0,1,7,8,21/06/2023,1,0,1,2,2,2,3,7,0,6,5,11,0,0,2,2,0,1,0,1
7105,181103,2023,Netherlands,China,1,3,6,10,20/06/2023,0,0,1,1,6,2,2,10,4,3,1,8,0,0,3,3,0,0,0,0
7106,181103,2023,Iran,China,0,3,7,10,10/06/2023,0,0,0,0,4,1,3,8,4,6,6,16,0,0,1,1,1,0,0,1
7107,181103,2023,China,France,0,3,6,9,09/06/2023,0,0,0,0,8,0,3,11,0,4,7,11,1,0,1,2,0,0,0,0
7108,181103,2023,Serbia,China,0,2,7,9,08/06/2023,0,0,0,0,3,0,1,4,0,0,3,3,1,0,0,1,1,0,0,1
7109,181103,2023,Bulgaria,China,1,4,13,18,06/06/2023,0,0,0,0,7,1,2,10,1,3,2,6,0,0,0,0,0,0,0,0
7110,174159,2023,China,Canada,0,2,1,3,09/07/2023,0,0,1,1,1,0,3,4,0,4,0,4,0,0,5,5,0,1,0,1
7111,174159,2023,Brazil,China,1,2,4,7,08/07/2023,0,0,4,4,2,6,10,18,0,0,0,0,0,0,1,1,3,0,0,3
7112,174159,2023,China,Slovenia,2,1,4,7,06/07/2023,0,0,1,1,6,2,8,16,0,3,2,5,0,0,2,2,1,1,0,2
7113,174159,2023,Japan,China,1,1,10,12,04/07/2023,0,0,1,1,6,0,6,12,1,1,2,4,1,0,7,8,1,0,0,1
7114,174159,2023,China,Germany,0,0,1,1,24/06/2023,0,0,0,0,0,0,0,0,0,0,0,0,0,0,0,0,0,0,0,0
7115,174159,2023,China,Italy,0,4,3,7,22/06/2023,0,0,0,0,12,9,4,25,0,2,2,4,3,0,17,20,2,1,0,3
7116,174159,2023,USA,China,1,2,6,9,21/06/2023,0,0,1,1,12,2,9,23,0,1,2,3,0,1,6,7,7,4,0,11
7117,174159,2023,Netherlands,China,0,1,1,2,20/06/2023,0,0,0,0,0,2,1,3,0,0,2,2,2,0,0,2,0,0,0,0
7118,174159,2023,Iran,China,0,2,5,7,10/06/2023,0,0,1,1,3,5,8,16,0,1,0,1,6,2,15,23,3,0,1,4
7119,174159,2023,China,France,0,3,13,16,09/06/2023,0,0,1,1,7,2,12,21,2,2,0,4,4,0,13,17,6,1,2,9
7120,174159,2023,Serbia,China,0,0,2,2,08/06/2023,0,0,0,0,1,0,0,1,0,0,0,0,1,0,5,6,1,0,0,1
7121,174159,2023,Bulgaria,China,0,0,0,0,06/06/2023,0,0,0,0,0,0,0,0,0,0,0,0,0,0,0,0,0,0,0,0
7122,168175,2023,China,Canada,0,1,12,13,09/07/2023,0,0,1,1,5,4,1,10,3,4,2,9,0,0,0,0,1,0,0,1
7123,168175,2023,Brazil,China,0,1,6,7,08/07/2023,0,0,0,0,1,1,3,5,0,4,2,6,0,0,0,0,0,0,0,0
7124,168175,2023,China,Slovenia,0,2,18,20,06/07/2023,0,0,1,1,6,3,6,15,2,1,3,6,0,0,0,0,1,1,2,4
7125,168175,2023,Japan,China,0,4,17,21,04/07/2023,0,0,0,0,6,0,0,6,1,2,4,7,0,0,0,0,1,0,0,1
7126,168175,2023,China,Germany,1,1,18,20,24/06/2023,0,0,0,0,4,0,3,7,0,6,4,10,0,0,1,1,1,0,0,1
7127,168175,2023,China,Italy,0,0,11,11,22/06/2023,0,0,0,0,3,2,2,7,1,2,4,7,0,0,0,0,0,1,0,1
7128,168175,2023,USA,China,0,0,0,0,21/06/2023,0,0,0,0,0,0,0,0,0,0,0,0,0,0,0,0,0,0,0,0
7129,168175,2023,Netherlands,China,0,1,10,11,20/06/2023,0,0,1,1,8,1,4,13,1,2,3,6,0,0,0,0,0,0,0,0
7130,168175,2023,Iran,China,2,0,17,19,10/06/2023,0,0,1,1,3,0,3,6,3,6,2,11,0,0,0,0,2,0,1,3
7131,168175,2023,China,France,0,2,11,13,09/06/2023,0,0,0,0,4,0,4,8,2,4,1,7,0,0,1,1,5,1,0,6
7132,168175,2023,Serbia,China,0,0,5,5,08/06/2023,0,0,0,0,1,0,1,2,1,0,3,4,1,0,0,1,2,0,0,2
7133,168175,2023,Bulgaria,China,1,1,11,13,06/06/2023,0,0,0,0,5,0,2,7,1,3,2,6,0,0,1,1,1,0,0,1
7134,174158,2023,China,Canada,0,0,0,0,09/07/2023,0,0,5,5,0,0,0,0,0,0,0,0,3,0,21,24,5,2,0,7
7135,174158,2023,Brazil,China,0,0,0,0,08/07/2023,0,0,6,6,0,0,0,0,0,0,0,0,3,1,5,9,3,2,0,5
7136,174158,2023,China,Slovenia,0,0,0,0,06/07/2023,0,0,5,5,0,0,0,0,0,0,0,0,3,2,12,17,9,3,2,14
7137,174158,2023,Japan,China,0,0,0,0,04/07/2023,0,0,5,5,0,0,0,0,0,0,0,0,5,1,14,20,11,6,3,20
7138,174158,2023,China,Germany,0,0,0,0,24/06/2023,0,0,4,4,0,0,0,0,0,0,0,0,8,0,12,20,12,10,2,24
7139,174158,2023,China,Italy,0,0,0,0,22/06/2023,0,0,0,0,0,0,0,0,0,0,0,0,0,0,0,0,0,0,0,0
7140,174158,2023,USA,China,0,0,0,0,21/06/2023,0,0,5,5,0,0,0,0,0,0,0,0,4,1,19,24,4,4,0,8
7141,174158,2023,Netherlands,China,0,0,0,0,20/06/2023,0,0,4,4,0,0,0,0,0,0,0,0,6,2,18,26,6,3,0,9
7142,174158,2023,Iran,China,0,0,0,0,10/06/2023,0,0,1,1,0,0,0,0,0,0,0,0,6,3,17,26,2,2,1,5
7143,174158,2023,China,France,0,0,0,0,09/06/2023,0,0,6,6,0,0,0,0,0,0,0,0,3,2,7,12,11,1,4,16
7144,174158,2023,Serbia,China,0,0,0,0,08/06/2023,0,0,4,4,0,0,0,0,0,0,0,0,4,3,8,15,8,0,0,8
7145,174158,2023,Bulgaria,China,0,0,0,0,06/06/2023,0,0,5,5,0,0,0,0,0,0,0,0,2,2,8,12,8,1,2,11
7146,152511,2023,China,Canada,0,0,4,4,09/07/2023,2,1,20,23,0,0,0,0,0,0,0,0,0,0,0,0,0,0,0,0
7147,152511,2023,Brazil,China,0,1,4,5,08/07/2023,4,0,37,41,0,0,0,0,0,0,1,1,0,1,0,1,4,2,1,7
7148,152511,2023,China,Slovenia,0,1,8,9,06/07/2023,11,1,45,57,0,0,0,0,0,1,2,3,0,0,0,0,2,0,1,3
7149,152511,2023,Japan,China,0,0,0,0,04/07/2023,0,0,0,0,0,0,0,0,0,0,0,0,0,0,0,0,0,0,0,0
7150,152511,2023,China,Germany,0,0,0,0,24/06/2023,0,0,1,1,0,0,0,0,0,1,0,1,0,0,0,0,1,1,0,2
7151,152511,2023,China,Italy,1,1,8,10,22/06/2023,7,0,42,49,0,0,0,0,0,1,0,1,0,0,0,0,1,2,0,3
7152,152511,2023,USA,China,0,0,0,0,21/06/2023,0,0,0,0,0,0,0,0,0,0,0,0,0,0,0,0,0,0,0,0
7153,152511,2023,Netherlands,China,0,0,0,0,20/06/2023,0,0,3,3,0,0,0,0,0,0,0,0,0,0,0,0,0,0,0,0
7154,142598,2023,China,Canada,0,0,0,0,09/07/2023,0,0,0,0,0,0,0,0,0,0,0,0,0,0,0,0,0,0,0,0
7155,142598,2023,Brazil,China,0,0,0,0,08/07/2023,0,0,0,0,0,0,0,0,0,0,0,0,0,0,0,0,0,0,0,0
7156,142598,2023,China,Slovenia,0,0,0,0,06/07/2023,0,0,0,0,0,0,0,0,0,0,0,0,0,0,0,0,0,0,0,0
7157,142598,2023,Japan,China,0,0,0,0,04/07/2023,0,0,0,0,0,0,0,0,0,0,0,0,0,0,0,0,0,0,0,0
7158,168271,2023,China,Canada,1,2,13,16,09/07/2023,0,0,2,2,24,4,13,41,0,3,2,5,1,3,22,26,2,1,2,5
7159,168271,2023,Brazil,China,0,4,3,7,08/07/2023,0,0,4,4,8,5,12,25,1,2,2,5,6,0,27,33,3,0,1,4
7160,168271,2023,China,Slovenia,0,1,11,12,06/07/2023,0,1,4,5,14,5,17,36,2,2,4,8,9,1,26,36,7,3,0,10
7161,168271,2023,Japan,China,2,3,14,19,04/07/2023,0,0,4,4,17,5,14,36,2,4,0,6,4,5,27,36,3,0,1,4
7162,168271,2023,China,Germany,2,3,10,15,24/06/2023,0,0,2,2,20,4,6,30,3,1,2,6,3,2,15,20,0,5,1,6
7163,168271,2023,China,Italy,0,0,0,0,22/06/2023,0,0,0,0,0,0,0,0,0,0,0,0,0,0,0,0,0,0,0,0
7164,168271,2023,USA,China,3,1,11,15,21/06/2023,0,0,2,2,12,5,7,24,0,1,3,4,3,2,8,13,3,2,0,5
7165,168271,2023,Netherlands,China,4,2,7,13,20/06/2023,0,0,2,2,10,10,9,29,1,0,1,2,4,0,17,21,6,3,0,9
7166,168271,2023,Iran,China,1,2,9,12,10/06/2023,0,0,5,5,15,4,7,26,4,2,1,7,8,1,19,28,3,0,2,5
7167,168271,2023,China,France,1,2,11,14,09/06/2023,0,0,2,2,7,6,11,24,1,2,4,7,7,5,24,36,6,1,1,8
7168,168271,2023,Serbia,China,1,2,7,10,08/06/2023,0,0,0,0,14,6,7,27,2,4,2,8,2,2,15,19,3,0,0,3
7169,168271,2023,Bulgaria,China,2,6,8,16,06/06/2023,0,0,3,3,21,6,9,36,6,3,2,11,1,1,14,16,5,0,1,6
7170,169310,2023,China,Canada,0,0,1,1,09/07/2023,0,0,0,0,1,0,0,1,0,0,0,0,0,0,1,1,0,0,0,0
7171,169310,2023,Brazil,China,2,2,1,5,08/07/2023,0,0,0,0,9,2,6,17,0,0,0,0,0,0,9,9,0,0,0,0
7172,169310,2023,China,Slovenia,0,0,1,1,06/07/2023,0,0,0,0,0,0,0,0,0,0,0,0,0,0,0,0,0,1,0,1
7173,169310,2023,Japan,China,0,1,3,4,04/07/2023,0,0,0,0,0,0,0,0,0,0,0,0,0,0,0,0,0,0,0,0
7174,169310,2023,China,Germany,0,1,0,1,24/06/2023,0,0,0,0,0,0,0,0,0,0,0,0,0,0,0,0,0,0,0,0
7175,169310,2023,China,Italy,0,0,3,3,22/06/2023,0,0,0,0,1,0,0,1,0,1,1,2,1,1,8,10,1,1,0,2
7176,169310,2023,USA,China,1,4,6,11,21/06/2023,0,0,0,0,10,0,4,14,0,1,0,1,1,2,12,15,5,3,0,8
7177,169310,2023,Netherlands,China,1,2,6,9,20/06/2023,0,0,2,2,4,7,3,14,0,2,0,2,0,0,11,11,2,2,2,6
7178,169310,2023,Iran,China,0,0,0,0,10/06/2023,0,0,0,0,0,0,0,0,0,0,0,0,0,0,0,0,0,0,0,0
7179,169310,2023,China,France,0,0,0,0,09/06/2023,0,0,0,0,0,0,0,0,0,0,0,0,0,0,0,0,0,0,0,0
7180,169310,2023,Serbia,China,0,0,0,0,08/06/2023,0,0,0,0,0,0,0,0,0,0,0,0,0,0,1,1,0,0,0,0
7181,169310,2023,Bulgaria,China,0,1,2,3,06/06/2023,0,0,0,0,0,0,0,0,0,0,0,0,0,0,0,0,0,0,0,0
7182,147273,2023,Cuba,Iran,0,1,2,3,09/07/2023,0,0,0,0,1,0,1,2,0,1,2,3,0,0,1,1,3,0,0,3
7183,147273,2023,Cuba,Germany,0,0,0,0,08/07/2023,0,0,0,0,0,0,0,0,0,0,0,0,0,0,0,0,0,0,0,0
7184,147273,2023,Serbia,Cuba,0,4,7,11,07/07/2023,0,0,1,1,4,1,2,7,2,2,3,7,0,0,3,3,1,0,0,1
7185,147273,2023,USA,Cuba,0,4,4,8,06/07/2023,0,0,1,1,4,2,1,7,1,4,5,10,0,0,0,0,3,1,0,4
7186,147273,2023,Bulgaria,Cuba,0,1,16,17,25/06/2023,0,0,0,0,6,4,1,11,0,6,5,11,1,0,2,3,1,2,0,3
7187,147273,2023,France,Cuba,0,1,4,5,23/06/2023,0,0,1,1,1,2,2,5,1,3,4,8,0,0,1,1,1,0,0,1
7188,147273,2023,Slovenia,Cuba,0,2,5,7,22/06/2023,0,0,0,0,6,1,2,9,0,4,3,7,0,0,1,1,1,0,0,1
7189,147273,2023,Japan,Cuba,0,2,5,7,21/06/2023,0,0,3,3,6,0,1,7,1,3,2,6,0,0,0,0,0,0,0,0
7190,147273,2023,Brazil,Cuba,0,0,0,0,10/06/2023,0,0,0,0,0,0,0,0,0,0,0,0,0,0,0,0,0,0,0,0
7191,147273,2023,Italy,Cuba,0,4,3,7,09/06/2023,0,0,0,0,5,2,3,10,0,5,5,10,0,1,1,2,1,2,0,3
7192,147273,2023,Netherlands,Cuba,2,1,8,11,08/06/2023,0,0,2,2,6,2,0,8,2,3,2,7,0,0,0,0,0,0,0,0
7193,147273,2023,Canada,Cuba,1,3,9,13,07/06/2023,0,0,0,0,8,2,5,15,2,7,13,22,0,0,0,0,3,1,0,4
7194,151814,2023,Cuba,Iran,0,4,5,9,09/07/2023,0,0,2,2,4,2,4,10,0,1,0,1,3,1,9,13,1,4,0,5
7195,151814,2023,Cuba,Germany,0,2,10,12,08/07/2023,0,0,2,2,4,0,5,9,0,2,0,2,0,1,4,5,5,0,0,5
7196,151814,2023,Serbia,Cuba,1,4,13,18,07/07/2023,0,0,6,6,9,5,14,28,0,5,1,6,2,3,30,35,4,1,0,5
7197,151814,2023,USA,Cuba,0,1,3,4,06/07/2023,0,0,1,1,1,0,2,3,0,1,0,1,1,0,4,5,0,0,0,0
7198,151814,2023,Bulgaria,Cuba,0,1,7,8,25/06/2023,0,0,1,1,10,3,3,16,2,1,0,3,0,0,7,7,3,0,0,3
7199,151814,2023,France,Cuba,0,1,2,3,23/06/2023,0,0,0,0,0,0,1,1,0,0,0,0,0,0,1,1,0,0,0,0
7200,151814,2023,Slovenia,Cuba,1,1,5,7,22/06/2023,0,0,0,0,0,0,1,1,0,0,1,1,0,0,0,0,2,0,0,2
7201,151814,2023,Japan,Cuba,0,1,2,3,21/06/2023,0,0,0,0,0,0,0,0,0,0,0,0,0,0,2,2,0,1,0,1
7202,151814,2023,Brazil,Cuba,0,0,2,2,10/06/2023,0,0,0,0,0,0,0,0,0,0,0,0,0,0,0,0,0,0,0,0
7203,151814,2023,Italy,Cuba,0,0,0,0,09/06/2023,0,0,0,0,0,0,0,0,0,0,0,0,0,0,0,0,0,0,0,0
7204,151814,2023,Netherlands,Cuba,0,4,6,10,08/06/2023,0,0,0,0,6,1,13,20,0,0,2,2,1,0,10,11,5,2,2,9
7205,151814,2023,Canada,Cuba,0,1,2,3,07/06/2023,0,0,0,0,0,0,6,6,0,1,2,3,1,0,4,5,0,1,0,1
7206,147263,2023,Cuba,Iran,0,2,11,13,09/07/2023,0,0,1,1,7,2,5,14,4,8,5,17,0,0,2,2,3,1,1,5
7207,147263,2023,Cuba,Germany,0,2,9,11,08/07/2023,0,0,1,1,4,0,1,5,3,2,3,8,0,0,3,3,2,1,2,5
7208,147263,2023,Serbia,Cuba,0,1,10,11,07/07/2023,0,0,0,0,4,1,4,9,6,7,8,21,0,1,4,5,3,2,1,6
7209,147263,2023,USA,Cuba,0,2,7,9,06/07/2023,0,0,0,0,2,1,3,6,1,3,1,5,0,0,0,0,3,0,1,4
7210,147263,2023,Bulgaria,Cuba,1,4,9,14,25/06/2023,0,0,1,1,5,1,1,7,3,4,1,8,3,0,4,7,0,0,0,0
7211,147263,2023,France,Cuba,0,2,5,7,23/06/2023,0,0,0,0,6,0,2,8,2,4,4,10,0,0,1,1,3,0,0,3
7212,147263,2023,Slovenia,Cuba,0,3,5,8,22/06/2023,0,0,2,2,7,1,1,9,0,3,2,5,0,0,2,2,1,0,0,1
7213,147263,2023,Japan,Cuba,0,2,4,6,21/06/2023,0,0,1,1,5,3,0,8,1,6,2,9,2,0,0,2,0,0,0,0
7214,147263,2023,Brazil,Cuba,1,5,13,19,10/06/2023,0,0,0,0,8,1,2,11,4,6,5,15,0,0,2,2,2,1,0,3
7215,147263,2023,Italy,Cuba,1,4,10,15,09/06/2023,0,0,0,0,4,1,2,7,5,6,1,12,0,0,4,4,3,0,0,3
7216,147263,2023,Netherlands,Cuba,0,1,8,9,08/06/2023,0,0,0,0,3,0,6,9,0,6,6,12,0,1,3,4,1,2,0,3
7217,147263,2023,Canada,Cuba,0,4,15,19,07/06/2023,0,1,2,3,12,2,2,16,0,6,11,17,1,0,0,1,5,1,1,7
7218,168412,2023,Cuba,Iran,0,1,3,4,09/07/2023,6,0,16,22,0,0,2,2,0,3,0,3,0,0,0,0,1,1,0,2
7219,168412,2023,Cuba,Germany,0,0,0,0,08/07/2023,0,0,0,0,0,0,0,0,0,0,0,0,0,0,0,0,0,0,0,0
7220,168412,2023,Serbia,Cuba,0,0,10,10,07/07/2023,5,0,20,25,0,0,2,2,1,1,1,3,0,0,0,0,1,2,0,3
7221,168412,2023,USA,Cuba,0,0,0,0,06/07/2023,0,0,0,0,0,0,0,0,0,0,0,0,0,0,0,0,0,0,0,0
7222,168412,2023,Bulgaria,Cuba,0,1,0,1,25/06/2023,2,0,5,7,0,0,0,0,0,0,0,0,0,0,0,0,0,0,0,0
7223,168412,2023,France,Cuba,1,2,5,8,23/06/2023,15,1,58,74,0,0,4,4,0,3,1,4,0,0,0,0,2,0,0,2
7224,168412,2023,Slovenia,Cuba,0,1,6,7,22/06/2023,13,0,34,47,0,2,0,2,1,4,1,6,0,0,0,0,2,1,0,3
7225,168412,2023,Japan,Cuba,0,1,2,3,21/06/2023,6,0,9,15,0,0,0,0,1,0,0,1,0,0,0,0,0,1,0,1
7226,168412,2023,Brazil,Cuba,0,0,0,0,10/06/2023,0,0,0,0,0,0,0,0,0,0,0,0,0,0,0,0,0,0,0,0
7227,168412,2023,Italy,Cuba,0,2,4,6,09/06/2023,4,0,25,29,1,0,0,1,0,2,2,4,0,0,0,0,1,0,0,1
7228,168412,2023,Netherlands,Cuba,0,1,0,1,08/06/2023,1,0,9,10,0,0,0,0,0,0,0,0,0,0,0,0,1,1,0,2
7229,168412,2023,Canada,Cuba,0,0,0,0,07/06/2023,0,0,0,0,0,0,0,0,0,0,0,0,0,0,0,0,0,0,0,0
7230,132361,2023,Cuba,Iran,0,0,0,0,09/07/2023,0,1,6,7,0,0,0,0,0,0,0,0,2,2,8,12,8,2,0,10
7231,132361,2023,Cuba,Germany,0,0,0,0,08/07/2023,0,0,3,3,0,0,0,0,0,0,0,0,4,2,13,19,3,5,0,8
7232,132361,2023,Serbia,Cuba,0,0,0,0,07/07/2023,0,1,2,3,0,0,0,0,0,0,0,0,4,1,12,17,5,5,1,11
7233,132361,2023,USA,Cuba,0,0,0,0,06/07/2023,0,0,3,3,0,0,0,0,0,0,0,0,6,2,12,20,5,4,0,9
7234,132361,2023,Bulgaria,Cuba,0,0,0,0,25/06/2023,0,0,0,0,0,0,0,0,0,0,0,0,0,0,0,0,0,0,0,0
7235,132361,2023,France,Cuba,0,0,0,0,23/06/2023,0,0,0,0,0,0,0,0,0,0,0,0,0,0,0,0,0,0,0,0
7236,132361,2023,Slovenia,Cuba,0,0,0,0,22/06/2023,0,0,1,1,0,0,0,0,0,0,0,0,2,0,11,13,3,5,1,9
7237,132361,2023,Japan,Cuba,0,0,0,0,21/06/2023,0,0,4,4,0,0,0,0,0,0,0,0,1,0,6,7,1,4,1,6
7238,132361,2023,Brazil,Cuba,0,0,0,0,10/06/2023,0,0,1,1,0,0,0,0,0,0,0,0,3,0,12,15,8,4,3,15
7239,132361,2023,Italy,Cuba,0,0,0,0,09/06/2023,0,0,6,6,0,0,0,0,0,0,0,0,3,1,7,11,4,0,1,5
7240,132361,2023,Netherlands,Cuba,0,0,0,0,08/06/2023,0,0,6,6,0,0,0,0,0,0,0,0,2,0,13,15,4,2,1,7
7241,132361,2023,Canada,Cuba,0,0,0,0,07/06/2023,0,0,5,5,0,0,0,0,0,0,0,0,12,2,24,38,10,6,0,16
7242,147268,2023,Cuba,Iran,0,0,0,0,09/07/2023,0,0,0,0,0,0,0,0,0,0,0,0,0,0,0,0,0,0,0,0
7243,147268,2023,Cuba,Germany,0,0,0,0,08/07/2023,0,0,0,0,0,0,0,0,0,0,0,0,0,0,0,0,0,0,0,0
7244,147268,2023,Serbia,Cuba,0,0,0,0,07/07/2023,0,0,0,0,0,0,0,0,0,0,0,0,0,0,0,0,0,0,0,0
7245,147268,2023,USA,Cuba,0,0,0,0,06/07/2023,0,0,0,0,0,0,0,0,0,0,0,0,0,0,0,0,0,0,0,0
7246,147268,2023,Bulgaria,Cuba,0,0,1,1,25/06/2023,0,0,0,0,1,0,1,2,0,0,0,0,0,0,0,0,0,0,0,0
7247,147268,2023,France,Cuba,0,2,1,3,23/06/2023,0,0,1,1,5,0,3,8,0,1,0,1,0,0,0,0,2,1,1,4
7248,147268,2023,Slovenia,Cuba,0,1,0,1,22/06/2023,0,0,0,0,0,0,1,1,0,1,0,1,0,0,0,0,0,1,0,1
7249,147268,2023,Japan,Cuba,0,0,0,0,21/06/2023,0,0,0,0,1,0,0,1,0,0,0,0,0,0,0,0,0,0,0,0
7250,147268,2023,Brazil,Cuba,0,0,0,0,10/06/2023,0,0,0,0,0,0,0,0,0,0,0,0,0,0,0,0,0,0,0,0
7251,147268,2023,Italy,Cuba,0,1,1,2,09/06/2023,0,0,1,1,2,0,3,5,1,2,0,3,0,0,0,0,1,0,0,1
7252,147268,2023,Netherlands,Cuba,0,0,0,0,08/06/2023,0,0,0,0,0,0,0,0,0,0,0,0,0,0,0,0,0,0,0,0
7253,147268,2023,Canada,Cuba,0,0,0,0,07/06/2023,0,0,0,0,0,0,0,0,1,1,1,3,0,0,0,0,0,0,0,0
7254,157477,2023,Cuba,Iran,0,2,10,12,09/07/2023,27,1,59,87,0,0,0,0,3,1,3,7,0,0,0,0,4,4,1,9
7255,157477,2023,Cuba,Germany,0,1,9,10,08/07/2023,13,1,53,67,0,1,0,1,2,2,1,5,0,1,2,3,5,0,0,5
7256,157477,2023,Serbia,Cuba,0,3,6,9,07/07/2023,18,2,52,72,0,0,1,1,3,2,3,8,0,0,0,0,1,2,0,3
7257,157477,2023,USA,Cuba,0,1,7,8,06/07/2023,18,1,36,55,0,0,0,0,1,1,0,2,0,0,0,0,1,1,0,2
7258,157477,2023,Bulgaria,Cuba,0,0,12,12,25/06/2023,27,0,70,97,1,0,1,2,1,5,3,9,0,0,0,0,4,6,0,10
7259,157477,2023,France,Cuba,0,0,0,0,23/06/2023,0,0,0,0,0,0,0,0,0,0,0,0,0,0,0,0,0,0,0,0
7260,157477,2023,Slovenia,Cuba,0,0,4,4,22/06/2023,6,0,25,31,1,0,0,1,0,3,2,5,0,0,0,0,2,2,0,4
7261,157477,2023,Japan,Cuba,0,0,4,4,21/06/2023,12,0,28,40,0,2,0,2,0,2,1,3,0,0,0,0,0,3,0,3
7262,157477,2023,Brazil,Cuba,0,1,19,20,10/06/2023,24,0,82,106,1,0,0,1,2,1,5,8,0,0,0,0,5,4,1,10
7263,157477,2023,Italy,Cuba,0,0,11,11,09/06/2023,10,0,38,48,1,1,0,2,1,0,0,1,0,1,3,4,3,1,0,4
7264,157477,2023,Netherlands,Cuba,0,2,9,11,08/06/2023,9,1,45,55,1,0,1,2,0,2,1,3,0,0,1,1,3,1,1,5
7265,157477,2023,Canada,Cuba,0,1,14,15,07/06/2023,19,1,102,122,1,0,0,1,1,5,4,10,0,0,0,0,7,4,0,11
7266,169940,2023,Cuba,Iran,2,7,12,21,09/07/2023,0,0,3,3,25,6,5,36,1,2,1,4,0,0,0,0,1,4,1,6
7267,169940,2023,Cuba,Germany,0,5,6,11,08/07/2023,0,0,1,1,15,1,12,28,1,5,0,6,1,0,1,2,2,3,0,5
7268,169940,2023,Serbia,Cuba,5,7,10,22,07/07/2023,0,0,1,1,24,12,9,45,1,1,3,5,0,0,0,0,3,1,0,4
7269,169940,2023,USA,Cuba,1,3,8,12,06/07/2023,0,0,1,1,10,6,8,24,0,1,0,1,0,0,0,0,2,0,2,4
7270,169940,2023,Bulgaria,Cuba,6,6,13,25,25/06/2023,0,0,1,1,21,6,9,36,0,2,1,3,1,0,1,2,7,3,1,11
7271,169940,2023,France,Cuba,0,2,6,8,23/06/2023,0,0,0,0,4,7,2,13,0,0,3,3,0,0,0,0,0,3,0,3
7272,169940,2023,Slovenia,Cuba,1,2,10,13,22/06/2023,0,0,0,0,12,10,9,31,0,2,4,6,0,1,0,1,1,2,1,4
7273,169940,2023,Japan,Cuba,1,5,7,13,21/06/2023,0,0,0,0,4,3,6,13,1,0,1,2,0,0,0,0,5,2,0,7
7274,169940,2023,Brazil,Cuba,2,4,18,24,10/06/2023,0,0,4,4,26,6,6,38,2,2,2,6,0,0,2,2,5,3,0,8
7275,169940,2023,Italy,Cuba,0,2,9,11,09/06/2023,0,0,2,2,6,7,10,23,1,5,2,8,0,0,0,0,4,5,1,10
7276,169940,2023,Netherlands,Cuba,1,4,10,15,08/06/2023,0,0,1,1,9,8,5,22,2,5,3,10,0,0,0,0,2,7,0,9
7277,169940,2023,Canada,Cuba,2,5,14,21,07/06/2023,0,0,1,1,24,11,6,41,2,3,3,8,0,0,0,0,8,4,3,15
7278,147272,2023,Cuba,Iran,0,0,0,0,09/07/2023,0,0,0,0,0,0,0,0,0,0,0,0,0,0,0,0,0,0,0,0
7279,147272,2023,Cuba,Germany,0,0,0,0,08/07/2023,0,0,0,0,0,0,0,0,0,0,0,0,0,0,0,0,0,0,0,0
7280,147272,2023,Serbia,Cuba,0,0,0,0,07/07/2023,0,0,0,0,0,0,0,0,0,0,0,0,0,0,0,0,0,0,0,0
7281,147272,2023,USA,Cuba,0,0,0,0,06/07/2023,2,0,2,4,0,0,0,0,0,1,0,1,0,0,0,0,0,0,0,0
7282,147272,2023,Bulgaria,Cuba,0,0,0,0,25/06/2023,0,0,0,0,0,0,0,0,0,0,0,0,0,0,0,0,0,0,0,0
7283,147272,2023,France,Cuba,0,0,0,0,23/06/2023,0,0,0,0,0,0,0,0,0,0,0,0,0,0,0,0,0,0,0,0
7284,147272,2023,Slovenia,Cuba,0,0,0,0,22/06/2023,0,0,0,0,0,0,0,0,0,0,0,0,0,0,0,0,0,0,0,0
7285,147272,2023,Japan,Cuba,0,0,0,0,21/06/2023,0,0,0,0,0,0,0,0,0,0,0,0,0,0,0,0,0,0,0,0
7286,147272,2023,Brazil,Cuba,0,0,0,0,10/06/2023,0,0,0,0,0,0,0,0,0,0,0,0,0,0,0,0,0,0,0,0
7287,147272,2023,Italy,Cuba,0,0,0,0,09/06/2023,0,0,0,0,0,0,0,0,0,0,0,0,0,0,0,0,0,0,0,0
7288,147272,2023,Netherlands,Cuba,0,0,0,0,08/06/2023,0,0,0,0,0,0,0,0,0,0,0,0,0,0,0,0,0,0,0,0
7289,147272,2023,Canada,Cuba,0,0,0,0,07/06/2023,0,0,0,0,0,0,0,0,0,0,0,0,0,0,0,0,0,0,0,0
7290,151817,2023,Cuba,Iran,3,5,15,23,09/07/2023,0,0,2,2,22,3,8,33,2,3,4,9,9,0,32,41,1,5,1,7
7291,151817,2023,Cuba,Germany,1,3,8,12,08/07/2023,0,1,5,6,11,2,10,23,1,0,1,2,1,4,21,26,4,2,1,7
7292,151817,2023,Serbia,Cuba,2,4,9,15,07/07/2023,0,0,2,2,12,3,6,21,0,3,0,3,6,2,17,25,5,1,1,7
7293,151817,2023,USA,Cuba,1,3,6,10,06/07/2023,0,0,0,0,11,4,3,18,0,1,1,2,2,4,11,17,4,1,0,5
7294,151817,2023,Bulgaria,Cuba,1,4,10,15,25/06/2023,0,0,7,7,17,6,9,32,1,4,1,6,4,1,15,20,11,2,2,15
7295,151817,2023,France,Cuba,3,2,8,13,23/06/2023,0,0,2,2,9,5,7,21,0,5,2,7,4,0,9,13,7,1,2,10
7296,151817,2023,Slovenia,Cuba,0,4,9,13,22/06/2023,0,0,5,5,9,5,6,20,0,6,2,8,6,2,20,28,2,3,0,5
7297,151817,2023,Japan,Cuba,1,4,6,11,21/06/2023,0,0,1,1,8,2,5,15,1,2,3,6,4,0,14,18,0,3,0,3
7298,151817,2023,Brazil,Cuba,2,6,12,20,10/06/2023,0,0,5,5,14,4,17,35,0,5,4,9,6,1,27,34,4,5,2,11
7299,151817,2023,Italy,Cuba,2,4,7,13,09/06/2023,0,1,6,7,11,3,9,23,1,2,1,4,1,0,21,22,2,0,1,3
7300,151817,2023,Netherlands,Cuba,0,2,8,10,08/06/2023,0,0,6,6,9,5,5,19,1,0,3,4,4,0,21,25,2,1,0,3
7301,151817,2023,Canada,Cuba,0,5,14,19,07/06/2023,0,0,7,7,15,7,12,34,0,2,3,5,6,1,20,27,6,5,0,11
7302,182877,2023,Cuba,Iran,0,1,15,16,09/07/2023,0,0,0,0,4,2,3,9,0,6,3,9,0,0,0,0,1,1,0,2
7303,182877,2023,Cuba,Germany,0,2,4,6,08/07/2023,0,0,0,0,2,1,1,4,4,2,3,9,0,0,0,0,0,0,0,0
7304,182877,2023,Serbia,Cuba,0,1,2,3,07/07/2023,0,0,0,0,0,0,1,1,1,0,0,1,0,0,1,1,0,0,0,0
7305,182877,2023,USA,Cuba,0,0,0,0,06/07/2023,0,0,0,0,0,0,0,0,0,0,0,0,0,0,0,0,0,0,0,0
7306,182877,2023,Bulgaria,Cuba,0,0,2,2,25/06/2023,0,0,0,0,0,0,0,0,0,1,0,1,0,0,0,0,0,0,0,0
7307,182877,2023,France,Cuba,0,1,1,2,23/06/2023,0,0,0,0,0,1,2,3,2,3,0,5,0,0,0,0,0,0,0,0
7308,182877,2023,Slovenia,Cuba,0,0,0,0,22/06/2023,0,0,0,0,0,0,0,0,0,0,0,0,0,0,0,0,0,0,0,0
7309,182877,2023,Japan,Cuba,0,0,0,0,21/06/2023,0,0,0,0,0,0,0,0,0,0,0,0,0,0,0,0,0,0,0,0
7310,182877,2023,Brazil,Cuba,0,2,7,9,10/06/2023,0,0,0,0,4,1,1,6,4,6,4,14,0,0,1,1,0,1,0,1
7311,182877,2023,Italy,Cuba,0,0,0,0,09/06/2023,0,0,0,0,0,0,0,0,0,0,0,0,0,0,0,0,0,0,0,0
7312,182877,2023,Netherlands,Cuba,0,0,0,0,08/06/2023,0,0,0,0,0,0,0,0,0,0,0,0,0,0,0,0,0,0,0,0
7313,182877,2023,Canada,Cuba,0,0,0,0,07/06/2023,0,0,0,0,0,0,0,0,0,0,0,0,0,0,0,0,0,0,0,0
7314,168417,2023,Cuba,Iran,1,2,3,6,09/07/2023,0,0,0,0,0,0,0,0,0,0,0,0,0,0,0,0,1,0,0,1
7315,168417,2023,Cuba,Germany,0,1,4,5,08/07/2023,0,0,0,0,0,0,0,0,0,0,0,0,0,0,0,0,0,1,0,1
7316,168417,2023,Serbia,Cuba,0,2,4,6,07/07/2023,0,0,0,0,0,0,0,0,0,0,0,0,0,0,0,0,0,0,0,0
7317,168417,2023,USA,Cuba,0,0,0,0,06/07/2023,0,0,0,0,0,0,0,0,0,0,0,0,0,0,0,0,0,0,0,0
7318,168417,2023,Bulgaria,Cuba,0,3,1,4,25/06/2023,0,0,1,1,0,1,1,2,1,0,0,1,0,0,0,0,0,0,0,0
7319,168417,2023,France,Cuba,0,2,0,2,23/06/2023,0,0,0,0,0,0,0,0,0,0,0,0,0,0,0,0,0,0,0,0
7320,168417,2023,Slovenia,Cuba,0,1,3,4,22/06/2023,0,0,0,0,0,0,0,0,0,0,0,0,0,0,0,0,0,0,0,0
7321,168417,2023,Japan,Cuba,0,1,3,4,21/06/2023,0,0,0,0,0,0,0,0,0,0,0,0,0,0,0,0,0,1,0,1
7322,168417,2023,Brazil,Cuba,0,3,3,6,10/06/2023,0,0,0,0,0,0,0,0,0,0,0,0,0,0,0,0,0,0,0,0
7323,168417,2023,Italy,Cuba,0,1,2,3,09/06/2023,0,0,0,0,0,0,0,0,0,0,0,0,0,0,0,0,0,0,0,0
7324,168417,2023,Netherlands,Cuba,0,1,0,1,08/06/2023,0,0,0,0,0,0,0,0,0,0,0,0,0,0,0,0,0,0,0,0
7325,168417,2023,Canada,Cuba,0,1,5,6,07/06/2023,0,0,0,0,0,0,0,0,0,0,0,0,0,0,0,0,2,0,0,2
7326,157318,2023,Cuba,Iran,1,5,7,13,09/07/2023,0,0,0,0,13,4,2,19,1,0,3,4,6,0,23,29,4,4,0,8
7327,157318,2023,Cuba,Germany,0,1,2,3,08/07/2023,0,0,0,0,3,2,4,9,0,1,1,2,0,1,3,4,0,0,0,0
7328,157318,2023,Serbia,Cuba,0,0,1,1,07/07/2023,0,0,0,0,0,0,0,0,0,0,0,0,0,0,0,0,0,0,0,0
7329,157318,2023,USA,Cuba,0,2,5,7,06/07/2023,0,0,1,1,2,1,5,8,1,4,0,5,2,2,9,13,0,0,1,1
7330,157318,2023,Bulgaria,Cuba,0,2,5,7,25/06/2023,0,0,1,1,1,3,2,6,0,0,2,2,2,1,12,15,0,1,0,1
7331,157318,2023,France,Cuba,0,5,4,9,23/06/2023,0,0,1,1,7,2,10,19,3,1,5,9,3,0,19,22,2,0,0,2
7332,157318,2023,Slovenia,Cuba,2,4,6,12,22/06/2023,0,0,2,2,10,1,5,16,1,2,1,4,5,2,22,29,6,3,0,9
7333,157318,2023,Japan,Cuba,1,5,4,10,21/06/2023,0,0,1,1,6,2,6,14,3,0,0,3,9,0,23,32,1,0,0,1
7334,157318,2023,Brazil,Cuba,0,6,13,19,10/06/2023,0,0,2,2,17,2,13,32,2,5,3,10,3,1,32,36,3,1,1,5
7335,157318,2023,Italy,Cuba,0,2,13,15,09/06/2023,0,0,1,1,11,3,9,23,0,3,1,4,4,2,23,29,4,1,0,5
7336,157318,2023,Netherlands,Cuba,0,1,0,1,08/06/2023,0,0,1,1,0,1,0,1,0,0,0,0,1,0,2,3,0,0,0,0
7337,157318,2023,Canada,Cuba,0,3,9,12,07/06/2023,0,0,8,8,15,5,13,33,0,4,2,6,3,0,21,24,9,2,3,14
7338,190322,2023,Cuba,Iran,0,0,0,0,09/07/2023,0,0,0,0,0,0,0,0,0,0,0,0,0,0,0,0,0,0,0,0
7339,190322,2023,Cuba,Germany,0,0,0,0,08/07/2023,0,0,0,0,0,0,0,0,0,0,0,0,0,0,0,0,0,0,0,0
7340,190322,2023,Serbia,Cuba,0,0,0,0,07/07/2023,0,0,0,0,0,0,0,0,0,0,0,0,0,0,0,0,0,0,0,0
7341,190322,2023,USA,Cuba,0,0,0,0,06/07/2023,0,0,0,0,0,0,0,0,0,0,0,0,0,0,0,0,0,0,0,0
7342,190322,2023,Bulgaria,Cuba,0,0,0,0,25/06/2023,0,0,2,2,0,0,0,0,0,0,0,0,9,1,23,33,3,7,1,11
7343,190322,2023,France,Cuba,0,0,0,0,23/06/2023,0,0,2,2,0,0,0,0,0,0,0,0,4,4,13,21,6,5,1,12
7344,190322,2023,Slovenia,Cuba,0,0,0,0,22/06/2023,0,0,0,0,0,0,0,0,0,0,0,0,1,0,1,2,0,0,0,0
7345,190322,2023,Japan,Cuba,0,0,0,0,21/06/2023,0,0,0,0,0,0,0,0,0,0,0,0,0,0,0,0,0,1,0,1
7346,190322,2023,Brazil,Cuba,0,0,0,0,10/06/2023,0,0,0,0,0,0,0,0,0,0,0,0,0,0,0,0,0,0,0,0
7347,190322,2023,Italy,Cuba,0,0,0,0,09/06/2023,0,0,1,1,0,0,0,0,0,0,0,0,0,0,0,0,0,0,0,0
7348,190322,2023,Netherlands,Cuba,0,0,0,0,08/06/2023,0,0,0,0,0,0,0,0,0,0,0,0,0,0,0,0,6,2,0,8
7349,190322,2023,Canada,Cuba,0,0,0,0,07/06/2023,0,0,0,0,0,0,0,0,0,0,0,0,0,0,0,0,4,3,1,8
7350,152494,2023,USA,France,1,4,13,18,19/07/2023,0,0,1,1,10,1,6,17,5,4,3,12,0,0,0,0,0,1,1,2
7351,152494,2023,France,Germany,1,1,12,14,10/07/2023,0,0,0,0,11,2,5,18,1,4,4,9,0,0,0,0,2,0,0,2
7352,152494,2023,USA,France,1,2,6,9,09/07/2023,0,0,0,0,9,1,1,11,1,5,2,8,0,0,0,0,0,1,0,1
7353,152494,2023,Serbia,France,0,2,10,12,07/07/2023,0,0,1,1,7,3,3,13,3,4,2,9,0,0,1,1,1,0,0,1
7354,152494,2023,Iran,France,0,2,9,11,04/07/2023,0,0,2,2,6,1,2,9,1,4,3,8,0,0,0,0,2,0,1,3
7355,152494,2023,Brazil,France,1,0,10,11,25/06/2023,0,1,3,4,8,1,5,14,1,5,3,9,0,0,0,0,2,1,0,3
7356,152494,2023,Canada,France,0,4,5,9,24/06/2023,0,0,0,0,7,0,3,10,0,2,3,5,0,0,0,0,4,1,0,5
7357,152494,2023,France,Cuba,0,2,8,10,23/06/2023,0,0,0,0,5,0,3,8,0,3,3,6,0,0,0,0,3,0,0,3
7358,152494,2023,Argentina,France,0,3,9,12,21/06/2023,0,0,0,0,7,3,5,15,3,3,2,8,0,0,0,0,3,1,0,4
7359,119792,2023,USA,France,0,0,0,0,19/07/2023,0,0,9,9,0,0,0,0,0,0,0,0,6,1,14,21,10,5,2,17
7360,119792,2023,France,Germany,0,0,0,0,10/07/2023,0,0,9,9,0,0,0,0,0,0,0,0,2,2,16,20,12,4,1,17
7361,119792,2023,USA,France,0,0,0,0,09/07/2023,0,0,12,12,0,0,0,0,0,0,0,0,10,0,8,18,8,4,2,14
7362,119792,2023,Serbia,France,0,0,0,0,07/07/2023,0,0,11,11,0,0,0,0,0,0,0,0,5,0,11,16,10,2,2,14
7363,119792,2023,Iran,France,0,0,0,0,04/07/2023,0,0,8,8,0,0,0,0,0,0,0,0,2,0,16,18,7,3,3,13
7364,119792,2023,Brazil,France,0,0,0,0,25/06/2023,0,0,5,5,0,0,0,0,0,0,0,0,3,1,19,23,15,8,0,23
7365,119792,2023,Canada,France,0,0,0,0,24/06/2023,0,0,4,4,0,0,0,0,0,0,0,0,4,0,11,15,10,4,0,14
7366,119792,2023,France,Cuba,0,0,0,0,23/06/2023,0,0,4,4,0,0,0,0,0,0,0,0,2,1,10,13,12,5,2,19
7367,119792,2023,Argentina,France,0,0,0,0,21/06/2023,0,0,7,7,0,0,0,0,0,0,0,0,9,2,13,24,19,5,1,25
7368,142694,2023,USA,France,2,4,5,11,19/07/2023,0,0,0,0,13,6,10,29,2,1,3,6,0,0,0,0,3,0,0,3
7369,142694,2023,France,Germany,0,0,1,1,10/07/2023,0,0,0,0,1,1,3,5,0,0,0,0,0,0,0,0,1,0,0,1
7370,142694,2023,USA,France,0,2,10,12,09/07/2023,0,0,1,1,9,3,10,22,2,3,0,5,0,0,0,0,2,1,1,4
7371,142694,2023,Serbia,France,0,3,13,16,07/07/2023,0,0,0,0,16,8,15,39,2,1,1,4,0,0,0,0,4,3,0,7
7372,142694,2023,Iran,France,0,1,0,1,04/07/2023,0,0,0,0,2,0,0,2,0,0,0,0,0,0,0,0,0,0,0,0
7373,142694,2023,Brazil,France,0,0,0,0,25/06/2023,0,0,0,0,0,0,0,0,0,0,0,0,0,0,0,0,0,0,0,0
7374,142694,2023,Canada,France,3,2,13,18,24/06/2023,0,0,0,0,11,0,10,21,2,3,2,7,0,0,0,0,3,1,0,4
7375,142694,2023,France,Cuba,1,3,8,12,23/06/2023,0,0,2,2,13,3,11,27,0,0,3,3,0,0,0,0,3,0,2,5
7376,142694,2023,Argentina,France,0,1,0,1,21/06/2023,0,0,0,0,3,0,2,5,2,1,0,3,0,0,0,0,0,0,0,0
7377,119804,2023,USA,France,0,0,6,6,19/07/2023,12,0,34,46,1,0,0,1,0,0,1,1,0,0,0,0,0,3,1,4
7378,119804,2023,France,Germany,0,1,21,22,10/07/2023,30,0,41,71,1,0,1,2,1,3,2,6,0,0,0,0,3,4,0,7
7379,119804,2023,USA,France,0,0,0,0,09/07/2023,3,0,7,10,0,0,0,0,0,0,0,0,0,0,0,0,0,0,0,0
7380,119804,2023,Serbia,France,0,0,0,0,07/07/2023,0,0,0,0,0,0,0,0,0,0,0,0,0,0,0,0,0,0,0,0
7381,119804,2023,Iran,France,0,1,12,13,04/07/2023,17,0,40,57,1,0,0,1,0,0,2,2,0,0,1,1,3,1,0,4
7382,124518,2023,USA,France,0,2,20,22,19/07/2023,0,0,3,3,11,6,6,23,0,3,3,6,7,3,27,37,13,3,0,16
7383,124518,2023,Brazil,France,0,3,17,20,25/06/2023,0,0,3,3,9,4,9,22,0,4,2,6,8,1,19,28,2,1,4,7
7384,124518,2023,Canada,France,0,0,1,1,24/06/2023,0,0,0,0,0,0,0,0,0,0,0,0,0,0,0,0,0,0,0,0
7385,124518,2023,France,Cuba,0,1,6,7,23/06/2023,0,0,4,4,5,3,7,15,2,1,2,5,3,0,6,9,5,2,0,7
7386,124518,2023,Argentina,France,0,2,15,17,21/06/2023,0,0,4,4,13,6,9,28,0,3,5,8,8,0,11,19,3,3,0,6
7387,124518,2023,Japan,France,0,3,10,13,11/06/2023,0,0,3,3,14,2,5,21,0,1,4,5,12,1,15,28,7,2,0,9
7388,124518,2023,France,Slovenia,0,3,12,15,10/06/2023,0,0,2,2,8,5,12,25,1,4,1,6,7,2,19,28,10,1,0,11
7389,124518,2023,China,France,1,2,17,20,09/06/2023,0,0,3,3,16,5,8,29,0,1,2,3,7,0,10,17,11,1,1,13
7390,124518,2023,Poland,France,1,3,12,16,07/06/2023,0,0,3,3,10,4,11,25,1,4,5,10,7,2,10,19,6,1,0,7
7391,136851,2023,USA,France,2,4,11,17,19/07/2023,25,0,46,71,0,0,2,2,1,4,2,7,0,0,0,0,8,3,0,11
7392,136851,2023,France,Germany,0,0,0,0,10/07/2023,2,0,12,14,0,0,0,0,0,0,0,0,0,0,0,0,0,0,0,0
7393,136851,2023,USA,France,0,5,6,11,09/07/2023,19,0,45,64,0,1,1,2,0,1,1,2,0,0,0,0,4,1,0,5
7394,136851,2023,Serbia,France,1,6,11,18,07/07/2023,29,0,64,93,2,0,1,3,0,3,4,7,0,0,1,1,4,3,1,8
7395,136851,2023,Iran,France,0,0,0,0,04/07/2023,1,0,4,5,0,0,0,0,0,0,0,0,0,0,0,0,0,1,0,1
7396,136851,2023,Brazil,France,3,3,16,22,25/06/2023,30,0,60,90,3,0,2,5,1,3,1,5,0,1,0,1,4,4,0,8
7397,136851,2023,Canada,France,0,1,8,9,24/06/2023,16,1,52,69,1,1,0,2,1,4,4,9,0,0,0,0,4,1,1,6
7398,136851,2023,France,Cuba,1,4,8,13,23/06/2023,13,0,46,59,2,0,0,2,2,2,3,7,0,0,0,0,3,3,0,6
7399,136851,2023,Argentina,France,0,5,13,18,21/06/2023,21,2,71,94,0,0,3,3,1,1,1,3,0,0,0,0,4,1,2,7
7400,142710,2023,USA,France,0,1,3,4,19/07/2023,0,0,1,1,4,1,10,15,0,1,1,2,0,0,1,1,3,0,1,4
7401,142710,2023,France,Germany,1,7,7,15,10/07/2023,0,0,1,1,11,5,8,24,1,1,4,6,0,0,0,0,2,1,0,3
7402,142710,2023,USA,France,0,0,2,2,09/07/2023,0,0,0,0,2,0,0,2,1,0,0,1,0,0,0,0,0,0,0,0
7403,142710,2023,Serbia,France,0,0,0,0,07/07/2023,0,0,0,0,0,0,0,0,0,0,0,0,0,0,0,0,0,0,0,0
7404,142710,2023,Iran,France,1,3,6,10,04/07/2023,0,0,1,1,10,1,8,19,0,3,0,3,0,0,0,0,4,2,1,7
7405,142710,2023,Brazil,France,0,5,7,12,25/06/2023,0,0,3,3,16,5,15,36,1,2,3,6,1,0,0,1,4,3,0,7
7406,142710,2023,Canada,France,0,0,0,0,24/06/2023,0,0,0,0,0,0,0,0,0,0,0,0,0,0,0,0,0,0,0,0
7407,142710,2023,France,Cuba,0,0,0,0,23/06/2023,0,0,0,0,0,0,0,0,0,0,0,0,0,0,0,0,0,0,0,0
7408,142710,2023,Argentina,France,0,3,7,10,21/06/2023,0,0,2,2,14,6,8,28,0,3,1,4,0,0,0,0,4,2,0,6
7409,125073,2023,USA,France,1,1,6,8,19/07/2023,0,0,0,0,11,2,5,18,2,5,0,7,0,0,0,0,1,1,0,2
7410,125073,2023,France,Germany,0,0,7,7,10/07/2023,0,0,0,0,7,0,0,7,3,2,1,6,0,0,0,0,0,1,0,1
7411,125073,2023,USA,France,0,3,0,3,09/07/2023,0,0,0,0,1,0,1,2,0,2,1,3,0,0,0,0,0,0,1,1
7412,125073,2023,Serbia,France,0,2,1,3,07/07/2023,0,0,0,0,0,0,1,1,0,1,1,2,0,0,0,0,0,0,0,0
7413,125073,2023,Iran,France,0,1,6,7,04/07/2023,0,0,0,0,1,1,2,4,3,2,3,8,0,0,0,0,2,0,0,2
7414,142677,2023,USA,France,0,0,0,0,19/07/2023,0,0,0,0,0,0,0,0,0,0,0,0,0,0,0,0,0,0,0,0
7415,142677,2023,France,Germany,0,0,0,0,10/07/2023,0,0,0,0,0,0,0,0,0,0,0,0,0,0,0,0,0,0,0,0
7416,142677,2023,USA,France,0,2,3,5,09/07/2023,0,0,0,0,2,1,4,7,1,1,3,5,0,0,0,0,0,0,0,0
7417,142677,2023,Serbia,France,0,3,2,5,07/07/2023,0,0,0,0,9,1,3,13,4,2,6,12,0,0,1,1,0,0,0,0
7418,142677,2023,Iran,France,0,0,0,0,04/07/2023,0,0,0,0,0,0,0,0,0,0,0,0,0,0,0,0,0,0,0,0
7419,142677,2023,Brazil,France,0,3,5,8,25/06/2023,0,0,0,0,7,1,1,9,1,3,3,7,0,0,0,0,0,0,2,2
7420,142677,2023,Canada,France,0,3,9,12,24/06/2023,0,0,0,0,7,1,2,10,0,2,2,4,0,0,0,0,1,1,0,2
7421,142677,2023,France,Cuba,2,1,7,10,23/06/2023,0,0,0,0,3,0,2,5,1,4,3,8,0,0,0,0,0,0,0,0
7422,142677,2023,Argentina,France,0,0,7,7,21/06/2023,0,0,0,0,4,1,0,5,0,1,3,4,0,0,0,0,0,0,0,0
7423,142677,2023,Japan,France,1,3,6,10,11/06/2023,0,0,1,1,5,0,2,7,0,1,3,4,0,0,1,1,1,0,0,1
7424,142677,2023,France,Slovenia,0,2,6,8,10/06/2023,0,0,2,2,6,0,3,9,0,3,0,3,0,0,2,2,1,0,0,1
7425,142677,2023,China,France,1,4,6,11,09/06/2023,0,0,0,0,10,0,4,14,1,3,6,10,0,0,2,2,5,0,1,6
7426,142677,2023,Poland,France,0,3,8,11,07/06/2023,0,0,0,0,6,1,2,9,2,2,0,4,0,0,0,0,5,0,0,5
7427,132948,2023,USA,France,0,4,6,10,19/07/2023,0,0,1,1,6,0,20,26,1,5,6,12,2,1,24,27,5,5,1,11
7428,132948,2023,France,Germany,1,4,8,13,10/07/2023,0,0,0,0,15,1,5,21,1,5,0,6,10,2,12,24,3,2,0,5
7429,132948,2023,USA,France,0,2,12,14,09/07/2023,0,0,1,1,9,6,9,24,1,1,2,4,2,1,11,14,2,4,2,8
7430,132948,2023,Serbia,France,0,3,13,16,07/07/2023,0,0,7,7,17,4,11,32,0,3,2,5,9,0,19,28,5,2,2,9
7431,132948,2023,Iran,France,0,4,9,13,04/07/2023,0,0,1,1,7,5,11,23,0,1,0,1,2,0,11,13,5,2,1,8
7432,132948,2023,Brazil,France,1,3,10,14,25/06/2023,0,0,2,2,10,4,10,24,2,8,2,12,2,1,22,25,1,3,1,5
7433,132948,2023,Canada,France,0,2,8,10,24/06/2023,0,0,3,3,16,0,3,19,1,2,2,5,3,1,12,16,3,1,2,6
7434,132948,2023,France,Cuba,0,1,15,16,23/06/2023,0,0,5,5,2,2,9,13,0,2,0,2,1,2,14,17,4,2,0,6
7435,132948,2023,Argentina,France,1,0,6,7,21/06/2023,0,0,1,1,4,1,4,9,1,0,1,2,6,1,4,11,3,1,0,4
7436,120735,2023,USA,France,0,0,0,0,19/07/2023,0,0,0,0,0,0,0,0,0,0,0,0,0,0,0,0,0,0,0,0
7437,120735,2023,France,Germany,1,3,14,18,10/07/2023,0,0,0,0,6,3,11,20,1,0,2,3,8,2,15,25,2,3,0,5
7438,120735,2023,USA,France,1,3,9,13,09/07/2023,0,0,2,2,8,4,7,19,2,2,1,5,9,3,17,29,1,0,4,5
7439,120735,2023,Serbia,France,1,0,15,16,07/07/2023,0,0,2,2,3,4,7,14,1,4,3,8,7,1,14,22,2,2,0,4
7440,120735,2023,Iran,France,0,0,0,0,04/07/2023,0,0,0,0,0,0,0,0,0,0,0,0,0,0,0,0,0,0,0,0
7441,120735,2023,Brazil,France,0,1,2,3,25/06/2023,0,0,0,0,0,0,0,0,0,0,0,0,0,0,0,0,0,0,0,0
7442,120735,2023,Canada,France,1,1,10,12,24/06/2023,0,0,2,2,9,1,9,19,1,3,0,4,6,3,12,21,2,2,1,5
7443,120735,2023,France,Cuba,0,0,1,1,23/06/2023,0,0,0,0,0,0,0,0,0,0,0,0,0,0,0,0,0,0,0,0
7444,120735,2023,Argentina,France,0,2,7,9,21/06/2023,0,0,1,1,7,2,7,16,0,3,1,4,9,1,15,25,3,0,0,3
7445,152506,2023,USA,France,0,0,0,0,19/07/2023,0,0,0,0,0,0,0,0,0,0,0,0,0,0,0,0,0,0,0,0
7446,152506,2023,France,Germany,0,0,0,0,10/07/2023,0,0,0,0,0,0,0,0,0,0,0,0,0,0,0,0,0,0,0,0
7447,152506,2023,USA,France,0,0,0,0,09/07/2023,0,0,0,0,0,0,0,0,0,0,0,0,0,0,0,0,0,0,0,0
7448,152506,2023,Serbia,France,0,0,0,0,07/07/2023,0,0,0,0,0,0,0,0,0,0,0,0,0,0,0,0,0,0,0,0
7449,152506,2023,Iran,France,0,0,0,0,04/07/2023,0,0,0,0,0,0,0,0,0,0,0,0,0,0,0,0,0,0,0,0
7450,152506,2023,Brazil,France,0,0,0,0,25/06/2023,0,0,0,0,0,0,0,0,0,0,0,0,0,0,0,0,0,0,0,0
7451,152506,2023,Canada,France,0,0,0,0,24/06/2023,0,0,0,0,0,0,0,0,0,0,0,0,0,0,0,0,0,0,0,0
7452,152506,2023,France,Cuba,0,0,0,0,23/06/2023,0,0,0,0,0,0,0,0,0,0,0,0,0,0,0,0,0,0,0,0
7453,152506,2023,Argentina,France,0,0,0,0,21/06/2023,0,0,0,0,0,0,0,0,0,0,0,0,0,0,0,0,0,0,0,0
7454,152506,2023,Japan,France,0,0,0,0,11/06/2023,0,0,5,5,0,0,0,0,0,0,0,0,6,4,15,25,7,1,0,8
7455,152506,2023,France,Slovenia,0,0,0,0,10/06/2023,0,0,8,8,0,0,0,0,0,0,0,0,4,1,10,15,6,0,5,11
7456,152506,2023,China,France,0,0,0,0,09/06/2023,0,0,3,3,0,0,0,0,0,0,0,0,6,1,6,13,13,0,5,18
7457,152506,2023,Poland,France,0,0,0,0,07/06/2023,0,1,5,6,0,0,0,0,0,0,0,0,7,3,12,22,4,0,1,5
7458,142686,2023,USA,France,0,0,0,0,19/07/2023,0,0,1,1,2,0,3,5,0,0,0,0,1,0,0,1,0,1,0,1
7459,142686,2023,France,Germany,0,0,0,0,10/07/2023,0,0,0,0,0,0,0,0,0,0,0,0,0,0,0,0,0,0,0,0
7460,142686,2023,USA,France,0,1,0,1,09/07/2023,0,0,0,0,1,0,1,2,0,0,0,0,1,0,2,3,0,0,0,0
7461,142686,2023,Serbia,France,0,1,4,5,07/07/2023,0,0,0,0,2,0,1,3,0,0,1,1,1,1,6,8,1,2,0,3
7462,142686,2023,Iran,France,3,3,6,12,04/07/2023,0,0,3,3,12,4,4,20,2,2,2,6,2,1,9,12,3,3,1,7
7463,142686,2023,Brazil,France,0,0,1,1,25/06/2023,0,0,1,1,0,0,0,0,0,0,0,0,0,0,0,0,0,0,0,0
7464,142686,2023,Canada,France,0,0,0,0,24/06/2023,0,0,0,0,0,0,0,0,0,0,0,0,0,0,0,0,0,0,0,0
7465,142686,2023,France,Cuba,0,0,0,0,23/06/2023,0,0,0,0,2,0,2,4,0,0,0,0,0,1,0,1,0,0,0,0
7466,142686,2023,Argentina,France,0,1,0,1,21/06/2023,0,0,0,0,0,0,0,0,0,0,0,0,0,0,0,0,0,0,0,0
7467,142686,2023,Japan,France,1,5,10,16,11/06/2023,0,0,3,3,12,4,7,23,0,1,2,3,6,2,15,23,6,2,2,10
7468,142686,2023,France,Slovenia,1,3,12,16,10/06/2023,0,0,4,4,15,8,16,39,0,1,4,5,4,0,17,21,6,0,2,8
7469,142686,2023,China,France,2,1,7,10,09/06/2023,0,0,2,2,14,1,10,25,2,2,1,5,13,0,16,29,11,3,2,16
7470,142686,2023,Poland,France,0,4,13,17,07/06/2023,1,0,4,5,8,4,8,20,0,3,1,4,5,3,27,35,4,0,0,4
7471,136856,2023,USA,France,0,4,2,6,19/07/2023,0,0,0,0,0,0,0,0,0,0,0,0,0,0,0,0,0,0,0,0
7472,136856,2023,France,Germany,0,2,3,5,10/07/2023,0,0,0,0,0,0,0,0,0,0,0,0,0,0,0,0,1,0,0,1
7473,136856,2023,USA,France,1,0,4,5,09/07/2023,0,0,0,0,0,0,0,0,0,0,0,0,0,0,0,0,0,0,0,0
7474,136856,2023,Serbia,France,0,3,3,6,07/07/2023,0,0,0,0,0,0,0,0,0,0,0,0,0,0,0,0,1,0,0,1
7475,136856,2023,Iran,France,2,1,4,7,04/07/2023,0,0,0,0,0,0,0,0,0,0,0,0,0,0,0,0,1,0,0,1
7476,136856,2023,Brazil,France,0,1,1,2,25/06/2023,0,0,0,0,0,0,0,0,0,0,0,0,0,0,0,0,0,0,0,0
7477,136856,2023,Canada,France,0,0,2,2,24/06/2023,0,0,0,0,0,0,0,0,0,0,0,0,0,0,0,0,0,0,0,0
7478,136856,2023,France,Cuba,0,1,2,3,23/06/2023,0,0,0,0,0,0,0,0,0,0,0,0,0,0,0,0,0,0,0,0
7479,136856,2023,Argentina,France,1,4,4,9,21/06/2023,0,0,1,1,1,0,0,1,0,0,0,0,0,0,0,0,1,0,0,1
7480,136856,2023,Japan,France,1,4,12,17,11/06/2023,0,0,0,0,6,1,2,9,2,3,3,8,1,0,1,2,1,0,1,2
7481,136856,2023,France,Slovenia,0,7,8,15,10/06/2023,0,0,0,0,8,1,3,12,2,4,4,10,2,0,2,4,7,0,3,10
7482,136856,2023,China,France,2,5,14,21,09/06/2023,0,0,1,1,2,3,7,12,0,1,2,3,0,0,0,0,2,0,0,2
7483,136856,2023,Poland,France,0,5,9,14,07/06/2023,0,0,0,0,3,2,0,5,1,3,7,11,2,0,1,3,2,0,1,3
7484,119779,2023,France,Germany,1,3,10,14,10/07/2023,0,0,3,3,11,4,4,19,0,1,2,3,4,1,19,24,2,3,0,5
7485,119779,2023,Cuba,Germany,0,1,5,6,08/07/2023,0,0,3,3,6,4,4,14,0,4,2,6,2,0,24,26,2,1,1,4
7486,119779,2023,Argentina,Germany,0,1,3,4,06/07/2023,0,0,1,1,3,1,9,13,0,1,0,1,3,0,8,11,1,0,0,1
7487,119779,2023,Germany,Bulgaria,0,0,12,12,06/07/2023,0,0,2,2,8,2,2,12,0,0,4,4,2,1,15,18,1,1,0,2
7488,152469,2023,France,Germany,0,4,7,11,10/07/2023,27,0,41,68,1,1,0,2,0,0,5,5,0,1,1,2,4,2,0,6
7489,152469,2023,Cuba,Germany,1,2,10,13,08/07/2023,20,0,37,57,0,0,0,0,0,2,3,5,0,0,1,1,5,2,0,7
7490,152469,2023,Argentina,Germany,0,0,3,3,06/07/2023,1,0,7,8,0,0,0,0,0,0,0,0,0,0,0,0,4,1,0,5
7491,152469,2023,Germany,Bulgaria,1,1,10,12,06/07/2023,15,0,42,57,0,0,0,0,1,1,1,3,0,0,0,0,3,1,1,5
7492,152469,2023,China,Germany,1,3,11,15,24/06/2023,25,0,52,77,0,0,1,1,1,0,1,2,0,0,0,0,2,4,0,6
7493,152469,2023,Serbia,Germany,4,1,11,16,22/06/2023,32,0,70,102,0,0,0,0,0,2,2,4,0,0,1,1,4,3,0,7
7494,152469,2023,Germany,Poland,0,2,17,19,21/06/2023,16,0,60,76,0,0,0,0,1,1,1,3,0,0,0,0,5,0,1,6
7495,152469,2023,Iran,Germany,0,3,10,13,20/06/2023,14,1,52,67,0,0,0,0,1,2,0,3,0,0,1,1,1,1,1,3
7496,152469,2023,Canada,Germany,1,2,16,19,11/06/2023,13,1,82,96,0,0,0,0,2,0,1,3,0,0,0,0,4,0,0,4
7497,152469,2023,Germany,Italy,1,0,13,14,10/06/2023,10,1,36,47,0,1,0,1,1,4,1,6,0,0,1,1,3,5,0,8
7498,152469,2023,Netherlands,Germany,0,0,4,4,09/06/2023,6,0,8,14,0,0,0,0,0,1,1,2,0,0,0,0,0,0,1,1
7499,152469,2023,Brazil,Germany,0,0,3,3,08/06/2023,5,0,5,10,0,0,0,0,0,0,0,0,0,0,0,0,1,1,0,2
7500,119775,2023,France,Germany,0,0,1,1,10/07/2023,0,0,0,0,0,0,1,1,0,0,0,0,0,0,0,0,0,0,0,0
7501,119775,2023,Cuba,Germany,0,0,0,0,08/07/2023,0,0,0,0,0,0,0,0,0,0,0,0,0,0,2,2,3,1,0,4
7502,119775,2023,Argentina,Germany,0,0,0,0,06/07/2023,0,0,0,0,0,0,0,0,0,0,0,0,0,0,0,0,0,0,0,0
7503,119775,2023,Germany,Bulgaria,0,0,0,0,06/07/2023,0,0,1,1,0,0,0,0,0,0,0,0,0,0,0,0,0,0,0,0
7504,119775,2023,China,Germany,0,2,1,3,24/06/2023,0,0,1,1,0,2,0,2,0,1,0,1,5,0,4,9,0,2,0,2
7505,119775,2023,Serbia,Germany,0,0,0,0,22/06/2023,0,0,0,0,0,0,0,0,0,0,0,0,0,1,10,11,6,3,0,9
7506,119775,2023,Germany,Poland,0,0,0,0,21/06/2023,0,0,1,1,0,0,0,0,0,0,0,0,0,1,9,10,4,1,1,6
7507,119775,2023,Iran,Germany,0,0,0,0,20/06/2023,0,0,0,0,0,0,0,0,0,0,0,0,0,0,0,0,0,0,0,0
7508,119775,2023,Canada,Germany,0,0,0,0,11/06/2023,0,0,0,0,0,0,0,0,0,0,0,0,0,0,0,0,0,0,0,0
7509,119775,2023,Germany,Italy,2,3,10,15,10/06/2023,0,0,1,1,8,4,8,20,1,2,1,4,1,2,23,26,7,5,0,12
7510,119775,2023,Netherlands,Germany,0,2,1,3,09/06/2023,0,0,1,1,1,1,0,2,0,0,0,0,1,0,2,3,2,0,0,2
7511,119775,2023,Brazil,Germany,0,0,4,4,08/06/2023,0,0,0,0,1,2,3,6,0,1,0,1,0,0,8,8,1,3,0,4
7512,139386,2023,France,Germany,1,2,13,16,10/07/2023,0,0,4,4,7,2,10,19,1,0,6,7,3,2,19,24,6,2,1,9
7513,139386,2023,Cuba,Germany,2,0,15,17,08/07/2023,0,0,6,6,10,4,4,18,0,5,1,6,9,0,10,19,6,3,0,9
7514,139386,2023,Argentina,Germany,0,1,4,5,06/07/2023,0,0,1,1,4,4,3,11,1,1,0,2,3,1,9,13,0,3,0,3
7515,139386,2023,Germany,Bulgaria,2,2,12,16,06/07/2023,0,0,2,2,12,1,7,20,0,2,1,3,0,0,7,7,5,1,0,6
7516,139386,2023,China,Germany,1,2,12,15,24/06/2023,0,0,7,7,10,3,6,19,1,2,2,5,9,1,8,18,3,5,0,8
7517,139386,2023,Serbia,Germany,1,3,11,15,22/06/2023,0,0,3,3,12,3,16,31,1,3,1,5,9,1,22,32,6,3,3,12
7518,139386,2023,Germany,Poland,0,2,12,14,21/06/2023,0,0,1,1,3,4,3,10,0,1,0,1,2,0,9,11,2,2,1,5
7519,139386,2023,Iran,Germany,0,3,5,8,20/06/2023,0,0,0,0,10,3,9,22,1,4,2,7,5,3,18,26,2,2,0,4
7520,139386,2023,Canada,Germany,1,4,13,18,11/06/2023,0,0,0,0,8,6,13,27,1,0,0,1,10,1,18,29,4,1,3,8
7521,139386,2023,Germany,Italy,1,3,6,10,10/06/2023,0,0,5,5,4,5,6,15,0,1,2,3,7,0,18,25,4,3,0,7
7522,139386,2023,Netherlands,Germany,0,3,11,14,09/06/2023,0,0,3,3,10,4,7,21,2,0,0,2,2,5,16,23,5,2,1,8
7523,139386,2023,Brazil,Germany,0,3,11,14,08/06/2023,0,0,7,7,14,4,7,25,0,1,2,3,10,1,18,29,9,6,0,15
7524,182291,2023,France,Germany,0,0,0,0,10/07/2023,0,0,4,4,0,0,0,0,0,0,0,0,6,0,18,24,6,5,0,11
7525,182291,2023,Cuba,Germany,0,0,0,0,08/07/2023,0,0,2,2,0,0,0,0,0,0,0,0,1,1,0,2,5,2,0,7
7526,182291,2023,Argentina,Germany,0,0,0,0,06/07/2023,0,0,3,3,0,0,0,0,0,0,0,0,2,2,10,14,6,5,1,12
7527,182291,2023,Germany,Bulgaria,0,0,0,0,06/07/2023,0,0,2,2,0,0,0,0,0,0,0,0,5,0,14,19,8,3,2,13
7528,182291,2023,China,Germany,0,0,0,0,24/06/2023,0,0,1,1,0,0,0,0,0,0,0,0,3,1,7,11,8,8,2,18
7529,182291,2023,Serbia,Germany,0,0,0,0,22/06/2023,0,0,0,0,0,0,0,0,0,0,0,0,0,0,12,12,1,4,1,6
7530,182291,2023,Germany,Poland,0,0,0,0,21/06/2023,0,0,4,4,0,0,0,0,0,0,0,0,1,2,13,16,2,2,1,5
7531,182291,2023,Iran,Germany,0,0,0,0,20/06/2023,0,0,1,1,0,0,0,0,0,0,0,0,1,3,13,17,7,4,0,11
7532,182291,2023,Canada,Germany,0,0,0,0,11/06/2023,0,0,2,2,0,0,0,0,0,0,1,1,4,0,11,15,21,2,0,23
7533,182291,2023,Germany,Italy,0,0,0,0,10/06/2023,0,0,1,1,0,0,0,0,0,0,0,0,0,0,0,0,2,4,0,6
7534,182291,2023,Netherlands,Germany,0,0,0,0,09/06/2023,0,0,1,1,0,0,0,0,0,0,0,0,0,0,0,0,1,1,0,2
7535,182291,2023,Brazil,Germany,0,0,0,0,08/06/2023,0,0,1,1,0,0,0,0,0,0,0,0,0,0,0,0,4,9,0,13
7536,116575,2023,France,Germany,0,0,5,5,10/07/2023,3,0,12,15,0,0,0,0,0,1,0,1,0,0,0,0,3,1,2,6
7537,116575,2023,Cuba,Germany,0,1,3,4,08/07/2023,3,0,2,5,0,0,0,0,0,0,0,0,0,0,0,0,0,0,0,0
7538,116575,2023,Argentina,Germany,1,2,11,14,06/07/2023,10,0,46,56,0,0,0,0,1,0,3,4,0,0,0,0,3,3,1,7
7539,116575,2023,Germany,Bulgaria,0,1,4,5,06/07/2023,5,1,5,11,0,0,0,0,0,0,0,0,0,0,0,0,3,0,1,4
7540,116575,2023,Canada,Germany,0,1,1,2,11/06/2023,3,0,17,20,0,0,0,0,0,1,0,1,0,0,0,0,0,0,0,0
7541,116575,2023,Germany,Italy,1,2,4,7,10/06/2023,6,0,28,34,1,0,0,1,0,1,1,2,0,0,0,0,4,3,0,7
7542,116575,2023,Netherlands,Germany,0,2,8,10,09/06/2023,6,1,54,61,0,0,0,0,0,2,4,6,0,0,0,0,4,3,0,7
7543,116575,2023,Brazil,Germany,0,3,9,12,08/06/2023,23,1,72,96,1,0,0,1,0,1,0,1,0,0,0,0,3,1,1,5
7544,162081,2023,France,Germany,3,6,7,16,10/07/2023,0,1,1,2,9,5,2,16,2,5,4,11,0,0,1,1,1,1,1,3
7545,162081,2023,Cuba,Germany,2,3,6,11,08/07/2023,0,1,1,2,8,1,5,14,0,5,6,11,0,0,0,0,0,0,0,0
7546,162081,2023,Argentina,Germany,0,3,4,7,06/07/2023,0,0,0,0,1,0,1,2,0,0,1,1,0,0,1,1,0,1,1,2
7547,162081,2023,Germany,Bulgaria,1,1,9,11,06/07/2023,0,0,0,0,4,2,5,11,1,7,4,12,0,0,1,1,0,1,0,1
7548,162081,2023,China,Germany,0,3,10,13,24/06/2023,0,0,0,0,17,0,1,18,0,5,3,8,0,1,5,6,1,0,0,1
7549,162081,2023,Serbia,Germany,1,2,13,16,22/06/2023,0,0,1,1,13,1,2,16,1,7,4,12,1,0,1,2,2,1,0,3
7550,162081,2023,Germany,Poland,0,2,3,5,21/06/2023,0,0,0,0,8,2,2,12,1,4,0,5,0,0,2,2,1,0,0,1
7551,162081,2023,Iran,Germany,0,3,4,7,20/06/2023,0,0,0,0,6,1,3,10,1,3,3,7,0,0,1,1,0,0,1,1
7552,162081,2023,Canada,Germany,1,4,7,12,11/06/2023,0,0,0,0,4,3,5,12,1,2,1,4,0,0,2,2,1,0,3,4
7553,162081,2023,Germany,Italy,0,4,11,15,10/06/2023,0,0,0,0,5,1,4,10,2,2,6,10,1,0,3,4,0,1,0,1
7554,162081,2023,Netherlands,Germany,0,4,10,14,09/06/2023,0,0,0,0,8,1,6,15,3,7,2,12,0,0,0,0,4,3,0,7
7555,162081,2023,Brazil,Germany,3,3,8,14,08/06/2023,0,0,0,0,10,0,6,16,1,3,6,10,0,0,2,2,1,0,0,1
7556,136441,2023,France,Germany,0,0,0,0,10/07/2023,0,0,0,0,0,0,0,0,0,0,0,0,0,0,2,2,0,0,0,0
7557,136441,2023,Cuba,Germany,1,0,1,2,08/07/2023,0,0,0,0,0,0,0,0,0,0,0,0,1,0,1,2,0,0,0,0
7558,136441,2023,Argentina,Germany,1,3,6,10,06/07/2023,0,0,5,5,6,3,4,13,1,0,2,3,4,3,13,20,3,0,0,3
7559,136441,2023,Germany,Bulgaria,0,1,2,3,06/07/2023,0,0,1,1,0,0,0,0,0,0,0,0,0,0,2,2,1,1,0,2
7560,136441,2023,China,Germany,1,2,5,8,24/06/2023,0,0,2,2,5,5,12,22,0,2,1,3,12,2,11,25,1,3,1,5
7561,136441,2023,Serbia,Germany,1,3,9,13,22/06/2023,0,0,7,7,7,3,6,16,1,1,3,5,7,1,14,22,7,4,1,12
7562,136441,2023,Germany,Poland,0,2,8,10,21/06/2023,0,0,4,4,3,4,2,9,2,0,2,4,1,2,7,10,5,4,3,12
7563,136441,2023,Iran,Germany,0,1,2,3,20/06/2023,0,0,1,1,0,2,2,4,0,0,0,0,0,0,2,2,0,1,0,1
7564,136441,2023,Canada,Germany,0,1,1,2,11/06/2023,0,0,0,0,0,0,0,0,0,0,0,0,0,0,0,0,0,0,0,0
7565,136441,2023,Germany,Italy,0,0,0,0,10/06/2023,0,1,3,4,0,0,0,0,0,0,0,0,2,3,11,16,5,4,1,10
7566,136441,2023,Netherlands,Germany,0,0,0,0,09/06/2023,0,0,6,6,0,0,0,0,0,0,0,0,3,1,19,23,2,0,0,2
7567,136441,2023,Brazil,Germany,0,0,0,0,08/06/2023,0,0,2,2,0,0,0,0,0,0,0,0,6,2,12,20,6,5,0,11
7568,162790,2023,France,Germany,0,0,0,0,10/07/2023,0,0,0,0,0,0,0,0,0,0,0,0,0,0,0,0,0,0,0,0
7569,162790,2023,Cuba,Germany,0,0,0,0,08/07/2023,0,0,0,0,0,0,0,0,0,0,0,0,0,0,0,0,0,0,0,0
7570,162790,2023,Argentina,Germany,0,0,2,2,06/07/2023,0,0,1,1,0,2,0,2,2,2,2,6,0,1,0,1,0,0,0,0
7571,162790,2023,Germany,Bulgaria,0,1,9,10,06/07/2023,0,0,2,2,7,0,2,9,0,6,3,9,0,0,1,1,0,0,1,1
7572,162790,2023,China,Germany,0,0,10,10,24/06/2023,0,0,1,1,5,1,3,9,1,5,1,7,0,0,1,1,1,1,0,2
7573,162790,2023,Serbia,Germany,1,0,9,10,22/06/2023,0,0,0,0,6,1,5,12,1,5,3,9,0,1,0,1,2,1,1,4
7574,162790,2023,Germany,Poland,1,1,14,16,21/06/2023,0,0,3,3,3,2,2,7,4,6,7,17,0,0,1,1,3,0,0,3
7575,162790,2023,Iran,Germany,0,0,0,0,20/06/2023,0,0,0,0,0,0,0,0,0,2,0,2,0,0,0,0,0,0,0,0
7576,162790,2023,Canada,Germany,0,0,1,1,11/06/2023,0,0,0,0,2,0,0,2,0,0,0,0,0,0,0,0,0,0,0,0
7577,162790,2023,Germany,Italy,0,0,0,0,10/06/2023,0,0,0,0,0,0,0,0,0,0,0,0,0,0,0,0,0,0,0,0
7578,162790,2023,Netherlands,Germany,0,0,0,0,09/06/2023,0,0,0,0,0,0,0,0,0,0,0,0,0,0,0,0,0,0,0,0
7579,162790,2023,Brazil,Germany,0,0,0,0,08/06/2023,0,0,0,0,0,0,0,0,0,0,0,0,0,0,0,0,0,0,0,0
7580,162082,2023,France,Germany,1,5,5,11,10/07/2023,0,0,0,0,17,5,4,26,0,2,0,2,0,0,0,0,1,2,1,4
7581,162082,2023,Cuba,Germany,3,4,4,11,08/07/2023,0,0,0,0,11,6,3,20,1,3,4,8,0,0,0,0,2,2,0,4
7582,162082,2023,Argentina,Germany,0,2,4,6,06/07/2023,0,0,2,2,11,5,6,22,2,5,1,8,0,0,0,0,3,2,0,5
7583,162082,2023,Germany,Bulgaria,0,1,3,4,06/07/2023,0,0,0,0,11,2,9,22,1,3,1,5,0,0,0,0,4,1,0,5
7584,162082,2023,China,Germany,0,0,0,0,24/06/2023,0,0,0,0,0,0,0,0,0,0,0,0,0,0,0,0,0,0,0,0
7585,162082,2023,Serbia,Germany,2,8,4,14,22/06/2023,0,0,0,0,12,8,11,31,1,3,4,8,0,0,0,0,5,1,1,7
7586,162082,2023,Germany,Poland,0,2,3,5,21/06/2023,0,0,0,0,10,0,7,17,0,2,1,3,0,0,0,0,2,0,1,3
7587,162082,2023,Iran,Germany,2,4,5,11,20/06/2023,0,0,1,1,6,5,3,14,0,2,0,2,0,0,0,0,5,1,0,6
7588,162082,2023,Canada,Germany,1,0,1,2,11/06/2023,0,0,0,0,3,1,2,6,0,0,0,0,0,0,0,0,0,1,0,1
7589,162082,2023,Germany,Italy,0,2,7,9,10/06/2023,0,0,1,1,17,5,10,32,2,3,6,11,0,1,0,1,4,2,0,6
7590,162082,2023,Netherlands,Germany,0,3,5,8,09/06/2023,0,0,1,1,7,8,3,18,1,2,4,7,0,0,0,0,4,4,0,8
7591,162082,2023,Brazil,Germany,0,4,6,10,08/06/2023,0,0,0,0,20,8,8,36,1,4,1,6,0,0,0,0,5,2,1,8
7592,152349,2023,France,Germany,0,0,12,12,10/07/2023,0,0,0,0,6,1,2,9,2,0,4,6,0,0,0,0,1,0,0,1
7593,152349,2023,Cuba,Germany,0,0,10,10,08/07/2023,0,0,0,0,5,0,3,8,2,2,3,7,0,0,1,1,2,0,0,2
7594,152349,2023,Argentina,Germany,0,1,8,9,06/07/2023,0,1,2,3,2,1,3,6,1,4,5,10,0,0,0,0,1,0,0,1
7595,152349,2023,Germany,Bulgaria,0,0,0,0,06/07/2023,0,0,0,0,0,0,0,0,0,0,0,0,0,0,0,0,0,0,0,0
7596,152349,2023,China,Germany,0,0,0,0,24/06/2023,0,0,0,0,0,0,0,0,0,0,0,0,0,0,0,0,0,0,0,0
7597,152349,2023,Serbia,Germany,0,1,4,5,22/06/2023,0,0,0,0,4,2,1,7,1,1,0,2,0,0,0,0,0,0,0,0
7598,152349,2023,Germany,Poland,0,1,3,4,21/06/2023,0,0,0,0,1,2,2,5,0,6,3,9,0,0,0,0,0,0,0,0
7599,152349,2023,Iran,Germany,0,0,9,9,20/06/2023,0,0,0,0,8,1,3,12,0,7,4,11,0,0,4,4,3,0,0,3
7600,152349,2023,Canada,Germany,0,2,10,12,11/06/2023,0,0,0,0,9,1,0,10,4,2,0,6,0,0,1,1,2,0,0,2
7601,152349,2023,Germany,Italy,0,0,3,3,10/06/2023,0,0,0,0,0,0,0,0,1,1,0,2,0,0,2,2,0,1,0,1
7602,152349,2023,Netherlands,Germany,0,0,9,9,09/06/2023,0,0,1,1,3,0,1,4,1,4,2,7,0,0,0,0,4,0,1,5
7603,152349,2023,Brazil,Germany,0,2,2,4,08/06/2023,0,0,0,0,2,1,2,5,1,1,2,4,0,0,0,0,3,1,0,4
7604,163592,2023,France,Germany,0,0,0,0,10/07/2023,0,0,0,0,0,0,0,0,0,0,0,0,0,0,0,0,0,0,0,0
7605,163592,2023,Cuba,Germany,0,0,0,0,08/07/2023,0,0,0,0,0,0,0,0,0,0,0,0,0,0,0,0,0,0,0,0
7606,163592,2023,Argentina,Germany,0,0,0,0,06/07/2023,0,0,0,0,0,0,0,0,0,0,0,0,0,0,0,0,0,0,0,0
7607,163592,2023,Germany,Bulgaria,0,0,0,0,06/07/2023,0,0,0,0,0,0,0,0,0,0,0,0,0,0,0,0,0,0,0,0
7608,163592,2023,China,Germany,0,1,3,4,24/06/2023,0,0,0,0,2,2,1,5,0,2,0,2,4,0,6,10,1,2,0,3
7609,163592,2023,Serbia,Germany,0,0,0,0,22/06/2023,0,0,0,0,0,0,0,0,0,0,0,0,0,0,0,0,0,0,0,0
7610,163592,2023,Germany,Poland,0,0,3,3,21/06/2023,0,0,0,0,1,2,5,8,1,1,0,2,2,0,6,8,0,1,0,1
7611,163592,2023,Iran,Germany,0,3,7,10,20/06/2023,0,0,3,3,8,3,5,16,0,1,1,2,5,0,7,12,5,0,0,5
7612,163592,2023,Canada,Germany,0,1,11,12,11/06/2023,0,0,0,0,18,0,12,30,2,2,1,5,11,0,13,24,8,1,1,10
7613,163592,2023,Germany,Italy,0,0,1,1,10/06/2023,0,0,0,0,0,0,0,0,0,0,0,0,0,0,0,0,0,0,0,0
7614,163592,2023,Netherlands,Germany,0,1,0,1,09/06/2023,0,0,0,0,1,2,3,6,0,0,0,0,0,1,1,2,0,0,0,0
7615,163592,2023,Brazil,Germany,0,0,0,0,08/06/2023,0,0,0,0,0,0,0,0,0,0,0,0,0,0,0,0,0,0,0,0
7616,152352,2023,France,Germany,0,0,0,0,10/07/2023,0,0,0,0,0,0,0,0,0,0,0,0,0,0,0,0,0,0,0,0
7617,152352,2023,Cuba,Germany,0,0,0,0,08/07/2023,0,0,0,0,0,0,0,0,0,0,0,0,0,0,0,0,0,0,0,0
7618,152352,2023,Argentina,Germany,0,0,0,0,06/07/2023,0,0,0,0,0,0,0,0,0,0,0,0,0,0,0,0,0,0,0,0
7619,152352,2023,Germany,Bulgaria,0,0,0,0,06/07/2023,0,0,0,0,0,0,0,0,0,0,0,0,0,0,0,0,0,0,0,0
7620,152352,2023,Canada,Germany,0,0,0,0,11/06/2023,0,0,0,0,0,0,0,0,0,0,0,0,0,0,0,0,0,0,0,0
7621,152352,2023,Germany,Italy,0,1,8,9,10/06/2023,0,0,1,1,3,0,3,6,2,4,3,9,0,1,0,1,3,0,0,3
7622,152352,2023,Netherlands,Germany,0,0,0,0,09/06/2023,0,0,0,0,0,0,0,0,0,0,0,0,0,0,0,0,0,0,0,0
7623,152352,2023,Brazil,Germany,0,3,5,8,08/06/2023,0,0,0,0,3,1,2,6,1,0,2,3,0,0,0,0,2,1,0,3
7624,184322,2023,France,Germany,0,0,3,3,10/07/2023,0,0,0,0,0,1,4,5,1,2,0,3,0,0,0,0,0,0,0,0
7625,184322,2023,Cuba,Germany,0,0,0,0,08/07/2023,0,0,0,0,0,0,0,0,1,0,0,1,0,0,0,0,0,0,0,0
7626,184322,2023,Argentina,Germany,0,0,0,0,06/07/2023,0,0,1,1,1,0,4,5,0,1,1,2,0,0,0,0,1,0,0,1
7627,184322,2023,Germany,Bulgaria,0,0,0,0,06/07/2023,0,0,0,0,1,0,3,4,0,0,1,1,0,0,0,0,0,0,0,0
7628,184322,2023,China,Germany,0,1,0,1,24/06/2023,0,0,1,1,0,0,2,2,0,1,0,1,0,0,0,0,0,0,0,0
7629,184322,2023,Serbia,Germany,0,1,0,1,22/06/2023,0,0,1,1,1,1,3,5,0,1,0,1,0,0,0,0,0,0,0,0
7630,184322,2023,Germany,Poland,0,2,3,5,21/06/2023,0,0,0,0,10,5,4,19,3,3,2,8,0,0,0,0,3,0,2,5
7631,184322,2023,Iran,Germany,0,0,1,1,20/06/2023,0,0,0,0,2,1,0,3,0,0,0,0,0,0,0,0,0,0,0,0
7632,184322,2023,Canada,Germany,0,0,13,13,11/06/2023,0,0,0,0,19,4,8,31,0,2,0,2,0,0,0,0,7,2,0,9
7633,184322,2023,Germany,Italy,0,1,0,1,10/06/2023,0,0,0,0,2,1,0,3,1,0,0,1,0,0,0,0,0,2,0,2
7634,184322,2023,Netherlands,Germany,0,1,2,3,09/06/2023,0,0,0,0,4,0,4,8,0,1,2,3,0,0,0,0,1,1,0,2
7635,184322,2023,Brazil,Germany,0,1,1,2,08/06/2023,0,0,0,0,1,0,2,3,0,0,0,0,0,0,0,0,0,0,0,0
7636,163173,2023,Cuba,Iran,0,0,0,0,09/07/2023,0,0,0,0,0,0,0,0,0,0,0,0,0,0,0,0,1,0,0,1
7637,163173,2023,Argentina,Iran,0,3,13,16,09/07/2023,0,0,1,1,6,2,3,11,1,7,6,14,1,0,1,2,1,1,1,3
7638,163173,2023,Bulgaria,Iran,0,0,9,9,07/07/2023,0,0,0,0,0,1,2,3,0,3,1,4,0,0,1,1,1,0,0,1
7639,163173,2023,Iran,France,0,0,14,14,04/07/2023,0,0,0,0,6,0,4,10,0,1,1,2,0,0,0,0,0,1,0,1
7640,163173,2023,Netherlands,Iran,0,0,0,0,24/06/2023,0,0,0,0,0,0,0,0,0,1,0,1,0,0,0,0,0,0,0,0
7641,163173,2023,Iran,USA,0,0,0,0,23/06/2023,0,0,0,0,0,0,0,0,0,0,0,0,0,0,0,0,0,0,0,0
7642,163173,2023,Iran,Italy,0,0,0,0,21/06/2023,0,0,0,0,0,0,0,0,0,0,0,0,0,0,0,0,0,0,0,0
7643,163173,2023,Iran,Germany,0,0,0,0,20/06/2023,0,0,0,0,0,0,0,0,0,0,0,0,0,0,0,0,0,0,0,0
7644,163173,2023,Slovenia,Iran,0,0,0,0,11/06/2023,0,0,0,0,0,0,0,0,0,0,0,0,0,0,0,0,0,0,0,0
7645,163173,2023,Iran,China,0,0,0,0,10/06/2023,0,0,0,0,0,0,0,0,0,0,0,0,0,0,0,0,0,0,0,0
7646,163173,2023,Poland,Iran,0,0,0,0,08/06/2023,0,0,0,0,0,0,0,0,0,0,0,0,0,0,0,0,0,0,0,0
7647,163173,2023,Japan,Iran,0,0,0,0,06/06/2023,0,0,0,0,0,0,0,0,0,0,0,0,0,0,0,0,0,0,0,0
7648,118827,2023,Cuba,Iran,0,4,9,13,09/07/2023,0,0,2,2,11,3,4,18,3,9,4,16,0,0,1,1,2,2,1,5
7649,118827,2023,Argentina,Iran,0,0,0,0,09/07/2023,0,0,0,0,0,0,0,0,0,0,0,0,0,0,0,0,0,0,0,0
7650,118827,2023,Bulgaria,Iran,0,5,7,12,07/07/2023,0,0,0,0,6,2,5,13,7,8,10,25,1,0,0,1,4,0,0,4
7651,118827,2023,Iran,France,0,5,3,8,04/07/2023,0,0,1,1,3,1,3,7,4,6,5,15,0,1,2,3,1,0,0,1
7652,118827,2023,Netherlands,Iran,1,1,18,20,24/06/2023,0,1,0,1,5,3,2,10,5,8,4,17,0,0,1,1,1,2,1,4
7653,118827,2023,Iran,USA,0,3,7,10,23/06/2023,0,0,6,6,6,2,1,9,2,4,2,8,0,0,2,2,2,0,0,2
7654,118827,2023,Iran,Italy,0,2,6,8,21/06/2023,0,0,1,1,4,1,0,5,1,2,2,5,0,0,2,2,2,0,1,3
7655,118827,2023,Iran,Germany,1,3,6,10,20/06/2023,0,0,1,1,4,0,1,5,4,3,1,8,1,0,0,1,0,0,0,0
7656,118827,2023,Slovenia,Iran,0,3,4,7,11/06/2023,0,0,0,0,1,1,2,4,0,3,2,5,2,0,1,3,4,0,0,4
7657,118827,2023,Iran,China,0,2,15,17,10/06/2023,0,0,6,6,5,2,3,10,1,3,1,5,0,0,0,0,4,0,0,4
7658,118827,2023,Poland,Iran,1,5,10,16,08/06/2023,0,0,1,1,4,2,6,12,4,5,3,12,0,0,0,0,0,0,0,0
7659,118827,2023,Japan,Iran,0,3,5,8,06/06/2023,0,0,2,2,4,1,4,9,4,4,4,12,2,0,2,4,3,0,0,3
7660,163176,2023,Cuba,Iran,0,0,0,0,09/07/2023,0,0,0,0,0,0,0,0,0,0,0,0,0,0,0,0,0,0,0,0
7661,163176,2023,Argentina,Iran,0,0,0,0,09/07/2023,0,0,11,11,0,0,0,0,0,0,0,0,4,1,11,16,8,3,4,15
7662,163176,2023,Bulgaria,Iran,0,0,0,0,07/07/2023,0,0,0,0,0,0,0,0,0,0,0,0,0,0,0,0,0,0,0,0
7663,163176,2023,Iran,France,0,0,0,0,04/07/2023,0,0,2,2,0,0,0,0,0,0,0,0,2,2,10,14,7,1,0,8
7664,163176,2023,Netherlands,Iran,0,0,0,0,24/06/2023,0,0,5,5,0,0,0,0,0,0,0,0,3,3,13,19,12,2,0,14
7665,163176,2023,Iran,USA,0,0,0,0,23/06/2023,0,0,3,3,0,0,0,0,0,0,0,0,3,1,7,11,4,1,0,5
7666,163176,2023,Iran,Italy,0,0,0,0,21/06/2023,0,0,5,5,0,0,0,0,0,0,0,0,1,2,9,12,8,2,0,10
7667,163176,2023,Iran,Germany,0,0,0,0,20/06/2023,0,0,3,3,0,0,0,0,0,0,0,0,1,2,11,14,1,4,2,7
7668,163176,2023,Slovenia,Iran,0,0,0,0,11/06/2023,0,0,7,7,0,0,0,0,0,0,0,0,2,2,10,14,8,1,1,10
7669,163176,2023,Iran,China,0,0,0,0,10/06/2023,0,0,7,7,0,0,0,0,0,0,0,0,8,1,9,18,10,0,1,11
7670,163176,2023,Poland,Iran,0,0,0,0,08/06/2023,0,0,7,7,0,0,0,0,0,0,0,0,9,1,15,25,10,0,2,12
7671,163176,2023,Japan,Iran,0,0,0,0,06/06/2023,0,0,10,10,0,0,0,0,0,0,0,0,6,2,5,13,3,0,1,4
7672,153535,2023,Cuba,Iran,0,0,0,0,09/07/2023,0,0,9,9,0,0,0,0,0,0,0,0,4,1,13,18,6,4,1,11
7673,153535,2023,Argentina,Iran,0,0,0,0,09/07/2023,0,0,0,0,0,0,0,0,0,0,0,0,0,0,0,0,0,0,0,0
7674,153535,2023,Bulgaria,Iran,0,0,0,0,07/07/2023,0,0,4,4,0,0,0,0,0,0,0,0,3,2,4,9,8,4,0,12
7675,153535,2023,Iran,France,0,0,0,0,04/07/2023,0,0,3,3,0,0,0,0,0,0,0,0,0,0,0,0,0,0,0,0
7676,152752,2023,Cuba,Iran,3,4,19,26,09/07/2023,0,0,1,1,12,10,12,34,1,3,1,5,5,5,16,26,4,3,0,7
7677,152752,2023,Argentina,Iran,1,4,15,20,09/07/2023,0,0,2,2,9,2,13,24,3,1,1,5,4,3,33,40,2,1,0,3
7678,152752,2023,Bulgaria,Iran,1,1,9,11,07/07/2023,0,0,1,1,6,3,8,17,2,1,2,5,8,0,9,17,0,5,1,6
7679,152752,2023,Iran,France,1,3,6,10,04/07/2023,0,0,1,1,5,1,4,10,1,2,0,3,9,1,21,31,3,1,0,4
7680,152752,2023,Netherlands,Iran,1,4,10,15,24/06/2023,0,0,2,2,4,6,7,17,1,3,1,5,9,2,24,35,3,3,1,7
7681,152752,2023,Iran,USA,1,0,4,5,23/06/2023,0,0,1,1,2,0,0,2,0,0,0,0,2,3,10,15,0,1,0,1
7682,152752,2023,Iran,Italy,0,1,2,3,21/06/2023,0,0,1,1,4,0,3,7,0,1,2,3,2,0,8,10,0,0,0,0
7683,152752,2023,Iran,Germany,0,0,0,0,20/06/2023,0,0,0,0,0,0,0,0,0,0,0,0,0,0,0,0,0,0,0,0
7684,152752,2023,Slovenia,Iran,0,2,3,5,11/06/2023,0,0,1,1,5,4,6,15,1,1,1,3,6,1,6,13,6,1,0,7
7685,152752,2023,Iran,China,0,1,0,1,10/06/2023,0,0,0,0,0,0,0,0,0,0,0,0,0,0,0,0,0,0,0,0
7686,152752,2023,Poland,Iran,0,0,0,0,08/06/2023,0,0,0,0,0,0,0,0,0,0,0,0,0,0,0,0,0,0,0,0
7687,152752,2023,Japan,Iran,0,0,1,1,06/06/2023,0,0,0,0,1,2,2,5,0,0,1,1,1,0,4,5,3,0,0,3
7688,152753,2023,Cuba,Iran,0,2,14,16,09/07/2023,31,0,70,101,1,0,1,2,0,2,2,4,0,0,0,0,2,3,0,5
7689,152753,2023,Argentina,Iran,0,1,8,9,09/07/2023,3,0,18,21,0,0,0,0,0,0,1,1,0,0,0,0,3,1,0,4
7690,152753,2023,Bulgaria,Iran,0,0,4,4,07/07/2023,5,0,17,22,0,0,0,0,0,1,0,1,0,0,0,0,0,0,0,0
7691,152753,2023,Iran,France,0,0,2,2,04/07/2023,1,0,8,9,0,0,0,0,0,1,0,1,0,0,0,0,0,1,0,1
7692,182470,2023,Bulgaria,Iran,0,1,1,2,07/07/2023,0,0,0,0,3,1,2,6,0,1,2,3,0,0,5,5,1,1,0,2
7693,182470,2023,Iran,France,0,0,1,1,04/07/2023,0,0,0,0,0,0,0,0,0,0,0,0,0,0,1,1,0,1,0,1
7694,182470,2023,Netherlands,Iran,1,1,7,9,24/06/2023,0,0,1,1,4,3,6,13,0,1,0,1,3,4,9,16,3,1,0,4
7695,182470,2023,Iran,USA,0,3,6,9,23/06/2023,0,0,4,4,9,5,3,17,0,0,1,1,1,4,11,16,5,2,0,7
7696,182470,2023,Iran,Italy,0,0,5,5,21/06/2023,0,0,1,1,3,2,3,8,0,0,1,1,3,1,5,9,2,2,1,5
7697,182470,2023,Iran,Germany,1,2,9,12,20/06/2023,0,0,2,2,6,2,4,12,1,1,1,3,0,0,14,14,7,2,0,9
7698,182470,2023,Slovenia,Iran,0,1,4,5,11/06/2023,0,0,0,0,3,0,3,6,0,0,0,0,3,4,2,9,1,0,2,3
7699,182470,2023,Iran,China,1,0,14,15,10/06/2023,0,0,2,2,14,2,2,18,1,1,3,5,3,1,16,20,3,0,0,3
7700,182470,2023,Poland,Iran,1,3,18,22,08/06/2023,0,0,2,2,12,4,9,25,2,0,2,4,7,4,31,42,5,0,0,5
7701,182470,2023,Japan,Iran,0,2,1,3,06/06/2023,0,0,0,0,1,2,4,7,0,0,0,0,2,1,7,10,1,0,2,3
7702,123413,2023,Cuba,Iran,0,2,17,19,09/07/2023,0,0,2,2,10,1,3,14,0,0,1,1,14,1,29,44,5,4,0,9
7703,123413,2023,Argentina,Iran,0,0,2,2,09/07/2023,0,0,0,0,2,0,2,4,1,0,0,1,2,0,4,6,1,0,0,1
7704,123413,2023,Bulgaria,Iran,1,1,3,5,07/07/2023,0,0,0,0,0,0,0,0,0,0,0,0,1,0,2,3,0,0,0,0
7705,123413,2023,Iran,France,0,0,0,0,04/07/2023,0,0,0,0,0,0,0,0,0,0,0,0,0,0,0,0,0,0,0,0
7706,123413,2023,Netherlands,Iran,0,0,1,1,24/06/2023,0,0,0,0,0,0,0,0,0,0,0,0,0,0,4,4,0,0,1,1
7707,123413,2023,Iran,USA,0,1,1,2,23/06/2023,0,0,0,0,1,1,1,3,0,0,0,0,0,1,1,2,1,0,0,1
7708,123413,2023,Iran,Italy,0,1,3,4,21/06/2023,0,0,0,0,0,1,1,2,0,0,0,0,0,0,3,3,2,0,0,2
7709,123413,2023,Iran,Germany,0,1,5,6,20/06/2023,0,0,2,2,1,0,0,1,0,0,0,0,1,0,0,1,0,0,0,0
7710,123413,2023,Slovenia,Iran,0,0,1,1,11/06/2023,0,0,0,0,0,0,0,0,0,0,0,0,0,0,0,0,0,0,0,0
7711,123413,2023,Iran,China,0,0,0,0,10/06/2023,0,0,0,0,2,0,0,2,0,0,1,1,2,1,6,9,1,0,1,2
7712,123413,2023,Poland,Iran,0,0,1,1,08/06/2023,0,0,0,0,0,0,2,2,0,0,0,0,3,0,2,5,0,0,0,0
7713,123413,2023,Japan,Iran,0,0,3,3,06/06/2023,0,0,1,1,0,0,0,0,0,0,1,1,1,0,4,5,1,0,0,1
7714,189602,2023,Cuba,Iran,0,0,0,0,09/07/2023,0,0,0,0,0,0,0,0,0,0,0,0,0,0,0,0,0,0,0,0
7715,189602,2023,Argentina,Iran,0,0,0,0,09/07/2023,0,0,0,0,1,2,2,5,0,2,0,2,0,0,0,0,1,0,0,1
7716,189602,2023,Bulgaria,Iran,0,0,0,0,07/07/2023,0,0,0,0,0,0,0,0,0,0,0,0,0,0,0,0,0,0,0,0
7717,189602,2023,Iran,France,0,0,0,0,04/07/2023,0,0,0,0,0,0,0,0,0,0,0,0,0,0,0,0,0,0,0,0
7718,168551,2023,Cuba,Iran,0,3,17,20,09/07/2023,0,0,1,1,14,6,11,31,3,5,3,11,0,0,0,0,5,5,1,11
7719,168551,2023,Argentina,Iran,0,4,1,5,09/07/2023,0,0,3,3,8,6,3,17,0,2,3,5,0,0,0,0,2,1,0,3
7720,168551,2023,Bulgaria,Iran,0,2,5,7,07/07/2023,0,0,0,0,7,2,5,14,0,1,2,3,0,0,0,0,0,0,0,0
7721,168551,2023,Iran,France,0,2,3,5,04/07/2023,0,0,0,0,4,2,4,10,0,0,3,3,0,0,0,0,0,3,1,4
7722,152755,2023,Cuba,Iran,0,0,0,0,09/07/2023,0,0,0,0,0,0,0,0,0,0,0,0,0,0,0,0,0,0,0,0
7723,152755,2023,Argentina,Iran,0,4,11,15,09/07/2023,17,0,71,88,1,0,2,3,1,3,0,4,0,1,0,1,7,2,2,11
7724,152755,2023,Bulgaria,Iran,0,3,6,9,07/07/2023,12,0,58,70,3,0,1,4,1,1,1,3,0,0,0,0,1,1,2,4
7725,152755,2023,Iran,France,0,2,4,6,04/07/2023,18,0,34,52,2,0,1,3,0,1,1,2,0,0,0,0,3,8,2,13
7726,152755,2023,Netherlands,Iran,0,0,0,0,24/06/2023,4,0,2,6,0,0,0,0,0,0,0,0,0,0,0,0,0,0,0,0
7727,152755,2023,Iran,USA,0,0,0,0,23/06/2023,0,0,0,0,0,0,0,0,0,0,0,0,0,0,0,0,0,0,0,0
7728,152755,2023,Iran,Italy,0,0,0,0,21/06/2023,1,0,6,7,1,0,0,1,0,1,0,1,0,0,0,0,1,0,0,1
7729,152755,2023,Iran,Germany,0,0,0,0,20/06/2023,0,0,2,2,0,0,0,0,0,0,0,0,0,0,0,0,0,1,0,1
7730,152755,2023,Slovenia,Iran,0,1,2,3,11/06/2023,2,1,19,22,1,0,0,1,2,0,0,2,0,0,0,0,0,0,0,0
7731,152755,2023,Iran,China,1,3,9,13,10/06/2023,13,1,58,72,4,0,1,5,1,4,2,7,0,0,1,1,5,0,1,6
7732,152755,2023,Poland,Iran,0,3,8,11,08/06/2023,15,1,66,82,1,0,3,4,0,0,1,1,0,0,1,1,1,0,0,1
7733,152755,2023,Japan,Iran,1,2,4,7,06/06/2023,1,0,40,41,0,0,1,1,0,0,1,1,0,0,1,1,2,0,0,2
7734,174373,2023,Cuba,Iran,0,0,19,19,09/07/2023,0,0,1,1,9,0,4,13,3,5,1,9,0,0,0,0,2,1,1,4
7735,174373,2023,Argentina,Iran,0,1,14,15,09/07/2023,0,0,1,1,1,1,2,4,4,4,9,17,0,0,0,0,3,1,1,5
7736,174373,2023,Bulgaria,Iran,1,0,12,13,07/07/2023,0,0,1,1,2,0,1,3,1,2,3,6,0,0,1,1,2,0,0,2
7737,174373,2023,Iran,France,0,0,0,0,04/07/2023,0,0,0,0,0,0,0,0,0,0,0,0,0,0,0,0,0,0,0,0
7738,174373,2023,Netherlands,Iran,1,1,13,15,24/06/2023,0,0,0,0,9,1,2,12,1,4,4,9,0,0,0,0,3,0,2,5
7739,174373,2023,Iran,USA,0,0,14,14,23/06/2023,0,0,0,0,3,0,2,5,1,0,2,3,0,0,1,1,1,1,1,3
7740,174373,2023,Iran,Italy,0,1,10,11,21/06/2023,0,0,0,0,6,2,3,11,0,4,7,11,1,0,0,1,3,2,1,6
7741,174373,2023,Iran,Germany,1,1,11,13,20/06/2023,0,0,1,1,1,0,5,6,4,3,4,11,0,0,2,2,1,0,1,2
7742,174373,2023,Slovenia,Iran,0,0,14,14,11/06/2023,0,0,1,1,3,1,2,6,0,2,2,4,0,0,0,0,3,0,1,4
7743,174373,2023,Iran,China,1,1,14,16,10/06/2023,0,0,1,1,2,2,3,7,6,5,2,13,0,0,1,1,4,0,1,5
7744,174373,2023,Poland,Iran,0,2,15,17,08/06/2023,0,0,0,0,7,1,1,9,1,4,3,8,0,0,1,1,4,0,4,8
7745,174373,2023,Japan,Iran,1,0,9,10,06/06/2023,0,0,0,0,3,1,2,6,0,2,2,4,1,0,0,1,1,0,1,2
7746,152742,2023,Argentina,Iran,1,7,11,19,09/07/2023,0,0,2,2,14,8,16,38,1,5,2,8,8,0,22,30,4,0,1,5
7747,152742,2023,Bulgaria,Iran,0,4,11,15,07/07/2023,0,0,4,4,10,5,3,18,0,3,2,5,11,2,33,46,4,5,0,9
7748,152742,2023,Iran,France,0,2,9,11,04/07/2023,0,0,0,0,8,4,5,17,0,0,1,1,0,2,7,9,3,1,1,5
7749,152742,2023,Netherlands,Iran,0,0,1,1,24/06/2023,0,0,1,1,4,3,2,9,0,1,0,1,2,0,5,7,0,0,0,0
7750,152742,2023,Iran,USA,0,0,6,6,23/06/2023,0,0,0,0,4,2,3,9,1,2,1,4,2,3,7,12,2,0,0,2
7751,152742,2023,Iran,Italy,1,2,9,12,21/06/2023,0,0,1,1,7,4,8,19,0,1,0,1,2,3,10,15,3,3,4,10
7752,152742,2023,Iran,Germany,1,2,8,11,20/06/2023,0,0,1,1,10,0,4,14,0,1,3,4,2,0,13,15,4,2,1,7
7753,152742,2023,Slovenia,Iran,1,1,10,12,11/06/2023,0,0,0,0,6,3,7,16,0,4,4,8,3,2,11,16,4,0,2,6
7754,152742,2023,Iran,China,0,1,7,8,10/06/2023,0,0,0,0,12,0,10,22,0,2,0,2,2,0,6,8,5,0,0,5
7755,152742,2023,Poland,Iran,0,2,3,5,08/06/2023,0,1,0,1,6,0,3,9,1,0,0,1,0,0,5,5,2,0,0,2
7756,152742,2023,Japan,Iran,0,3,6,9,06/06/2023,0,0,2,2,3,1,6,10,1,3,0,4,1,0,9,10,2,0,0,2
7757,163174,2023,Cuba,Iran,0,0,0,0,09/07/2023,0,0,0,0,0,0,0,0,0,0,0,0,0,0,0,0,0,0,0,0
7758,171191,2023,Japan,Italy,4,3,13,20,23/07/2023,0,0,8,8,11,4,9,24,1,2,4,7,4,1,27,32,12,3,1,16
7759,171191,2023,USA,Italy,0,1,8,9,22/07/2023,0,0,5,5,9,2,13,24,0,0,2,2,1,1,24,26,5,2,1,8
7760,171191,2023,Italy,Argentina,1,1,14,16,19/07/2023,0,0,2,2,13,2,4,19,1,1,0,2,1,0,9,10,7,1,0,8
7761,171191,2023,Japan,Italy,1,2,12,15,08/07/2023,0,0,3,3,12,4,6,22,1,0,2,3,7,2,16,25,2,3,1,6
7762,171191,2023,Slovenia,Italy,1,1,8,10,07/07/2023,0,0,3,3,9,1,9,19,2,1,2,5,0,0,9,9,2,3,0,5
7763,171191,2023,Canada,Italy,1,3,15,19,06/07/2023,0,0,10,10,14,1,13,28,3,2,2,7,4,2,16,22,8,2,0,10
7764,171191,2023,Brazil,Italy,3,3,12,18,04/07/2023,0,0,8,8,14,2,10,26,0,5,2,7,3,0,23,26,8,4,0,12
7765,171191,2023,Italy,Poland,0,3,10,13,25/06/2023,0,0,9,9,11,6,12,29,3,3,2,8,3,3,19,25,8,2,0,10
7766,171191,2023,Serbia,Italy,0,0,11,11,23/06/2023,0,0,6,6,8,2,3,13,1,0,4,5,4,1,10,15,3,2,0,5
7767,171191,2023,China,Italy,1,0,12,13,22/06/2023,0,0,2,2,2,1,1,4,3,0,0,3,1,0,7,8,1,0,0,1
7768,171191,2023,Iran,Italy,1,2,5,8,21/06/2023,0,0,3,3,12,0,10,22,2,3,1,6,3,0,5,8,4,2,0,6
7769,144005,2023,Japan,Italy,2,3,12,17,23/07/2023,34,1,62,97,6,1,0,7,0,3,4,7,0,0,2,2,6,1,0,7
7770,144005,2023,USA,Italy,0,1,10,11,22/07/2023,23,0,46,69,2,0,1,3,0,1,1,2,0,0,0,0,8,4,0,12
7771,144005,2023,Italy,Argentina,0,1,11,12,19/07/2023,18,0,43,61,2,0,1,3,2,0,4,6,0,0,0,0,4,1,0,5
7772,144005,2023,Japan,Italy,0,1,15,16,08/07/2023,39,0,62,101,1,3,2,6,2,3,8,13,0,0,1,1,3,3,1,7
7773,144005,2023,Slovenia,Italy,0,1,13,14,07/07/2023,27,0,43,70,3,0,3,6,0,3,1,4,0,0,0,0,10,1,0,11
7774,144005,2023,Canada,Italy,2,1,16,19,06/07/2023,33,0,67,100,4,0,4,8,1,3,2,6,0,0,0,0,14,2,1,17
7775,144005,2023,Brazil,Italy,1,2,16,19,04/07/2023,16,0,60,76,1,0,0,1,2,3,5,10,0,0,1,1,6,3,2,11
7776,144005,2023,Italy,Poland,1,3,14,18,25/06/2023,29,1,64,94,2,0,3,5,2,5,7,14,0,0,2,2,5,1,1,7
7777,144005,2023,Serbia,Italy,0,0,13,13,23/06/2023,22,0,30,52,3,1,0,4,1,3,1,5,0,0,0,0,8,2,0,10
7778,144005,2023,China,Italy,1,1,15,17,22/06/2023,16,0,33,49,2,0,0,2,0,2,1,3,0,0,0,0,2,1,1,4
7779,144005,2023,Iran,Italy,1,3,9,13,21/06/2023,20,0,49,69,1,1,1,3,4,3,3,10,0,0,1,1,7,0,2,9
7780,150436,2023,Japan,Italy,0,0,0,0,23/07/2023,0,0,6,6,0,0,0,0,0,0,0,0,7,2,12,21,11,3,0,14
7781,150436,2023,USA,Italy,0,0,0,0,22/07/2023,0,1,6,7,0,0,0,0,0,0,0,0,5,1,14,20,5,3,0,8
7782,150436,2023,Italy,Argentina,0,0,0,0,19/07/2023,0,0,3,3,0,0,0,0,0,0,0,0,3,0,9,12,7,4,0,11
7783,150436,2023,Germany,Italy,0,0,0,0,10/06/2023,0,0,11,11,0,0,0,0,0,0,0,0,8,2,17,27,11,4,0,15
7784,150436,2023,Italy,Cuba,0,0,0,0,09/06/2023,0,0,7,7,0,0,0,0,0,0,0,0,5,0,14,19,14,1,1,16
7785,150436,2023,Italy,USA,0,0,0,0,08/06/2023,0,0,8,8,0,0,0,0,0,0,0,0,4,1,11,16,12,2,3,17
7786,150436,2023,Italy,Argentina,0,0,0,0,06/06/2023,0,0,12,12,0,0,0,0,0,0,0,0,3,0,9,12,10,1,3,14
7787,152370,2023,Japan,Italy,0,0,0,0,23/07/2023,0,0,0,0,0,0,0,0,0,0,0,0,0,0,0,0,0,0,0,0
7788,152370,2023,USA,Italy,0,1,0,1,22/07/2023,2,0,1,3,0,0,0,0,0,0,0,0,0,0,0,0,0,0,0,0
7789,152370,2023,Italy,Argentina,0,0,0,0,19/07/2023,0,0,0,0,0,0,0,0,0,0,0,0,0,0,0,0,0,0,0,0
7790,152370,2023,Japan,Italy,0,1,2,3,08/07/2023,0,0,1,1,0,0,0,0,0,0,0,0,0,0,0,0,0,0,0,0
7791,152370,2023,Slovenia,Italy,0,0,0,0,07/07/2023,0,0,0,0,0,0,0,0,0,0,0,0,0,0,0,0,0,0,0,0
7792,152370,2023,Canada,Italy,0,1,3,4,06/07/2023,0,0,0,0,0,0,0,0,0,0,0,0,0,0,0,0,0,1,0,1
7793,152370,2023,Brazil,Italy,0,0,0,0,04/07/2023,0,0,0,0,0,0,0,0,0,0,0,0,0,0,0,0,0,0,0,0
7794,152370,2023,Italy,Poland,0,0,1,1,25/06/2023,0,0,2,2,0,0,0,0,1,0,0,1,0,0,0,0,0,0,0,0
7795,152370,2023,Serbia,Italy,0,0,1,1,23/06/2023,0,0,0,0,0,0,0,0,0,0,0,0,0,0,0,0,0,0,0,0
7796,152370,2023,China,Italy,0,1,0,1,22/06/2023,2,0,4,6,0,0,0,0,0,1,0,1,0,0,0,0,0,0,0,0
7797,152370,2023,Iran,Italy,0,0,1,1,21/06/2023,0,0,0,0,0,0,0,0,0,0,0,0,0,0,0,0,0,0,0,0
7798,181128,2023,Japan,Italy,0,0,0,0,23/07/2023,0,0,0,0,0,0,0,0,0,0,0,0,0,0,0,0,0,0,0,0
7799,181128,2023,USA,Italy,0,0,0,0,22/07/2023,0,0,0,0,0,0,0,0,0,0,0,0,0,0,0,0,0,0,0,0
7800,181128,2023,Italy,Argentina,0,0,0,0,19/07/2023,0,0,0,0,0,0,0,0,0,0,0,0,0,0,0,0,0,0,0,0
7801,181128,2023,Japan,Italy,0,0,0,0,08/07/2023,0,0,2,2,0,0,0,0,0,0,0,0,0,0,0,0,9,2,0,11
7802,181128,2023,Slovenia,Italy,0,0,0,0,07/07/2023,0,0,4,4,0,0,0,0,0,0,0,0,0,0,0,0,3,2,0,5
7803,181128,2023,Canada,Italy,0,0,0,0,06/07/2023,0,0,3,3,0,0,0,0,0,0,0,0,3,2,10,15,7,2,2,11
7804,181128,2023,Brazil,Italy,0,0,0,0,04/07/2023,0,0,2,2,0,0,0,0,0,0,0,0,0,0,0,0,4,2,1,7
7805,181128,2023,Italy,Poland,0,0,0,0,25/06/2023,0,0,6,6,0,0,0,0,0,0,0,0,6,1,15,22,5,3,1,9
7806,181128,2023,Serbia,Italy,0,0,0,0,23/06/2023,0,0,3,3,0,0,0,0,0,0,0,0,2,0,5,7,4,1,1,6
7807,181128,2023,China,Italy,0,0,0,0,22/06/2023,0,0,2,2,0,0,0,0,0,0,0,0,2,0,7,9,2,1,0,3
7808,181128,2023,Iran,Italy,0,0,0,0,21/06/2023,0,0,5,5,0,0,0,0,0,0,0,0,11,0,12,23,14,4,3,21
7809,163447,2023,Japan,Italy,0,0,0,0,23/07/2023,0,0,0,0,0,0,0,0,0,0,0,0,0,0,0,0,0,0,0,0
7810,163447,2023,USA,Italy,0,0,0,0,22/07/2023,0,0,0,0,0,0,0,0,0,0,0,0,0,0,0,0,0,0,0,0
7811,163447,2023,Italy,Argentina,0,0,0,0,19/07/2023,0,0,0,0,0,0,0,0,0,0,0,0,0,0,0,0,0,0,0,0
7812,163447,2023,Japan,Italy,0,0,0,0,08/07/2023,0,0,0,0,0,0,0,0,0,0,0,0,0,0,0,0,0,0,0,0
7813,163447,2023,Slovenia,Italy,0,0,0,0,07/07/2023,0,0,0,0,0,0,0,0,0,0,0,0,0,0,0,0,0,0,0,0
7814,163447,2023,Canada,Italy,0,0,0,0,06/07/2023,0,0,0,0,0,0,0,0,0,0,0,0,0,0,0,0,0,0,0,0
7815,163447,2023,Brazil,Italy,0,0,0,0,04/07/2023,0,0,0,0,0,0,0,0,0,0,0,0,0,0,0,0,0,0,0,0
7816,163447,2023,Germany,Italy,1,4,15,20,10/06/2023,0,0,2,2,11,4,11,26,1,2,3,6,2,3,26,31,12,2,0,14
7817,163447,2023,Italy,Cuba,1,2,9,12,09/06/2023,0,0,2,2,15,6,5,26,1,3,0,4,3,0,15,18,6,2,0,8
7818,163447,2023,Italy,USA,0,2,2,4,08/06/2023,0,0,1,1,8,2,8,18,0,2,1,3,1,3,10,14,1,1,0,2
7819,163447,2023,Italy,Argentina,0,0,3,3,06/06/2023,0,0,0,0,3,1,0,4,0,0,0,0,0,1,1,2,0,0,0,0
7820,152408,2023,Japan,Italy,1,3,8,12,23/07/2023,0,0,0,0,3,0,5,8,5,9,6,20,0,0,1,1,0,0,0,0
7821,152408,2023,USA,Italy,3,4,4,11,22/07/2023,0,0,0,0,5,1,3,9,1,4,4,9,0,0,0,0,0,0,0,0
7822,152408,2023,Italy,Argentina,1,2,10,13,19/07/2023,0,0,0,0,4,0,2,6,1,2,4,7,0,0,0,0,3,1,0,4
7823,152408,2023,Japan,Italy,0,3,9,12,08/07/2023,0,0,2,2,6,0,3,9,5,4,6,15,0,1,2,3,3,0,0,3
7824,152408,2023,Slovenia,Italy,0,3,3,6,07/07/2023,0,0,0,0,5,0,6,11,1,3,4,8,0,0,1,1,4,0,2,6
7825,152408,2023,Canada,Italy,2,5,4,11,06/07/2023,0,0,1,1,10,0,1,11,3,5,7,15,0,0,0,0,1,0,0,1
7826,152408,2023,Brazil,Italy,1,3,6,10,04/07/2023,0,0,1,1,7,0,1,8,4,6,8,18,0,0,1,1,3,0,1,4
7827,152408,2023,Italy,Poland,0,1,3,4,25/06/2023,0,0,1,1,0,0,5,5,0,0,1,1,0,0,1,1,1,0,0,1
7828,152408,2023,Serbia,Italy,0,0,0,0,23/06/2023,0,0,0,0,0,0,0,0,0,0,0,0,0,0,0,0,0,0,0,0
7829,152408,2023,China,Italy,0,3,8,11,22/06/2023,0,0,0,0,3,2,0,5,0,4,1,5,0,0,0,0,0,0,0,0
7830,152408,2023,Iran,Italy,0,1,5,6,21/06/2023,0,0,1,1,3,1,2,6,2,6,2,10,0,0,0,0,2,0,0,2
7831,153200,2023,Japan,Italy,0,3,12,15,23/07/2023,0,0,3,3,11,4,16,31,3,4,6,13,4,4,16,24,6,1,0,7
7832,153200,2023,USA,Italy,0,3,5,8,22/07/2023,0,0,5,5,8,3,12,23,1,5,2,8,2,1,13,16,4,2,0,6
7833,153200,2023,Italy,Argentina,0,0,8,8,19/07/2023,0,0,5,5,11,1,10,22,1,3,4,8,6,2,6,14,3,3,0,6
7834,153200,2023,Japan,Italy,1,3,16,20,08/07/2023,0,0,2,2,15,0,18,33,2,5,1,8,14,3,13,30,4,3,1,8
7835,153200,2023,Slovenia,Italy,1,0,12,13,07/07/2023,0,0,2,2,7,3,10,20,5,2,3,10,8,1,15,24,5,0,1,6
7836,153200,2023,Canada,Italy,0,2,12,14,06/07/2023,0,0,5,5,10,2,17,29,1,2,0,3,7,2,22,31,8,2,0,10
7837,153200,2023,Brazil,Italy,2,2,16,20,04/07/2023,0,0,2,2,8,2,16,26,0,1,4,5,1,2,16,19,4,1,0,5
7838,153200,2023,Italy,Poland,1,3,9,13,25/06/2023,0,0,2,2,15,2,16,33,2,3,5,10,6,3,14,23,7,1,1,9
7839,153200,2023,Serbia,Italy,0,0,12,12,23/06/2023,0,0,4,4,5,2,5,12,2,1,3,6,3,0,16,19,4,0,0,4
7840,153200,2023,China,Italy,0,2,5,7,22/06/2023,0,0,4,4,9,3,8,20,2,3,1,6,6,0,8,14,1,3,1,5
7841,153200,2023,Iran,Italy,1,0,18,19,21/06/2023,0,0,4,4,9,0,12,21,1,2,3,6,4,1,16,21,4,1,0,5
7842,162520,2023,Japan,Italy,0,4,9,13,23/07/2023,0,1,1,2,14,4,17,35,1,5,7,13,0,0,0,0,4,1,2,7
7843,162520,2023,USA,Italy,1,2,1,4,22/07/2023,0,0,2,2,4,6,13,23,1,3,3,7,0,0,0,0,2,0,1,3
7844,162520,2023,Italy,Argentina,0,4,3,7,19/07/2023,0,0,2,2,10,3,6,19,1,2,1,4,0,0,0,0,8,2,0,10
7845,162520,2023,Japan,Italy,3,5,15,23,08/07/2023,0,0,1,1,16,6,5,27,3,5,2,10,0,0,1,1,5,2,3,10
7846,162520,2023,Slovenia,Italy,3,1,7,11,07/07/2023,0,0,2,2,11,5,12,28,2,3,5,10,0,0,0,0,3,2,1,6
7847,162520,2023,Canada,Italy,1,5,10,16,06/07/2023,0,0,2,2,16,6,19,41,1,6,8,15,0,0,1,1,5,8,0,13
7848,162520,2023,Brazil,Italy,4,3,9,16,04/07/2023,0,0,1,1,16,1,14,31,0,4,5,9,0,0,0,0,4,2,2,8
7849,162520,2023,Italy,Poland,1,4,11,16,25/06/2023,0,0,2,2,17,5,14,36,0,6,6,12,0,0,1,1,7,2,0,9
7850,162520,2023,Serbia,Italy,2,1,8,11,23/06/2023,0,0,1,1,13,4,8,25,0,6,4,10,0,0,0,0,2,2,0,4
7851,162520,2023,China,Italy,0,0,6,6,22/06/2023,0,0,1,1,8,1,5,14,4,1,1,6,0,1,1,2,3,0,0,3
7852,162520,2023,Iran,Italy,2,4,9,15,21/06/2023,0,0,0,0,11,5,7,23,1,0,0,1,0,0,0,0,1,2,1,4
7853,162520,2023,Germany,Italy,2,7,9,18,10/06/2023,0,0,1,1,14,5,15,34,1,2,2,5,0,0,1,1,4,2,1,7
7854,162520,2023,Italy,Cuba,2,3,14,19,09/06/2023,0,0,1,1,15,3,12,30,0,0,6,6,0,0,0,0,2,2,0,4
7855,162520,2023,Italy,USA,0,3,4,7,08/06/2023,0,0,0,0,8,5,10,23,0,5,1,6,0,0,0,0,3,1,0,4
7856,162520,2023,Italy,Argentina,1,3,6,10,06/06/2023,0,1,2,3,12,5,10,27,1,1,2,4,0,0,0,0,5,1,1,7
7857,163032,2023,Japan,Italy,0,0,0,0,23/07/2023,0,0,0,0,0,0,0,0,0,0,0,0,0,0,0,0,0,0,0,0
7858,163032,2023,USA,Italy,0,0,4,4,22/07/2023,0,0,1,1,0,1,2,3,0,0,0,0,0,0,0,0,0,2,0,2
7859,163032,2023,Italy,Argentina,0,0,0,0,19/07/2023,0,0,0,0,0,0,0,0,0,0,0,0,0,0,0,0,0,0,0,0
7860,163032,2023,Italy,Poland,0,1,1,2,25/06/2023,0,0,0,0,0,0,0,0,0,0,0,0,0,0,0,0,0,0,0,0
7861,163032,2023,Serbia,Italy,0,0,0,0,23/06/2023,0,0,0,0,0,0,0,0,0,0,0,0,0,0,0,0,0,0,0,0
7862,163032,2023,China,Italy,0,1,1,2,22/06/2023,0,0,0,0,1,0,2,3,0,0,0,0,0,0,0,0,1,0,0,1
7863,163032,2023,Iran,Italy,0,0,0,0,21/06/2023,0,0,0,0,0,0,0,0,0,0,0,0,0,0,0,0,0,0,0,0
7864,163032,2023,Germany,Italy,0,0,1,1,10/06/2023,0,0,0,0,0,0,0,0,0,0,0,0,0,0,0,0,0,0,0,0
7865,163032,2023,Italy,Cuba,0,0,0,0,09/06/2023,0,0,0,0,0,0,0,0,0,0,1,1,0,0,0,0,0,0,0,0
7866,163032,2023,Italy,USA,0,0,1,1,08/06/2023,0,0,0,0,1,0,1,2,0,0,2,2,0,0,0,0,0,0,0,0
7867,163032,2023,Italy,Argentina,0,1,2,3,06/06/2023,0,1,0,1,1,2,2,5,0,0,0,0,0,0,0,0,0,0,0,0
7868,152405,2023,Japan,Italy,0,2,19,21,23/07/2023,0,0,3,3,8,3,4,15,3,4,9,16,0,0,3,3,1,1,0,2
7869,152405,2023,USA,Italy,0,1,8,9,22/07/2023,0,0,0,0,5,1,3,9,3,2,5,10,1,0,2,3,3,0,0,3
7870,152405,2023,Italy,Argentina,3,0,14,17,19/07/2023,0,0,0,0,4,1,1,6,3,4,2,9,0,0,1,1,5,0,1,6
7871,152405,2023,Japan,Italy,0,2,8,10,08/07/2023,0,0,0,0,6,0,4,10,0,6,2,8,0,0,1,1,2,0,0,2
7872,152405,2023,Slovenia,Italy,1,2,13,16,07/07/2023,0,0,2,2,3,1,3,7,4,3,8,15,0,0,0,0,3,2,1,6
7873,152405,2023,Canada,Italy,2,2,23,27,06/07/2023,0,0,2,2,11,2,3,16,2,4,6,12,0,0,0,0,3,1,0,4
7874,152405,2023,Brazil,Italy,2,1,14,17,04/07/2023,0,0,2,2,4,0,2,6,1,5,7,13,0,0,1,1,2,0,0,2
7875,152405,2023,Italy,Poland,0,3,11,14,25/06/2023,0,0,0,0,8,0,5,13,0,6,5,11,0,0,2,2,4,0,1,5
7876,152405,2023,Serbia,Italy,3,0,15,18,23/06/2023,0,0,0,0,5,1,2,8,6,6,3,15,0,0,1,1,2,2,1,5
7877,152405,2023,China,Italy,0,0,0,0,22/06/2023,0,0,0,0,0,0,0,0,0,0,0,0,0,0,0,0,0,0,0,0
7878,152405,2023,Iran,Italy,2,4,6,12,21/06/2023,0,0,0,0,5,0,6,11,2,2,1,5,0,0,0,0,1,0,0,1
7879,172962,2023,Japan,Italy,0,0,2,2,23/07/2023,0,0,0,0,0,0,0,0,0,0,0,0,0,2,1,3,0,0,0,0
7880,172962,2023,USA,Italy,0,0,0,0,22/07/2023,0,0,0,0,0,0,0,0,0,0,0,0,0,0,0,0,0,0,0,0
7881,172962,2023,Italy,Argentina,0,0,0,0,19/07/2023,0,0,0,0,0,0,0,0,0,0,0,0,0,0,0,0,0,0,0,0
7882,172962,2023,Japan,Italy,0,1,2,3,08/07/2023,0,0,1,1,5,1,4,10,0,3,2,5,1,0,6,7,2,0,0,2
7883,172962,2023,Slovenia,Italy,0,0,0,0,07/07/2023,0,0,0,0,0,0,0,0,0,0,0,0,0,0,0,0,0,0,0,0
7884,172962,2023,Canada,Italy,0,0,0,0,06/07/2023,0,0,0,0,0,0,0,0,0,0,0,0,0,0,0,0,0,0,0,0
7885,172962,2023,Brazil,Italy,0,0,0,0,04/07/2023,0,0,0,0,0,0,0,0,0,0,0,0,0,0,0,0,0,0,0,0
7886,172962,2023,Italy,Poland,0,0,0,0,25/06/2023,0,0,0,0,0,0,0,0,0,0,0,0,1,0,1,2,0,0,0,0
7887,172962,2023,Serbia,Italy,0,0,0,0,23/06/2023,0,0,0,0,0,0,0,0,0,0,0,0,0,0,0,0,0,0,0,0
7888,172962,2023,China,Italy,1,0,4,5,22/06/2023,0,0,0,0,3,1,7,11,0,0,1,1,1,0,9,10,2,1,0,3
7889,172962,2023,Iran,Italy,0,0,0,0,21/06/2023,0,0,0,0,0,0,0,0,0,0,0,0,0,0,0,0,0,0,0,0
7890,172962,2023,Germany,Italy,1,3,11,15,10/06/2023,0,0,3,3,16,5,9,30,1,3,1,5,0,0,11,11,6,9,2,17
7891,172962,2023,Italy,Cuba,0,3,15,18,09/06/2023,0,0,0,0,9,4,9,22,2,3,3,8,3,3,19,25,4,1,0,5
7892,172962,2023,Italy,USA,1,1,10,12,08/06/2023,0,0,1,1,8,1,7,16,0,1,1,2,1,2,14,17,4,1,0,5
7893,172962,2023,Italy,Argentina,0,2,6,8,06/06/2023,0,0,1,1,6,3,11,20,0,1,0,1,0,1,9,10,4,2,0,6
7894,174076,2023,Japan,Italy,0,0,0,0,23/07/2023,0,0,0,0,0,0,0,0,0,0,0,0,0,0,0,0,0,0,0,0
7895,174076,2023,USA,Italy,0,0,0,0,22/07/2023,0,0,0,0,0,0,0,0,0,0,0,0,0,0,0,0,0,0,0,0
7896,174076,2023,Italy,Argentina,0,0,0,0,19/07/2023,0,0,0,0,0,0,0,0,0,0,0,0,0,0,0,0,0,0,0,0
7897,174076,2023,Japan,Italy,0,0,0,0,08/07/2023,0,0,0,0,0,0,0,0,0,0,0,0,0,0,0,0,0,0,0,0
7898,174076,2023,Slovenia,Italy,0,0,0,0,07/07/2023,0,0,0,0,0,0,0,0,0,0,0,0,0,0,0,0,0,0,0,0
7899,174076,2023,Canada,Italy,0,0,0,0,06/07/2023,0,0,0,0,0,0,0,0,0,0,0,0,0,0,0,0,0,0,0,0
7900,174076,2023,Brazil,Italy,0,0,0,0,04/07/2023,0,0,0,0,0,0,0,0,0,0,0,0,0,0,0,0,0,0,0,0
7901,174076,2023,Germany,Italy,3,4,9,16,10/06/2023,0,0,1,1,4,0,2,6,1,5,1,7,0,0,0,0,3,0,0,3
7902,174076,2023,Italy,Cuba,1,6,5,12,09/06/2023,0,0,1,1,7,1,1,9,3,0,3,6,0,0,0,0,1,0,0,1
7903,174076,2023,Italy,USA,1,0,3,4,08/06/2023,0,0,0,0,1,0,2,3,0,1,3,4,0,0,0,0,1,0,0,1
7904,174076,2023,Italy,Argentina,0,0,2,2,06/06/2023,0,0,0,0,0,1,0,1,0,0,2,2,0,0,0,0,0,0,0,0
7905,174074,2023,Japan,Italy,0,0,0,0,23/07/2023,0,0,0,0,0,0,0,0,0,0,0,0,0,0,0,0,0,0,0,0
7906,174074,2023,USA,Italy,0,0,0,0,22/07/2023,0,0,0,0,0,0,0,0,0,0,0,0,0,0,0,0,0,0,0,0
7907,174074,2023,Italy,Argentina,0,0,0,0,19/07/2023,0,0,0,0,0,0,0,0,0,0,0,0,0,0,0,0,0,0,0,0
7908,174074,2023,Japan,Italy,0,0,2,2,08/07/2023,0,0,0,0,1,0,0,1,0,3,0,3,0,0,0,0,0,0,0,0
7909,174074,2023,Slovenia,Italy,0,0,0,0,07/07/2023,0,0,0,0,0,0,0,0,0,0,0,0,0,0,0,0,0,0,0,0
7910,174074,2023,Canada,Italy,0,0,0,0,06/07/2023,0,0,0,0,0,0,0,0,1,0,0,1,0,0,0,0,0,0,0,0
7911,174074,2023,Brazil,Italy,0,0,0,0,04/07/2023,0,0,0,0,0,0,0,0,0,0,0,0,0,0,0,0,0,0,0,0
7912,174074,2023,Germany,Italy,0,0,12,12,10/06/2023,0,0,0,0,7,0,1,8,2,1,3,6,0,0,0,0,0,1,0,1
7913,174074,2023,Italy,Cuba,0,2,11,13,09/06/2023,0,0,4,4,2,1,0,3,2,6,2,10,0,0,1,1,0,1,0,1
7914,174074,2023,Italy,USA,0,1,4,5,08/06/2023,0,1,0,1,1,1,4,6,1,0,1,2,0,1,0,1,0,0,0,0
7915,174074,2023,Italy,Argentina,0,0,7,7,06/06/2023,0,0,0,0,6,1,1,8,1,0,1,2,0,0,0,0,1,2,0,3
7916,142565,2023,Japan,Italy,1,1,11,13,23/07/2023,0,0,0,0,2,0,3,5,0,3,4,7,0,0,0,0,1,1,0,2
7917,142565,2023,Japan,Poland,0,3,8,11,22/07/2023,0,0,0,0,8,0,8,16,2,8,2,12,2,0,0,2,4,0,0,4
7918,142565,2023,Japan,Slovenia,0,1,18,19,20/07/2023,0,0,2,2,5,0,6,11,1,3,4,8,0,0,2,2,4,1,0,5
7919,142565,2023,Japan,Poland,0,0,3,3,09/07/2023,0,0,0,0,1,0,2,3,0,2,1,3,1,0,0,1,1,0,0,1
7920,142565,2023,Japan,Italy,1,1,11,13,08/07/2023,0,0,1,1,6,1,4,11,0,6,5,11,2,0,2,4,0,0,0,0
7921,142565,2023,Japan,Netherlands,0,3,8,11,07/07/2023,0,0,0,0,3,1,4,8,3,4,1,8,0,0,1,1,2,0,0,2
7922,142565,2023,Japan,China,1,2,17,20,04/07/2023,0,0,2,2,5,2,3,10,1,4,5,10,0,0,1,1,1,1,1,3
7923,142565,2023,Japan,Argentina,0,3,13,16,24/06/2023,0,0,2,2,8,0,2,10,0,2,1,3,1,0,2,3,3,1,1,5
7924,142565,2023,Japan,Brazil,0,2,13,15,22/06/2023,0,0,0,0,4,1,4,9,3,3,2,8,1,0,0,1,2,3,0,5
7925,142565,2023,Japan,Cuba,0,0,9,9,21/06/2023,0,0,0,0,7,0,0,7,1,2,1,4,0,0,1,1,2,2,0,4
7926,142565,2023,Japan,Canada,0,1,7,8,20/06/2023,0,0,1,1,9,0,2,11,3,3,2,8,0,0,0,0,2,0,0,2
7927,142565,2023,Japan,France,0,2,10,12,11/06/2023,0,0,0,0,5,1,1,7,1,4,5,10,0,1,1,2,3,0,0,3
7928,142565,2023,Japan,Bulgaria,0,4,10,14,10/06/2023,0,0,2,2,8,2,3,13,1,0,2,3,2,1,0,3,2,0,2,4
7929,142565,2023,Japan,Serbia,0,1,11,12,09/06/2023,0,0,0,0,5,1,1,7,1,5,2,8,0,0,0,0,3,0,0,3
7930,142565,2023,Japan,Iran,1,0,10,11,06/06/2023,0,0,2,2,2,0,1,3,1,4,4,9,0,0,0,0,2,0,0,2
7931,163038,2023,Japan,Italy,7,5,11,23,23/07/2023,0,1,1,2,12,7,11,30,1,1,6,8,0,0,0,0,10,2,0,12
7932,163038,2023,Japan,Poland,0,2,16,18,22/07/2023,0,0,1,1,13,6,6,25,0,0,2,2,0,0,1,1,3,3,0,6
7933,163038,2023,Japan,Slovenia,0,0,0,0,20/07/2023,0,0,0,0,1,0,1,2,0,1,0,1,0,0,0,0,0,0,0,0
7934,163038,2023,Japan,Poland,0,2,2,4,09/07/2023,0,0,0,0,3,2,8,13,0,2,1,3,0,0,0,0,0,2,0,2
7935,163038,2023,Japan,Italy,1,0,1,2,08/07/2023,0,0,0,0,0,0,0,0,0,0,0,0,0,0,0,0,0,0,0,0
7936,163038,2023,Japan,Netherlands,2,1,10,13,07/07/2023,0,0,0,0,9,7,6,22,1,2,0,3,0,0,0,0,4,2,1,7
7937,163038,2023,Japan,China,1,3,4,8,04/07/2023,0,0,1,1,14,3,3,20,0,2,0,2,0,0,0,0,2,2,1,5
7938,163038,2023,Japan,Argentina,0,5,18,23,24/06/2023,0,1,0,1,27,5,7,39,1,6,2,9,0,0,0,0,2,2,1,5
7939,163038,2023,Japan,Brazil,1,8,10,19,22/06/2023,0,0,1,1,22,9,6,37,1,2,3,6,0,0,0,0,5,7,0,12
7940,163038,2023,Japan,Cuba,0,1,0,1,21/06/2023,0,0,1,1,0,0,0,0,0,0,0,0,0,0,0,0,0,0,0,0
7941,163038,2023,Japan,Canada,0,1,0,1,20/06/2023,0,0,0,0,2,1,1,4,0,1,0,1,0,0,0,0,0,0,0,0
7942,163038,2023,Japan,France,2,1,3,6,11/06/2023,0,0,1,1,10,1,1,12,1,3,0,4,0,0,0,0,1,0,0,1
7943,163038,2023,Japan,Bulgaria,0,0,0,0,10/06/2023,0,0,0,0,0,0,0,0,0,0,0,0,0,0,0,0,0,0,0,0
7944,163038,2023,Japan,Serbia,1,1,0,2,09/06/2023,0,0,0,0,0,0,0,0,0,0,0,0,0,0,0,0,0,0,0,0
7945,163038,2023,Japan,Iran,0,0,0,0,06/06/2023,0,0,0,0,3,1,0,4,0,1,0,1,0,0,0,0,2,0,0,2
7946,163516,2023,Japan,Italy,0,0,2,2,23/07/2023,0,0,2,2,1,2,4,7,0,2,0,2,1,1,8,10,3,2,1,6
7947,163516,2023,Japan,Poland,0,0,1,1,22/07/2023,0,0,0,0,0,0,0,0,0,0,0,0,0,0,0,0,0,0,0,0
7948,163516,2023,Japan,Slovenia,0,0,0,0,20/07/2023,0,0,0,0,0,0,0,0,0,0,0,0,0,0,0,0,0,0,0,0
7949,163516,2023,Japan,Poland,0,1,7,8,09/07/2023,0,0,4,4,11,2,9,22,0,1,2,3,2,2,16,20,3,2,0,5
7950,163516,2023,Japan,Italy,0,2,13,15,08/07/2023,0,0,5,5,14,4,9,27,0,0,1,1,8,3,30,41,10,0,0,10
7951,163516,2023,Japan,Netherlands,0,1,0,1,07/07/2023,0,0,0,0,0,0,0,0,0,0,0,0,0,0,0,0,0,0,0,0
7952,163516,2023,Japan,China,0,0,1,1,04/07/2023,0,0,0,0,2,1,3,6,0,0,0,0,0,0,5,5,0,0,0,0
7953,163516,2023,Japan,Argentina,0,0,1,1,24/06/2023,0,0,0,0,0,0,0,0,0,0,0,0,0,0,0,0,0,0,0,0
7954,163516,2023,Japan,Brazil,0,0,1,1,22/06/2023,0,0,0,0,2,0,2,4,0,2,1,3,1,0,1,2,0,0,0,0
7955,163516,2023,Japan,Cuba,0,0,0,0,21/06/2023,0,0,0,0,0,0,0,0,0,0,0,0,0,0,0,0,0,0,0,0
7956,163516,2023,Japan,Canada,0,0,0,0,20/06/2023,0,0,0,0,0,0,0,0,0,0,0,0,0,0,0,0,0,0,0,0
7957,163516,2023,Japan,France,0,0,0,0,11/06/2023,0,0,0,0,0,0,0,0,0,0,0,0,0,0,0,0,0,0,0,0
7958,163516,2023,Japan,Bulgaria,0,0,0,0,10/06/2023,0,0,0,0,1,0,0,1,0,0,0,0,0,0,0,0,0,0,0,0
7959,163516,2023,Japan,Serbia,0,0,0,0,09/06/2023,0,0,0,0,0,0,0,0,0,0,0,0,0,0,0,0,0,0,0,0
7960,146409,2023,Japan,Italy,1,1,11,13,23/07/2023,0,0,2,2,7,0,5,12,2,1,6,9,1,0,4,5,2,0,1,3
7961,146409,2023,Japan,Poland,0,1,6,7,22/07/2023,0,0,0,0,2,0,3,5,0,4,3,7,0,0,0,0,0,1,0,1
7962,146409,2023,Japan,Slovenia,0,1,5,6,20/07/2023,0,0,1,1,5,2,5,12,1,3,4,8,0,0,0,0,1,0,0,1
7963,146409,2023,Japan,Poland,0,0,0,0,09/07/2023,0,0,0,0,0,0,0,0,0,0,0,0,0,0,0,0,0,0,0,0
7964,146409,2023,Japan,Italy,0,1,15,16,08/07/2023,0,0,2,2,3,1,3,7,0,1,3,4,0,0,0,0,1,1,0,2
7965,146409,2023,Japan,Netherlands,0,1,9,10,07/07/2023,0,0,0,0,10,2,1,13,3,2,3,8,1,0,0,1,0,0,0,0
7966,146409,2023,Japan,China,0,1,10,11,04/07/2023,0,0,0,0,4,1,2,7,1,4,1,6,0,0,0,0,1,0,0,1
7967,146409,2023,Japan,Argentina,0,3,17,20,24/06/2023,0,0,0,0,7,1,4,12,1,4,6,11,0,0,0,0,0,1,0,1
7968,146409,2023,Japan,Brazil,1,2,10,13,22/06/2023,0,0,0,0,1,2,5,8,0,5,0,5,0,0,0,0,1,2,0,3
7969,146409,2023,Japan,Cuba,0,1,14,15,21/06/2023,0,0,0,0,8,0,3,11,1,2,0,3,0,0,0,0,0,2,0,2
7970,146409,2023,Japan,Canada,2,0,26,28,20/06/2023,0,0,3,3,4,2,4,10,1,5,1,7,0,0,0,0,2,1,2,5
7971,146409,2023,Japan,France,0,0,0,0,11/06/2023,0,0,0,0,0,0,0,0,0,0,0,0,0,0,0,0,0,0,0,0
7972,146409,2023,Japan,Bulgaria,0,0,0,0,10/06/2023,0,0,0,0,0,0,0,0,0,0,0,0,0,0,0,0,0,0,0,0
7973,146409,2023,Japan,Serbia,0,0,5,5,09/06/2023,0,0,0,0,0,1,1,2,0,3,0,3,0,0,0,0,1,0,0,1
7974,146409,2023,Japan,Iran,0,0,6,6,06/06/2023,0,0,0,0,7,1,2,10,2,3,2,7,1,0,0,1,2,0,0,2
7975,133009,2023,Japan,Italy,0,1,21,22,23/07/2023,33,0,77,110,0,0,1,1,0,0,0,0,0,0,0,0,8,7,4,19
7976,133009,2023,Japan,Poland,0,0,9,9,22/07/2023,13,0,67,80,0,0,0,0,0,4,3,7,0,0,0,0,2,2,1,5
7977,133009,2023,Japan,Slovenia,1,0,15,16,20/07/2023,28,0,59,87,0,0,1,1,0,1,6,7,0,0,1,1,6,0,2,8
7978,133009,2023,Japan,Poland,0,0,0,0,09/07/2023,0,0,0,0,0,0,0,0,0,0,0,0,0,0,0,0,0,0,0,0
7979,133009,2023,Japan,Italy,0,1,15,16,08/07/2023,24,2,82,108,0,0,1,1,0,0,3,3,0,0,1,1,7,6,1,14
7980,133009,2023,Japan,Netherlands,0,1,20,21,07/07/2023,25,0,59,84,0,0,0,0,1,3,3,7,0,0,0,0,3,1,0,4
7981,133009,2023,Japan,China,0,1,15,16,04/07/2023,27,0,69,96,0,0,1,1,0,2,1,3,0,0,0,0,9,3,2,14
7982,133009,2023,Japan,Argentina,1,1,15,17,24/06/2023,21,0,87,108,0,0,0,0,0,7,0,7,0,0,0,0,7,8,1,16
7983,133009,2023,Japan,Brazil,1,1,17,19,22/06/2023,23,0,88,111,0,0,0,0,0,3,2,5,0,0,0,0,5,7,3,15
7984,133009,2023,Japan,Cuba,0,1,16,17,21/06/2023,29,0,29,58,0,0,0,0,0,2,1,3,0,0,0,0,1,1,0,2
7985,133009,2023,Japan,Canada,0,0,17,17,20/06/2023,19,0,61,80,0,0,0,0,0,3,3,6,0,0,0,0,7,2,1,10
7986,133009,2023,Japan,France,0,0,12,12,11/06/2023,8,0,51,59,0,0,0,0,0,0,0,0,0,0,0,0,5,1,0,6
7987,133009,2023,Japan,Bulgaria,0,1,13,14,10/06/2023,22,0,47,69,1,0,0,1,0,2,2,4,0,0,0,0,1,0,0,1
7988,133009,2023,Japan,Serbia,1,0,16,17,09/06/2023,19,1,70,90,1,0,0,1,0,2,3,5,0,0,0,0,5,0,2,7
7989,133009,2023,Japan,Iran,1,0,17,18,06/06/2023,5,0,66,71,0,0,0,0,0,1,0,1,0,0,1,1,5,0,1,6
7990,142561,2023,Japan,Italy,0,0,0,0,23/07/2023,0,0,0,0,0,0,0,0,0,0,0,0,0,0,0,0,0,0,0,0
7991,142561,2023,Japan,Poland,0,1,3,4,22/07/2023,0,0,0,0,0,0,1,1,0,1,1,2,0,0,0,0,0,0,0,0
7992,142561,2023,Japan,Slovenia,0,0,0,0,20/07/2023,0,0,0,0,0,0,0,0,0,0,0,0,0,0,0,0,0,0,0,0
7993,142561,2023,Japan,Poland,0,0,6,6,09/07/2023,0,0,1,1,2,0,2,4,0,5,1,6,0,1,0,1,1,0,0,1
7994,142561,2023,Japan,Italy,0,0,0,0,08/07/2023,0,0,0,0,0,0,0,0,0,0,0,0,0,0,0,0,0,0,0,0
7995,142561,2023,Japan,Netherlands,0,0,0,0,07/07/2023,0,0,0,0,0,0,0,0,0,0,0,0,0,0,0,0,0,0,0,0
7996,142561,2023,Japan,China,0,1,2,3,04/07/2023,0,0,0,0,1,2,0,3,1,2,2,5,0,0,0,0,0,0,0,0
7997,142561,2023,Japan,Argentina,0,0,0,0,24/06/2023,0,0,0,0,0,0,0,0,1,0,0,1,0,0,0,0,0,0,0,0
7998,142561,2023,Japan,Brazil,0,2,4,6,22/06/2023,0,0,1,1,0,0,2,2,0,1,0,1,0,0,0,0,1,0,0,1
7999,142561,2023,Japan,Cuba,0,0,0,0,21/06/2023,0,0,0,0,0,0,0,0,0,0,0,0,0,0,0,0,0,0,0,0
8000,142561,2023,Japan,Canada,0,0,0,0,20/06/2023,0,0,0,0,0,0,0,0,0,0,0,0,0,0,0,0,0,0,0,0
8001,142561,2023,Japan,France,0,1,13,14,11/06/2023,0,0,0,0,6,0,4,10,2,5,3,10,0,0,0,0,1,0,1,2
8002,142561,2023,Japan,Bulgaria,0,1,7,8,10/06/2023,0,0,1,1,4,0,0,4,2,6,4,12,1,0,0,1,2,0,0,2
8003,142561,2023,Japan,Serbia,0,1,6,7,09/06/2023,0,0,1,1,6,0,0,6,0,6,3,9,0,0,0,0,0,1,0,1
8004,142561,2023,Japan,Iran,0,0,0,0,06/06/2023,0,0,0,0,0,0,0,0,0,0,0,0,0,0,0,0,0,0,0,0
8005,178761,2023,Japan,Italy,0,0,0,0,23/07/2023,0,0,0,0,0,0,0,0,0,0,0,0,0,0,1,1,1,0,0,1
8006,178761,2023,Japan,Poland,0,0,0,0,22/07/2023,0,0,0,0,0,0,0,0,0,0,0,0,0,0,1,1,0,0,0,0
8007,178761,2023,Japan,Slovenia,0,0,0,0,20/07/2023,0,0,0,0,0,0,0,0,0,0,0,0,0,0,0,0,0,0,0,0
8008,178761,2023,Japan,Poland,0,1,2,3,09/07/2023,0,0,2,2,5,0,4,9,0,0,0,0,0,0,9,9,2,1,0,3
8009,178761,2023,Japan,Italy,0,0,0,0,08/07/2023,0,0,0,0,0,0,0,0,0,0,0,0,1,0,3,4,0,0,0,0
8010,178761,2023,Japan,Netherlands,0,1,2,3,07/07/2023,0,0,0,0,4,0,2,6,0,0,0,0,3,0,2,5,1,0,0,1
8011,178761,2023,Japan,China,0,0,1,1,04/07/2023,0,0,0,0,0,0,0,0,0,0,0,0,0,0,1,1,0,0,0,0
8012,178761,2023,Japan,Argentina,0,0,0,0,24/06/2023,0,0,0,0,0,0,0,0,0,0,0,0,1,0,0,1,0,0,0,0
8013,178761,2023,Japan,Brazil,0,0,1,1,22/06/2023,0,0,0,0,0,0,0,0,0,0,0,0,0,0,0,0,0,1,0,1
8014,178761,2023,Japan,Cuba,0,0,0,0,21/06/2023,0,0,0,0,0,0,0,0,0,0,0,0,1,0,0,1,0,0,0,0
8015,178761,2023,Japan,Canada,0,0,0,0,20/06/2023,0,0,2,2,0,0,0,0,0,0,0,0,1,0,3,4,1,0,0,1
8016,178761,2023,Japan,France,0,0,0,0,11/06/2023,0,0,0,0,0,0,0,0,0,0,0,0,0,0,0,0,0,0,0,0
8017,178761,2023,Japan,Bulgaria,0,0,0,0,10/06/2023,0,0,0,0,0,0,0,0,0,0,0,0,1,0,0,1,0,0,0,0
8018,178761,2023,Japan,Serbia,0,0,0,0,09/06/2023,0,0,0,0,0,0,0,0,0,0,0,0,0,0,0,0,0,0,0,0
8019,178761,2023,Japan,Iran,0,0,0,0,06/06/2023,0,0,0,0,0,0,0,0,0,0,0,0,0,0,0,0,0,0,0,0
8020,178762,2023,Japan,Italy,0,2,6,8,23/07/2023,0,0,2,2,11,6,12,29,1,1,4,6,4,4,12,20,6,2,0,8
8021,178762,2023,Japan,Poland,3,3,12,18,22/07/2023,0,0,4,4,12,5,7,24,1,4,4,9,7,1,15,23,6,4,0,10
8022,178762,2023,Japan,Slovenia,0,2,13,15,20/07/2023,1,0,6,7,9,4,5,18,0,4,1,5,5,0,15,20,7,1,1,9
8023,178762,2023,Japan,Poland,0,0,0,0,09/07/2023,0,0,0,0,0,0,0,0,0,0,0,0,0,0,0,0,0,0,0,0
8024,178762,2023,Japan,Italy,0,0,0,0,08/07/2023,0,0,0,0,0,0,0,0,0,0,0,0,0,0,0,0,0,0,0,0
8025,178762,2023,Japan,Netherlands,0,3,13,16,07/07/2023,0,0,5,5,9,1,5,15,1,3,1,5,3,1,18,22,8,1,0,9
8026,178762,2023,Japan,China,4,5,15,24,04/07/2023,0,0,8,8,10,6,9,25,0,2,0,2,10,2,28,40,7,4,1,12
8027,178762,2023,Japan,Argentina,1,3,15,19,24/06/2023,0,0,4,4,29,3,8,40,2,6,4,12,13,2,29,44,9,4,0,13
8028,178762,2023,Japan,Brazil,2,4,12,18,22/06/2023,0,0,7,7,19,1,11,31,0,5,1,6,8,0,17,25,9,2,2,13
8029,178762,2023,Japan,Cuba,0,1,8,9,21/06/2023,0,0,2,2,13,2,4,19,1,2,1,4,3,1,12,16,6,3,0,9
8030,178762,2023,Japan,Canada,0,1,11,12,20/06/2023,0,0,1,1,15,4,10,29,3,3,5,11,1,3,12,16,10,4,1,15
8031,178762,2023,Japan,France,2,3,15,20,11/06/2023,0,0,2,2,14,5,7,26,1,2,1,4,7,0,14,21,4,0,0,4
8032,178762,2023,Japan,Bulgaria,0,1,7,8,10/06/2023,0,0,3,3,10,0,3,13,0,1,2,3,5,2,8,15,8,0,3,11
8033,178762,2023,Japan,Serbia,2,3,16,21,09/06/2023,0,0,1,1,13,6,3,22,0,1,3,4,6,0,15,21,8,1,1,10
8034,178762,2023,Japan,Iran,1,3,10,14,06/06/2023,0,0,2,2,9,3,10,22,0,0,1,1,4,1,15,20,8,0,2,10
8035,180990,2023,Japan,Italy,0,0,0,0,23/07/2023,0,0,0,0,0,0,0,0,0,0,0,0,0,0,0,0,0,0,0,0
8036,180990,2023,Japan,Poland,0,0,0,0,22/07/2023,0,0,0,0,0,0,0,0,0,0,0,0,0,0,0,0,0,0,0,0
8037,180990,2023,Japan,Slovenia,0,0,0,0,20/07/2023,0,0,0,0,0,0,0,0,0,0,0,0,0,0,0,0,0,0,0,0
8038,180990,2023,Japan,Poland,0,0,0,0,09/07/2023,0,0,3,3,0,0,0,0,0,0,0,0,6,2,7,15,8,2,2,12
8039,180990,2023,Japan,Italy,0,0,0,0,08/07/2023,0,0,0,0,0,0,0,0,0,0,0,0,0,0,0,0,0,0,0,0
8040,180990,2023,Japan,Netherlands,0,0,0,0,07/07/2023,0,0,4,4,0,0,0,0,0,0,0,0,2,0,5,7,8,1,0,9
8041,180990,2023,Japan,China,0,0,0,0,04/07/2023,0,0,0,0,0,0,0,0,0,0,0,0,0,0,0,0,0,0,0,0
8042,180990,2023,Japan,Argentina,0,0,0,0,24/06/2023,0,0,0,0,0,0,0,0,0,0,0,0,0,0,0,0,0,0,0,0
8043,180990,2023,Japan,Brazil,0,0,0,0,22/06/2023,0,0,0,0,0,0,0,0,0,0,0,0,0,0,0,0,0,0,0,0
8044,180990,2023,Japan,Cuba,0,0,0,0,21/06/2023,0,0,0,0,0,0,0,0,0,0,0,0,0,0,0,0,0,0,0,0
8045,180990,2023,Japan,Canada,0,0,0,0,20/06/2023,0,0,0,0,0,0,0,0,0,0,0,0,0,0,0,0,0,0,0,0
8046,180990,2023,Japan,France,0,0,0,0,11/06/2023,0,0,0,0,0,0,0,0,0,0,0,0,0,0,0,0,0,0,0,0
8047,180990,2023,Japan,Bulgaria,0,0,0,0,10/06/2023,0,0,0,0,0,0,0,0,0,0,0,0,0,0,0,0,0,0,0,0
8048,180990,2023,Japan,Serbia,0,0,0,0,09/06/2023,0,0,0,0,0,0,0,0,0,0,0,0,0,0,0,0,0,0,0,0
8049,180990,2023,Japan,Iran,0,0,0,0,06/06/2023,0,0,0,0,0,0,0,0,0,0,0,0,0,0,0,0,0,0,0,0
8050,142568,2023,Japan,Italy,0,3,13,16,23/07/2023,0,1,7,8,21,8,19,48,0,4,3,7,7,2,18,27,4,3,0,7
8051,142568,2023,Japan,Poland,4,4,10,18,22/07/2023,0,0,4,4,17,2,9,28,1,2,0,3,1,1,29,31,3,3,4,10
8052,142568,2023,Japan,Slovenia,1,3,5,9,20/07/2023,1,0,2,3,22,2,13,37,4,8,3,15,2,0,18,20,5,2,0,7
8053,142568,2023,Japan,Poland,1,2,4,7,09/07/2023,0,0,3,3,6,2,5,13,0,2,2,4,0,2,11,13,1,1,1,3
8054,142568,2023,Japan,Italy,1,3,12,16,08/07/2023,0,0,2,2,17,8,17,42,3,2,0,5,2,2,13,17,7,2,4,13
8055,142568,2023,Japan,Netherlands,1,5,12,18,07/07/2023,0,0,4,4,14,5,8,27,2,6,6,14,8,0,12,20,1,1,1,3
8056,142568,2023,Japan,China,1,4,10,15,04/07/2023,0,0,2,2,16,4,15,35,1,1,4,6,3,1,15,19,2,3,1,6
8057,142568,2023,Japan,Argentina,1,6,15,22,24/06/2023,0,0,4,4,16,5,6,27,0,1,6,7,8,1,20,29,6,2,1,9
8058,142568,2023,Japan,Brazil,2,4,10,16,22/06/2023,0,0,6,6,25,3,15,43,0,7,4,11,13,1,26,40,3,1,0,4
8059,142568,2023,Japan,Cuba,0,4,8,12,21/06/2023,0,0,2,2,5,1,5,11,0,2,3,5,3,1,5,9,4,1,0,5
8060,142568,2023,Japan,Canada,3,5,9,17,20/06/2023,0,0,2,2,19,2,9,30,1,5,2,8,7,3,17,27,5,4,1,10
8061,142568,2023,Japan,France,1,3,14,18,11/06/2023,0,1,6,7,14,2,8,24,1,3,2,6,11,1,16,28,10,1,1,12
8062,142568,2023,Japan,Bulgaria,3,5,8,16,10/06/2023,0,0,1,1,12,3,12,27,2,3,4,9,7,1,17,25,9,0,1,10
8063,142568,2023,Japan,Serbia,1,3,13,17,09/06/2023,0,0,1,1,15,4,7,26,1,1,1,3,9,0,20,29,7,0,0,7
8064,142568,2023,Japan,Iran,1,4,9,14,06/06/2023,0,0,2,2,18,5,7,30,1,2,2,5,3,2,10,15,5,0,0,5
8065,192453,2023,Japan,Italy,0,0,2,2,23/07/2023,0,0,0,0,0,1,0,1,0,0,0,0,0,0,0,0,0,0,0,0
8066,192453,2023,Japan,Poland,1,2,0,3,22/07/2023,0,0,0,0,3,2,1,6,0,1,0,1,0,0,0,0,2,0,0,2
8067,192453,2023,Japan,Slovenia,0,0,0,0,20/07/2023,0,0,0,0,0,0,0,0,0,0,0,0,0,0,0,0,0,0,0,0
8068,172893,2023,Japan,Italy,0,0,0,0,23/07/2023,0,0,6,6,0,0,0,0,0,0,0,0,7,0,12,19,14,5,0,19
8069,172893,2023,Japan,Poland,0,0,0,0,22/07/2023,0,0,2,2,0,0,0,0,0,0,0,0,3,2,16,21,11,4,0,15
8070,172893,2023,Japan,Slovenia,0,0,0,0,20/07/2023,0,0,6,6,0,0,0,0,0,0,0,0,5,0,8,13,10,4,1,15
8071,172893,2023,Japan,Poland,0,0,0,0,09/07/2023,0,0,0,0,0,0,0,0,0,0,0,0,0,0,0,0,0,0,0,0
8072,172893,2023,Japan,Italy,0,0,0,0,08/07/2023,0,0,5,5,0,0,0,0,0,0,0,0,4,0,14,18,9,7,1,17
8073,172893,2023,Japan,Netherlands,0,0,0,0,07/07/2023,0,0,2,2,0,0,0,0,0,0,0,0,3,1,5,9,5,3,0,8
8074,172893,2023,Japan,China,0,0,0,0,04/07/2023,0,0,8,8,0,0,0,0,0,0,0,0,4,2,14,20,7,2,2,11
8075,172893,2023,Japan,Argentina,0,0,0,0,24/06/2023,0,0,6,6,0,0,0,0,0,0,0,0,5,1,7,13,10,4,3,17
8076,172893,2023,Japan,Brazil,0,0,0,0,22/06/2023,0,0,5,5,0,0,0,0,0,0,0,0,12,1,13,26,11,3,4,18
8077,172893,2023,Japan,Cuba,0,0,0,0,21/06/2023,0,0,2,2,0,0,0,0,0,0,0,0,3,1,8,12,6,3,1,10
8078,172893,2023,Japan,Canada,0,0,0,0,20/06/2023,0,0,11,11,0,0,0,0,0,0,0,0,3,2,17,22,12,4,0,16
8079,172893,2023,Japan,France,0,0,0,0,11/06/2023,0,0,4,4,0,0,0,0,0,0,0,0,7,1,9,17,8,1,3,12
8080,172893,2023,Japan,Bulgaria,0,0,0,0,10/06/2023,0,0,1,1,0,0,0,0,0,0,0,0,5,1,4,10,7,1,1,9
8081,172893,2023,Japan,Serbia,0,0,0,0,09/06/2023,0,0,3,3,0,0,0,0,0,0,0,0,9,2,7,18,10,1,2,13
8082,172893,2023,Japan,Iran,0,0,0,0,06/06/2023,0,0,2,2,0,0,0,0,0,0,0,0,2,0,6,8,11,1,1,13
8083,142562,2023,Japan,Italy,0,0,0,0,23/07/2023,1,0,1,2,0,0,0,0,0,0,0,0,0,0,0,0,0,0,0,0
8084,142562,2023,Japan,Poland,0,0,1,1,22/07/2023,3,1,12,16,0,0,0,0,0,0,1,1,0,0,1,1,0,1,0,1
8085,142562,2023,Japan,Slovenia,0,0,0,0,20/07/2023,0,0,0,0,0,0,0,0,0,0,0,0,0,0,0,0,0,0,0,0
8086,142562,2023,Japan,Poland,0,1,6,7,09/07/2023,16,0,55,71,0,0,0,0,1,5,1,7,0,0,0,0,7,4,0,11
8087,142562,2023,Japan,Italy,0,0,0,0,08/07/2023,0,0,0,0,0,0,0,0,0,0,0,0,0,0,0,0,0,0,0,0
8088,142562,2023,Japan,Netherlands,0,0,0,0,07/07/2023,0,0,1,1,0,0,0,0,0,0,0,0,0,0,0,0,0,0,0,0
8089,142562,2023,Japan,China,0,0,0,0,04/07/2023,0,0,10,10,0,0,0,0,0,0,0,0,0,0,0,0,1,0,0,1
8090,189039,2023,Japan,Italy,0,0,0,0,23/07/2023,0,0,0,0,0,0,0,0,0,0,0,0,0,0,0,0,0,0,0,0
8091,189039,2023,Japan,Poland,0,0,9,9,09/07/2023,0,0,0,0,2,1,2,5,0,1,1,2,1,1,0,2,2,1,0,3
8092,189039,2023,Japan,Italy,0,0,0,0,08/07/2023,0,0,0,0,0,0,0,0,0,0,0,0,0,0,0,0,0,0,0,0
8093,189039,2023,Japan,Netherlands,0,0,0,0,07/07/2023,0,0,0,0,0,0,0,0,0,0,0,0,0,0,0,0,0,0,0,0
8094,189039,2023,Japan,China,0,0,0,0,04/07/2023,0,0,0,0,0,0,0,0,0,0,0,0,0,0,0,0,0,0,0,0
8095,188782,2023,Slovenia,Netherlands,0,0,0,0,09/07/2023,0,0,0,0,0,0,0,0,0,0,0,0,0,0,0,0,0,0,0,0
8096,188782,2023,Japan,Netherlands,0,0,0,0,07/07/2023,0,0,0,0,0,0,0,0,0,0,0,0,0,0,0,0,0,0,0,0
8097,188782,2023,Brazil,Netherlands,0,0,0,0,06/07/2023,0,0,0,0,0,0,0,0,0,0,0,0,0,0,0,0,0,0,0,0
8098,188782,2023,Canada,Netherlands,0,1,1,2,05/07/2023,0,0,0,0,2,0,0,2,1,0,2,3,0,0,0,0,0,0,0,0
8099,188782,2023,Netherlands,Serbia,0,0,0,0,25/06/2023,0,0,0,0,0,0,0,0,0,0,0,0,0,0,0,0,0,0,0,0
8100,188782,2023,Netherlands,Iran,0,0,0,0,24/06/2023,0,0,0,0,0,0,0,0,0,0,0,0,0,0,0,0,0,0,0,0
8101,188782,2023,Netherlands,Poland,0,0,0,0,22/06/2023,0,0,0,0,0,0,0,0,0,0,0,0,0,0,0,0,0,0,0,0
8102,188782,2023,Netherlands,China,0,1,1,2,20/06/2023,0,0,0,0,0,0,0,0,1,0,0,1,0,0,0,0,0,0,0,0
8103,188782,2023,Argentina,Netherlands,0,0,0,0,11/06/2023,0,0,0,0,0,0,0,0,0,0,0,0,0,0,0,0,0,0,0,0
8104,188782,2023,Netherlands,Germany,0,0,0,0,09/06/2023,0,0,0,0,0,0,0,0,0,0,0,0,0,0,0,0,0,0,0,0
8105,188782,2023,Netherlands,Cuba,0,0,0,0,08/06/2023,0,0,0,0,0,0,0,0,0,0,0,0,0,0,0,0,0,0,0,0
8106,188782,2023,USA,Netherlands,0,0,0,0,07/06/2023,0,0,0,0,0,0,0,0,0,0,0,0,0,0,0,0,0,0,0,0
8107,141546,2023,Slovenia,Netherlands,0,1,9,10,09/07/2023,17,0,58,75,1,0,0,1,0,2,4,6,0,0,1,1,1,1,0,2
8108,141546,2023,Japan,Netherlands,0,1,10,11,07/07/2023,20,0,62,82,0,0,0,0,0,2,2,4,0,0,1,1,1,2,1,4
8109,141546,2023,Brazil,Netherlands,0,0,3,3,06/07/2023,15,0,34,49,1,0,2,3,0,1,1,2,0,0,0,0,0,1,0,1
8110,141546,2023,Canada,Netherlands,1,0,11,12,05/07/2023,18,0,61,79,1,0,0,1,0,3,1,4,0,0,0,0,4,2,2,8
8111,141546,2023,Netherlands,Serbia,0,0,16,16,25/06/2023,30,2,73,105,2,0,0,2,2,4,1,7,0,0,0,0,4,1,0,5
8112,141546,2023,Netherlands,Iran,0,0,7,7,24/06/2023,21,0,55,76,1,0,0,1,1,0,0,1,0,1,0,1,4,1,1,6
8113,141546,2023,Netherlands,Poland,0,3,11,14,22/06/2023,15,3,62,80,1,0,0,1,0,2,1,3,0,0,0,0,3,0,0,3
8114,141546,2023,Netherlands,China,0,0,15,15,20/06/2023,13,0,47,60,1,0,0,1,1,1,1,3,0,1,0,1,4,3,2,9
8115,141546,2023,Argentina,Netherlands,2,0,15,17,11/06/2023,22,0,82,104,2,0,0,2,2,5,3,10,0,0,1,1,3,5,1,9
8116,141546,2023,Netherlands,Germany,0,1,8,9,09/06/2023,9,1,51,61,1,0,0,1,2,5,5,12,0,0,0,0,6,2,1,9
8117,141546,2023,Netherlands,Cuba,0,0,10,10,08/06/2023,17,0,44,61,1,0,0,1,0,0,3,3,0,0,0,0,5,1,2,8
8118,141546,2023,USA,Netherlands,0,1,7,8,07/06/2023,8,0,33,41,0,0,1,1,0,1,0,1,0,0,0,0,0,1,0,1
8119,139929,2023,Slovenia,Netherlands,1,2,4,7,09/07/2023,0,0,1,1,2,5,6,13,1,1,1,3,6,2,9,17,1,0,2,3
8120,139929,2023,Japan,Netherlands,0,2,6,8,07/07/2023,0,1,3,4,7,5,9,21,1,0,0,1,5,1,6,12,4,4,0,8
8121,139929,2023,Brazil,Netherlands,0,0,0,0,06/07/2023,0,0,0,0,0,0,0,0,0,0,0,0,0,0,0,0,0,0,0,0
8122,139929,2023,Canada,Netherlands,0,3,11,14,05/07/2023,0,0,3,3,11,1,12,24,0,3,1,4,4,2,23,29,3,0,1,4
8123,139929,2023,Netherlands,Serbia,3,3,14,20,25/06/2023,0,0,7,7,16,5,11,32,0,3,0,3,6,4,31,41,5,0,0,5
8124,139929,2023,Netherlands,Iran,0,3,7,10,24/06/2023,0,0,1,1,6,2,7,15,1,0,0,1,1,2,14,17,3,1,0,4
8125,139929,2023,Netherlands,Poland,0,5,5,10,22/06/2023,0,0,4,4,9,2,2,13,1,5,0,6,5,1,5,11,2,2,1,5
8126,139929,2023,Netherlands,China,2,2,7,11,20/06/2023,0,0,4,4,10,4,11,25,2,1,4,7,2,1,12,15,5,0,0,5
8127,139929,2023,Argentina,Netherlands,1,2,16,19,11/06/2023,0,0,0,0,12,5,12,29,1,3,1,5,7,5,23,35,6,5,1,12
8128,139929,2023,Netherlands,Germany,2,2,8,12,09/06/2023,0,0,2,2,15,2,9,26,4,2,1,7,0,0,11,11,1,0,0,1
8129,139929,2023,Netherlands,Cuba,0,1,11,12,08/06/2023,0,0,4,4,11,1,6,18,4,0,0,4,1,1,4,6,6,2,2,10
8130,139929,2023,USA,Netherlands,1,1,6,8,07/06/2023,0,0,1,1,4,5,5,14,0,0,2,2,2,2,13,17,7,4,0,11
8131,137345,2023,Slovenia,Netherlands,0,1,1,2,09/07/2023,0,0,1,1,3,1,3,7,1,1,1,3,1,0,4,5,0,3,0,3
8132,137345,2023,Japan,Netherlands,0,0,0,0,07/07/2023,0,0,0,0,0,0,0,0,0,0,0,0,0,0,0,0,0,0,0,0
8133,137345,2023,Brazil,Netherlands,0,3,1,4,06/07/2023,0,0,2,2,3,3,5,11,0,1,1,2,3,1,18,22,1,0,0,1
8134,137345,2023,Canada,Netherlands,0,0,0,0,05/07/2023,0,0,0,0,0,0,0,0,0,0,0,0,0,0,0,0,0,0,0,0
8135,137345,2023,Netherlands,Serbia,0,0,0,0,25/06/2023,0,0,0,0,0,0,0,0,0,0,0,0,0,0,0,0,0,0,0,0
8136,137345,2023,Netherlands,Iran,0,0,0,0,24/06/2023,0,0,0,0,0,0,0,0,0,0,0,0,0,0,0,0,0,0,0,0
8137,137345,2023,Netherlands,Poland,1,1,2,4,22/06/2023,0,0,1,1,5,3,3,11,0,1,2,3,2,1,11,14,0,0,0,0
8138,137345,2023,Netherlands,China,0,0,0,0,20/06/2023,0,0,0,0,0,0,0,0,0,0,0,0,0,0,0,0,0,0,0,0
8139,169921,2023,Slovenia,Netherlands,0,0,0,0,09/07/2023,0,0,0,0,0,0,0,0,0,0,0,0,0,0,0,0,0,0,0,0
8140,169921,2023,Japan,Netherlands,0,0,0,0,07/07/2023,0,0,0,0,0,0,0,0,0,0,0,0,0,0,0,0,0,0,0,0
8141,169921,2023,Argentina,Netherlands,0,0,0,0,11/06/2023,0,0,0,0,0,0,0,0,0,0,0,0,0,0,0,0,0,0,0,0
8142,169921,2023,Netherlands,Germany,0,0,0,0,09/06/2023,0,0,0,0,0,0,0,0,0,0,0,0,0,0,0,0,0,0,0,0
8143,169921,2023,Netherlands,Cuba,0,0,0,0,08/06/2023,0,0,0,0,0,0,0,0,0,0,0,0,0,0,0,0,0,0,0,0
8144,169921,2023,USA,Netherlands,0,0,0,0,07/06/2023,0,0,0,0,0,0,0,0,0,0,0,0,0,0,0,0,0,0,0,0
8145,188784,2023,Slovenia,Netherlands,0,0,1,1,09/07/2023,1,0,0,1,0,0,0,0,0,0,0,0,0,0,0,0,0,0,0,0
8146,188784,2023,Japan,Netherlands,0,0,0,0,07/07/2023,0,0,7,7,0,1,0,1,1,0,1,2,0,0,0,0,0,0,0,0
8147,188784,2023,Brazil,Netherlands,0,1,3,4,06/07/2023,6,2,19,27,0,0,1,1,1,0,1,2,0,0,0,0,1,1,0,2
8148,188784,2023,Canada,Netherlands,1,1,1,3,05/07/2023,3,0,12,15,0,0,1,1,0,1,2,3,0,0,0,0,0,0,1,1
8149,188784,2023,Netherlands,Serbia,0,0,0,0,25/06/2023,2,0,1,3,0,0,0,0,0,0,0,0,0,0,0,0,0,0,0,0
8150,188784,2023,Netherlands,Iran,0,1,4,5,24/06/2023,2,0,21,23,0,0,0,0,1,0,0,1,0,0,0,0,0,0,0,0
8151,188784,2023,Netherlands,Poland,0,0,0,0,22/06/2023,2,0,3,5,0,0,0,0,0,0,0,0,0,0,0,0,0,0,0,0
8152,188784,2023,Netherlands,China,0,0,0,0,20/06/2023,0,0,0,0,0,0,0,0,0,0,0,0,0,0,0,0,0,0,0,0
8153,188784,2023,Argentina,Netherlands,0,1,1,2,11/06/2023,2,0,3,5,0,0,0,0,0,0,1,1,0,0,0,0,0,0,0,0
8154,188784,2023,Netherlands,Germany,0,0,0,0,09/06/2023,0,0,0,0,0,0,0,0,0,0,0,0,0,0,0,0,0,0,0,0
8155,188784,2023,Netherlands,Cuba,0,0,0,0,08/06/2023,0,0,0,0,0,0,0,0,0,0,0,0,0,0,0,0,0,0,0,0
8156,188784,2023,USA,Netherlands,0,2,0,2,07/06/2023,9,0,22,31,0,0,0,0,0,1,0,1,0,0,0,0,3,0,0,3
8157,131980,2023,Slovenia,Netherlands,0,0,2,2,09/07/2023,0,0,0,0,1,1,2,4,0,0,0,0,4,0,4,8,0,1,1,2
8158,131980,2023,Japan,Netherlands,0,2,13,15,07/07/2023,0,0,4,4,7,6,9,22,3,3,1,7,10,1,27,38,3,8,1,12
8159,131980,2023,Brazil,Netherlands,1,1,5,7,06/07/2023,0,0,2,2,1,2,6,9,1,0,3,4,0,0,4,4,1,1,0,2
8160,131980,2023,Canada,Netherlands,0,2,17,19,05/07/2023,0,0,4,4,10,3,10,23,2,3,1,6,6,3,16,25,7,0,0,7
8161,131980,2023,Netherlands,Serbia,0,0,0,0,25/06/2023,0,0,0,0,0,1,0,1,0,1,0,1,1,0,1,2,0,0,0,0
8162,131980,2023,Netherlands,Iran,0,1,9,10,24/06/2023,0,1,2,3,4,1,3,8,0,1,0,1,5,0,13,18,1,3,1,5
8163,131980,2023,Netherlands,Poland,0,1,14,15,22/06/2023,0,0,5,5,6,1,6,13,0,5,1,6,7,3,24,34,4,5,0,9
8164,131980,2023,Netherlands,China,0,1,8,9,20/06/2023,0,0,1,1,2,2,5,9,1,4,5,10,2,2,10,14,3,0,1,4
8165,131980,2023,Argentina,Netherlands,0,1,3,4,11/06/2023,0,0,2,2,0,0,3,3,0,0,0,0,3,0,6,9,1,0,0,1
8166,131980,2023,Netherlands,Germany,0,0,10,10,09/06/2023,0,0,3,3,1,2,3,6,0,2,1,3,3,0,13,16,2,2,1,5
8167,131980,2023,Netherlands,Cuba,0,1,7,8,08/06/2023,0,1,4,5,0,3,1,4,0,6,1,7,4,1,10,15,3,0,1,4
8168,131980,2023,USA,Netherlands,0,0,6,6,07/06/2023,0,0,0,0,2,1,2,5,0,1,0,1,3,3,15,21,2,0,0,2
8169,156678,2023,Slovenia,Netherlands,0,4,8,12,09/07/2023,0,0,0,0,6,0,3,9,2,3,2,7,0,0,0,0,1,0,1,2
8170,156678,2023,Japan,Netherlands,1,5,7,13,07/07/2023,0,0,0,0,5,2,3,10,2,7,4,13,0,0,0,0,1,2,1,4
8171,156678,2023,Brazil,Netherlands,0,4,5,9,06/07/2023,0,0,2,2,4,1,1,6,1,2,4,7,0,1,2,3,3,0,2,5
8172,156678,2023,Canada,Netherlands,0,3,6,9,05/07/2023,0,0,0,0,6,2,2,10,2,4,1,7,0,0,0,0,1,0,0,1
8173,156678,2023,Netherlands,Serbia,0,5,9,14,25/06/2023,0,0,1,1,2,3,3,8,5,10,6,21,0,1,0,1,4,0,0,4
8174,156678,2023,Netherlands,Iran,0,4,10,14,24/06/2023,0,1,1,2,2,2,8,12,5,9,3,17,0,0,0,0,1,0,0,1
8175,156678,2023,Netherlands,Poland,3,6,5,14,22/06/2023,0,0,0,0,9,0,1,10,4,7,4,15,0,0,0,0,2,0,0,2
8176,156678,2023,Netherlands,China,0,0,0,0,20/06/2023,0,0,0,0,0,0,0,0,0,0,0,0,0,0,0,0,0,0,0,0
8177,156678,2023,Argentina,Netherlands,1,2,10,13,11/06/2023,0,1,2,3,9,1,5,15,2,5,4,11,0,0,0,0,4,2,0,6
8178,156678,2023,Netherlands,Germany,2,4,11,17,09/06/2023,0,0,1,1,4,2,2,8,1,3,2,6,0,0,1,1,0,3,0,3
8179,156678,2023,Netherlands,Cuba,0,5,8,13,08/06/2023,0,0,0,0,5,0,5,10,1,4,3,8,0,0,1,1,3,0,0,3
8180,156678,2023,USA,Netherlands,0,3,6,9,07/06/2023,0,0,2,2,5,0,6,11,0,1,4,5,0,0,0,0,3,0,0,3
8181,170436,2023,Slovenia,Netherlands,0,3,6,9,09/07/2023,0,0,0,0,5,4,7,16,0,3,0,3,3,2,18,23,3,1,0,4
8182,170436,2023,Japan,Netherlands,0,2,3,5,07/07/2023,0,0,1,1,2,1,3,6,0,1,0,1,4,0,5,9,3,3,0,6
8183,170436,2023,Brazil,Netherlands,0,1,7,8,06/07/2023,0,0,6,6,6,4,9,19,1,1,0,2,7,0,11,18,8,2,0,10
8184,170436,2023,Canada,Netherlands,0,0,1,1,05/07/2023,0,0,0,0,3,0,0,3,0,1,0,1,2,0,4,6,0,0,1,1
8185,170436,2023,Netherlands,Serbia,4,3,15,22,25/06/2023,0,0,2,2,12,6,12,30,1,1,1,3,8,1,19,28,1,1,0,2
8186,170436,2023,Netherlands,Iran,3,2,11,16,24/06/2023,0,0,1,1,16,8,7,31,1,3,2,6,5,1,20,26,2,1,3,6
8187,170436,2023,Netherlands,Poland,0,2,1,3,22/06/2023,0,0,0,0,0,0,0,0,0,0,0,0,0,0,1,1,0,0,0,0
8188,170436,2023,Netherlands,China,0,0,1,1,20/06/2023,0,0,0,0,0,0,0,0,0,1,0,1,0,0,1,1,0,0,0,0
8189,170436,2023,Argentina,Netherlands,2,5,10,17,11/06/2023,0,0,4,4,18,6,6,30,0,0,2,2,10,3,21,34,5,5,2,12
8190,170436,2023,Netherlands,Germany,1,2,2,5,09/06/2023,0,0,2,2,3,2,2,7,0,0,0,0,4,0,6,10,2,1,1,4
8191,170436,2023,Netherlands,Cuba,1,2,5,8,08/06/2023,0,0,0,0,2,0,3,5,0,0,0,0,2,0,2,4,0,1,0,1
8192,170436,2023,USA,Netherlands,0,0,4,4,07/06/2023,0,0,1,1,2,3,9,14,0,0,0,0,2,1,5,8,1,0,0,1
8193,137498,2023,Slovenia,Netherlands,2,6,11,19,09/07/2023,0,0,3,3,18,7,6,31,2,2,2,6,0,0,0,0,3,2,0,5
8194,137498,2023,Japan,Netherlands,0,2,6,8,07/07/2023,0,0,0,0,3,0,0,3,0,0,0,0,0,0,0,0,1,0,0,1
8195,137498,2023,Brazil,Netherlands,0,3,2,5,06/07/2023,0,0,2,2,7,5,9,21,1,1,0,2,0,0,0,0,3,3,0,6
8196,137498,2023,Canada,Netherlands,2,7,3,12,05/07/2023,0,0,3,3,22,5,11,38,0,4,0,4,0,0,0,0,4,3,2,9
8197,137498,2023,Netherlands,Serbia,7,1,9,17,25/06/2023,0,0,1,1,7,4,10,21,0,1,0,1,0,0,0,0,3,0,0,3
8198,137498,2023,Netherlands,Iran,6,3,9,18,24/06/2023,0,0,1,1,20,7,10,37,1,1,3,5,0,1,0,1,5,1,0,6
8199,137498,2023,Netherlands,Poland,2,7,14,23,22/06/2023,0,0,1,1,21,5,11,37,0,1,1,2,1,0,0,1,2,2,0,4
8200,137498,2023,Netherlands,China,0,3,7,10,20/06/2023,0,0,3,3,17,4,8,29,2,1,1,4,0,0,0,0,3,0,0,3
8201,137498,2023,Argentina,Netherlands,1,5,14,20,11/06/2023,0,0,3,3,16,11,14,41,0,1,3,4,1,0,0,1,5,6,3,14
8202,137498,2023,Netherlands,Germany,3,6,9,18,09/06/2023,0,0,3,3,10,8,7,25,1,1,3,5,1,0,0,1,4,0,1,5
8203,137498,2023,Netherlands,Cuba,0,7,7,14,08/06/2023,0,0,3,3,22,4,13,39,0,5,3,8,0,0,1,1,1,2,0,3
8204,137498,2023,USA,Netherlands,2,3,10,15,07/06/2023,0,0,1,1,21,6,6,33,1,2,1,4,0,0,0,0,4,1,0,5
8205,154521,2023,Slovenia,Netherlands,0,1,1,2,09/07/2023,0,0,0,0,0,0,0,0,0,0,0,0,1,0,0,1,0,0,0,0
8206,154521,2023,Japan,Netherlands,1,5,7,13,07/07/2023,0,0,1,1,18,6,13,37,2,1,3,6,1,0,2,3,4,4,0,8
8207,154521,2023,Brazil,Netherlands,0,2,1,3,06/07/2023,0,0,0,0,9,3,3,15,1,1,1,3,0,0,1,1,0,1,0,1
8208,154521,2023,Canada,Netherlands,0,1,0,1,05/07/2023,0,0,1,1,2,0,1,3,0,0,0,0,0,0,0,0,0,0,0,0
8209,154521,2023,Netherlands,Serbia,0,2,7,9,25/06/2023,0,0,1,1,13,5,3,21,0,2,1,3,0,0,0,0,4,3,2,9
8210,154521,2023,Netherlands,Iran,1,2,5,8,24/06/2023,0,0,1,1,2,2,1,5,1,0,0,1,0,0,0,0,2,0,0,2
8211,154521,2023,Netherlands,Poland,0,0,1,1,22/06/2023,0,0,0,0,2,1,0,3,0,1,0,1,0,0,0,0,0,0,0,0
8212,154521,2023,Netherlands,China,0,0,0,0,20/06/2023,0,0,0,0,0,0,0,0,0,0,0,0,0,0,0,0,0,0,0,0
8213,121992,2023,Slovenia,Netherlands,0,0,0,0,09/07/2023,0,0,4,4,0,0,0,0,0,0,0,0,2,0,9,11,3,3,3,9
8214,121992,2023,Japan,Netherlands,0,0,0,0,07/07/2023,0,0,3,3,0,0,0,0,0,0,0,0,2,2,13,17,0,5,1,6
8215,121992,2023,Brazil,Netherlands,0,0,0,0,06/07/2023,0,0,2,2,0,0,0,0,0,0,0,0,3,1,10,14,7,3,2,12
8216,121992,2023,Canada,Netherlands,0,0,0,0,05/07/2023,0,0,3,3,0,0,0,0,0,0,0,0,1,0,16,17,8,2,0,10
8217,121992,2023,Netherlands,Serbia,0,0,0,0,25/06/2023,0,0,2,2,0,0,0,0,0,0,0,0,8,0,15,23,7,5,2,14
8218,121992,2023,Netherlands,Iran,0,0,0,0,24/06/2023,0,0,4,4,0,0,0,0,0,0,0,0,5,2,15,22,8,2,1,11
8219,121992,2023,Netherlands,Poland,0,0,0,0,22/06/2023,0,0,2,2,0,0,0,0,0,0,0,0,2,0,17,19,6,1,0,7
8220,121992,2023,Netherlands,China,0,0,0,0,20/06/2023,0,0,4,4,0,0,0,0,0,0,0,0,4,2,16,22,9,1,1,11
8221,121992,2023,Argentina,Netherlands,0,0,0,0,11/06/2023,0,0,7,7,0,0,0,0,0,0,0,0,9,0,11,20,12,6,0,18
8222,121992,2023,Netherlands,Germany,0,0,0,0,09/06/2023,0,0,3,3,0,0,0,0,0,0,0,0,0,0,16,16,8,4,0,12
8223,121992,2023,Netherlands,Cuba,0,0,0,0,08/06/2023,0,0,4,4,0,0,0,0,0,0,0,0,5,1,18,24,8,2,0,10
8224,121992,2023,USA,Netherlands,0,0,0,0,07/06/2023,0,0,4,4,0,0,0,0,0,0,0,0,4,0,8,12,7,1,3,11
8225,150703,2023,Slovenia,Netherlands,0,2,8,10,09/07/2023,0,0,0,0,5,0,0,5,2,2,2,6,0,0,1,1,1,0,2,3
8226,150703,2023,Japan,Netherlands,0,2,11,13,07/07/2023,0,0,0,0,5,0,1,6,1,1,4,6,0,0,0,0,3,0,0,3
8227,150703,2023,Brazil,Netherlands,0,1,13,14,06/07/2023,0,0,0,0,2,2,1,5,0,2,2,4,0,0,2,2,3,0,0,3
8228,150703,2023,Canada,Netherlands,2,2,14,18,05/07/2023,0,0,3,3,5,1,2,8,2,1,2,5,0,0,0,0,2,1,1,4
8229,150703,2023,Netherlands,Serbia,0,1,8,9,25/06/2023,0,0,1,1,4,0,0,4,1,5,4,10,0,0,1,1,1,0,1,2
8230,150703,2023,Netherlands,Iran,0,0,2,2,24/06/2023,0,0,0,0,1,0,0,1,0,0,4,4,0,0,0,0,0,0,0,0
8231,150703,2023,Netherlands,Poland,1,2,13,16,22/06/2023,0,0,0,0,2,1,3,6,2,2,1,5,0,0,0,0,1,3,0,4
8232,150703,2023,Netherlands,China,0,2,10,12,20/06/2023,0,1,0,1,2,1,2,5,2,1,2,5,0,0,0,0,0,0,0,0
8233,150703,2023,Argentina,Netherlands,0,5,12,17,11/06/2023,0,0,1,1,3,0,5,8,4,8,5,17,0,0,0,0,0,1,1,2
8234,150703,2023,Netherlands,Germany,0,0,11,11,09/06/2023,0,0,0,0,2,0,0,2,4,3,3,10,0,0,0,0,0,3,0,3
8235,150703,2023,Netherlands,Cuba,0,2,10,12,08/06/2023,0,0,1,1,1,0,3,4,1,4,4,9,0,0,1,1,1,2,1,4
8236,150703,2023,USA,Netherlands,0,2,10,12,07/06/2023,0,0,0,0,2,0,3,5,1,1,2,4,0,0,1,1,4,1,2,7
8237,188785,2023,Slovenia,Netherlands,0,0,0,0,09/07/2023,0,0,0,0,0,0,0,0,0,0,0,0,0,0,0,0,0,0,0,0
8238,188785,2023,Japan,Netherlands,0,0,0,0,07/07/2023,0,0,0,0,0,0,0,0,0,0,0,0,0,0,0,0,0,0,0,0
8239,188785,2023,Brazil,Netherlands,0,0,0,0,06/07/2023,0,0,0,0,0,0,0,0,0,0,0,0,0,0,0,0,0,0,0,0
8240,188785,2023,Canada,Netherlands,0,0,0,0,05/07/2023,0,0,0,0,0,0,0,0,0,0,0,0,0,0,0,0,0,0,0,0
8241,188785,2023,Netherlands,Serbia,0,0,0,0,25/06/2023,0,0,0,0,0,0,0,0,0,0,0,0,0,0,0,0,0,0,0,0
8242,188785,2023,Netherlands,Iran,0,0,0,0,24/06/2023,0,0,0,0,0,0,0,0,0,0,0,0,0,0,0,0,0,0,0,0
8243,188785,2023,Netherlands,Poland,0,0,0,0,22/06/2023,0,0,0,0,0,0,0,0,0,0,0,0,0,0,0,0,0,0,0,0
8244,188785,2023,Netherlands,China,0,0,0,0,20/06/2023,0,0,0,0,0,0,0,0,0,0,0,0,0,0,0,0,0,0,0,0
8245,188785,2023,Argentina,Netherlands,0,0,0,0,11/06/2023,0,0,0,0,0,0,0,0,0,0,0,0,0,0,0,0,0,0,0,0
8246,188785,2023,Netherlands,Germany,0,0,0,0,09/06/2023,0,0,0,0,0,0,0,0,0,0,0,0,0,0,0,0,0,0,0,0
8247,188785,2023,Netherlands,Cuba,0,0,0,0,08/06/2023,0,0,0,0,0,0,0,0,0,0,0,0,0,0,0,0,0,0,0,0
8248,188785,2023,USA,Netherlands,0,0,0,0,07/06/2023,0,0,0,0,0,0,0,0,0,0,0,0,0,0,0,0,0,0,0,0
8249,153388,2023,Poland,USA,0,0,0,0,23/07/2023,0,0,0,0,0,0,0,0,0,0,0,0,0,0,0,0,0,0,0,0
8250,153388,2023,Japan,Poland,0,0,0,0,22/07/2023,0,0,0,0,0,0,0,0,0,0,0,0,0,0,0,0,0,0,0,0
8251,153388,2023,Poland,Brazil,0,0,0,0,20/07/2023,0,0,0,0,0,0,0,0,0,0,0,0,0,0,0,0,0,0,0,0
8252,153388,2023,Japan,Poland,0,0,0,0,09/07/2023,0,0,0,0,0,0,0,0,0,0,0,0,0,0,0,0,0,0,0,0
8253,153388,2023,Poland,Canada,0,0,0,0,08/07/2023,0,0,1,1,0,0,0,0,0,0,0,0,6,2,18,26,4,4,0,8
8254,153388,2023,Poland,Brazil,0,0,0,0,07/07/2023,0,0,4,4,0,0,0,0,0,0,0,0,2,0,10,12,1,1,0,2
8255,153388,2023,Poland,Slovenia,0,0,0,0,05/07/2023,0,0,1,1,0,0,0,0,0,0,0,0,4,1,11,16,5,5,0,10
8256,162105,2023,Poland,USA,1,3,13,17,23/07/2023,0,0,0,0,23,4,8,35,1,3,3,7,0,0,1,1,3,4,1,8
8257,162105,2023,Japan,Poland,0,4,13,17,22/07/2023,0,0,4,4,15,3,9,27,4,5,4,13,0,0,3,3,5,3,0,8
8258,162105,2023,Poland,Brazil,0,2,2,4,20/07/2023,0,0,2,2,2,0,4,6,1,2,2,5,0,0,0,0,0,2,0,2
8259,162105,2023,Japan,Poland,1,1,12,14,09/07/2023,0,0,4,4,11,0,6,17,0,4,1,5,0,0,0,0,5,3,1,9
8260,162105,2023,Poland,Canada,0,2,9,11,08/07/2023,0,0,3,3,9,0,7,16,1,3,4,8,1,0,0,1,2,1,1,4
8261,162105,2023,Poland,Brazil,0,0,6,6,07/07/2023,0,1,0,1,7,1,2,10,1,0,1,2,0,0,0,0,1,1,0,2
8262,162105,2023,Poland,Slovenia,0,1,5,6,05/07/2023,0,0,1,1,7,3,11,21,2,2,4,8,1,0,0,1,4,5,1,10
8263,115806,2023,Poland,USA,0,0,0,0,23/07/2023,0,0,0,0,0,0,0,0,0,0,0,0,0,0,0,0,0,0,0,0
8264,115806,2023,Japan,Poland,0,0,0,0,22/07/2023,0,0,0,0,0,0,0,0,0,0,0,0,0,0,0,0,0,0,0,0
8265,115806,2023,Poland,Brazil,0,3,5,8,20/07/2023,0,0,0,0,6,5,4,15,1,3,0,4,0,0,0,0,3,1,0,4
8266,115806,2023,Japan,Poland,0,0,0,0,09/07/2023,0,0,0,0,0,0,0,0,0,0,0,0,0,0,0,0,0,0,0,0
8267,115806,2023,Poland,Canada,0,0,0,0,08/07/2023,0,0,0,0,0,0,0,0,0,0,0,0,0,0,0,0,0,0,0,0
8268,115806,2023,Poland,Brazil,0,5,2,7,07/07/2023,0,0,1,1,10,2,8,20,0,3,0,3,1,1,0,2,3,0,1,4
8269,115806,2023,Poland,Slovenia,2,4,11,17,05/07/2023,0,0,3,3,8,6,8,22,0,1,7,8,1,0,0,1,3,0,0,3
8270,115806,2023,Italy,Poland,0,3,8,11,25/06/2023,0,0,0,0,20,6,10,36,0,0,5,5,1,0,0,1,8,4,0,12
8271,115806,2023,Poland,USA,0,3,7,10,24/06/2023,0,0,3,3,10,4,11,25,1,3,0,4,0,1,0,1,3,2,0,5
8272,115806,2023,Netherlands,Poland,0,2,6,8,22/06/2023,0,0,0,0,6,1,5,12,0,1,1,2,0,0,0,0,3,0,0,3
8273,115806,2023,Germany,Poland,0,5,8,13,21/06/2023,0,0,1,1,16,6,8,30,2,8,0,10,0,0,0,0,2,0,0,2
8274,119646,2023,Poland,USA,2,1,5,8,23/07/2023,0,0,0,0,3,2,7,12,2,2,3,7,1,1,15,17,1,0,1,2
8275,119646,2023,Japan,Poland,0,4,7,11,22/07/2023,0,0,5,5,21,2,6,29,2,2,5,9,4,3,7,14,1,1,2,4
8276,119646,2023,Poland,Brazil,2,3,14,19,20/07/2023,0,0,3,3,6,4,11,21,3,3,0,6,2,1,19,22,5,1,1,7
8277,119646,2023,Japan,Poland,3,5,4,12,09/07/2023,0,1,2,3,10,0,9,19,3,3,0,6,1,1,5,7,2,1,0,3
8278,119646,2023,Poland,Canada,2,2,1,5,08/07/2023,0,0,0,0,4,1,3,8,0,0,0,0,0,0,0,0,0,0,0,0
8279,119646,2023,Poland,Brazil,1,7,7,15,07/07/2023,0,0,0,0,20,0,13,33,1,2,1,4,1,3,16,20,4,2,0,6
8280,119646,2023,Poland,Slovenia,0,0,0,0,05/07/2023,0,0,0,0,0,0,0,0,0,0,0,0,0,0,0,0,0,0,0,0
8281,119646,2023,Italy,Poland,2,3,9,14,25/06/2023,0,0,4,4,14,3,11,28,0,3,2,5,5,2,29,36,3,2,1,6
8282,119646,2023,Poland,USA,0,2,2,4,24/06/2023,0,0,2,2,3,2,8,13,0,1,3,4,1,2,12,15,1,1,1,3
8283,119646,2023,Netherlands,Poland,0,3,2,5,22/06/2023,0,0,0,0,13,2,3,18,1,3,0,4,0,0,5,5,0,0,0,0
8284,119646,2023,Germany,Poland,2,3,12,17,21/06/2023,0,0,5,5,15,7,15,37,2,0,3,5,4,1,33,38,4,4,0,8
8285,150742,2023,Poland,USA,0,0,0,0,23/07/2023,0,0,0,0,0,0,0,0,0,0,0,0,0,0,0,0,0,0,0,0
8286,150742,2023,Japan,Poland,0,0,1,1,22/07/2023,0,0,0,0,2,1,4,7,0,0,0,0,0,0,2,2,1,0,0,1
8287,150742,2023,Poland,Brazil,0,0,0,0,20/07/2023,0,0,0,0,1,0,0,1,0,0,0,0,0,0,0,0,0,0,0,0
8288,150742,2023,Japan,Poland,0,0,2,2,09/07/2023,0,0,0,0,0,0,1,1,0,0,0,0,0,0,2,2,1,0,1,2
8289,150742,2023,Poland,Canada,0,1,2,3,08/07/2023,0,0,0,0,0,0,0,0,0,0,0,0,0,0,0,0,0,0,0,0
8290,150742,2023,Poland,Brazil,2,1,16,19,07/07/2023,0,0,1,1,9,4,6,19,0,4,3,7,3,0,18,21,3,2,0,5
8291,150742,2023,Poland,Slovenia,0,4,10,14,05/07/2023,0,0,0,0,13,1,10,24,1,2,2,5,2,0,10,12,2,0,1,3
8292,150742,2023,Italy,Poland,0,0,0,0,25/06/2023,0,0,0,0,0,0,1,1,0,0,0,0,1,0,0,1,0,0,0,0
8293,150742,2023,Poland,USA,0,2,7,9,24/06/2023,0,0,4,4,5,3,4,12,1,2,1,4,6,1,13,20,3,1,0,4
8294,150742,2023,Netherlands,Poland,0,0,0,0,22/06/2023,0,0,0,0,0,0,0,0,0,0,0,0,0,0,0,0,0,0,0,0
8295,150742,2023,Germany,Poland,1,2,12,15,21/06/2023,0,0,5,5,10,4,6,20,3,3,1,7,1,0,13,14,7,1,0,8
8296,142679,2023,Poland,USA,0,3,16,19,23/07/2023,1,0,4,5,13,4,8,25,1,5,0,6,3,0,15,18,6,1,0,7
8297,142679,2023,Japan,Poland,1,2,15,18,22/07/2023,0,0,4,4,12,1,6,19,1,3,1,5,3,4,25,32,6,2,0,8
8298,142679,2023,Poland,Brazil,2,1,7,10,20/07/2023,0,0,5,5,12,2,4,18,2,1,1,4,1,3,12,16,1,2,0,3
8299,142679,2023,Japan,Poland,0,2,12,14,09/07/2023,0,0,5,5,11,2,4,17,0,3,1,4,2,0,17,19,4,1,0,5
8300,142679,2023,Poland,Canada,0,2,11,13,08/07/2023,0,0,5,5,7,0,5,12,1,2,0,3,4,1,8,13,4,5,0,9
8301,142679,2023,Poland,Brazil,0,0,1,1,07/07/2023,0,0,0,0,1,0,1,2,0,0,0,0,0,0,2,2,2,0,0,2
8302,142679,2023,Poland,Slovenia,1,2,17,20,05/07/2023,0,0,5,5,18,3,15,36,1,8,4,13,12,1,28,41,7,5,0,12
8303,115794,2023,Poland,USA,0,0,0,0,23/07/2023,0,0,0,0,0,0,0,0,0,0,0,0,0,0,0,0,0,0,0,0
8304,115794,2023,Japan,Poland,0,0,0,0,22/07/2023,0,0,1,1,0,0,0,0,0,0,0,0,0,0,0,0,0,0,0,0
8305,115794,2023,Poland,Brazil,0,0,0,0,20/07/2023,0,0,0,0,0,0,0,0,0,0,0,0,0,0,0,0,0,0,0,0
8306,115794,2023,Japan,Poland,0,0,1,1,09/07/2023,2,0,6,8,0,0,0,0,0,2,0,2,0,0,0,0,1,1,0,2
8307,115794,2023,Poland,Canada,0,0,10,10,08/07/2023,13,1,43,57,1,0,0,1,1,0,1,2,0,0,0,0,5,3,1,9
8308,115794,2023,Poland,Brazil,0,0,0,0,07/07/2023,0,0,0,0,0,0,0,0,0,0,0,0,0,0,0,0,0,0,0,0
8309,115794,2023,Poland,Slovenia,0,0,0,0,05/07/2023,3,0,8,11,0,0,0,0,0,0,0,0,0,0,1,1,1,0,0,1
8310,115794,2023,Italy,Poland,0,0,12,12,25/06/2023,20,0,54,74,0,0,0,0,1,2,4,7,0,0,1,1,11,4,2,17
8311,115794,2023,Poland,USA,0,1,3,4,24/06/2023,4,0,32,36,0,0,0,0,0,1,0,1,0,0,0,0,2,1,0,3
8312,115794,2023,Netherlands,Poland,0,0,7,7,22/06/2023,10,0,34,44,1,0,0,1,0,0,0,0,0,0,0,0,2,2,0,4
8313,115794,2023,Germany,Poland,1,1,11,13,21/06/2023,23,0,55,78,0,0,0,0,0,1,1,2,0,0,0,0,8,0,2,10
8314,115794,2023,Serbia,Poland,0,0,4,4,11/06/2023,14,0,27,41,0,0,0,0,0,1,1,2,0,0,0,0,2,0,0,2
8315,115794,2023,Poland,Bulgaria,0,0,6,6,09/06/2023,4,0,32,36,0,0,0,0,0,0,1,1,0,0,0,0,1,0,0,1
8316,115794,2023,Poland,Iran,0,0,12,12,08/06/2023,19,1,71,91,0,0,0,0,1,1,3,5,0,0,1,1,4,0,4,8
8317,115794,2023,Poland,France,0,0,0,0,07/06/2023,3,0,3,6,0,0,0,0,0,0,0,0,0,0,2,2,0,1,0,1
8318,152870,2023,Poland,USA,1,2,11,14,23/07/2023,0,0,0,0,4,0,2,6,3,6,3,12,0,0,0,0,4,0,0,4
8319,152870,2023,Japan,Poland,0,3,2,5,22/07/2023,0,0,0,0,1,0,1,2,1,3,0,4,0,0,0,0,0,0,0,0
8320,152870,2023,Poland,Brazil,1,1,5,7,20/07/2023,0,0,1,1,4,0,2,6,2,4,3,9,0,0,0,0,1,2,0,3
8321,152870,2023,Japan,Poland,0,0,7,7,09/07/2023,0,0,1,1,6,0,2,8,3,5,7,15,0,0,0,0,0,0,0,0
8322,152870,2023,Poland,Canada,0,0,0,0,08/07/2023,0,0,0,0,0,0,0,0,0,0,0,0,0,0,0,0,0,0,0,0
8323,152870,2023,Poland,Brazil,0,5,15,20,07/07/2023,0,0,1,1,2,2,0,4,1,7,6,14,1,0,0,1,5,0,0,5
8324,152870,2023,Poland,Slovenia,1,3,10,14,05/07/2023,0,0,1,1,6,0,2,8,2,5,7,14,0,0,1,1,3,1,0,4
8325,152870,2023,Italy,Poland,2,1,10,13,25/06/2023,0,1,4,5,8,0,2,10,4,3,3,10,0,0,1,1,2,0,0,2
8326,152870,2023,Poland,USA,1,1,8,10,24/06/2023,0,0,0,0,3,0,2,5,2,4,6,12,0,0,1,1,6,1,0,7
8327,152870,2023,Netherlands,Poland,5,2,14,21,22/06/2023,0,0,0,0,10,0,1,11,2,4,3,9,0,0,0,0,1,2,0,3
8328,152870,2023,Germany,Poland,2,1,7,10,21/06/2023,0,0,1,1,1,0,3,4,0,0,2,2,0,0,0,0,1,0,0,1
8329,153395,2023,Poland,USA,0,0,1,1,23/07/2023,0,0,0,0,0,0,0,0,0,0,0,0,0,0,0,0,0,0,0,0
8330,153395,2023,Japan,Poland,0,0,0,0,22/07/2023,0,0,0,0,1,0,0,1,0,0,0,0,0,0,3,3,0,1,0,1
8331,153395,2023,Poland,Brazil,0,0,0,0,20/07/2023,0,0,0,0,0,0,0,0,0,0,0,0,0,0,0,0,0,0,0,0
8332,153395,2023,Japan,Poland,0,0,0,0,09/07/2023,0,0,0,0,1,0,1,2,0,0,0,0,1,0,0,1,1,0,0,1
8333,153395,2023,Poland,Canada,0,1,10,11,08/07/2023,0,0,2,2,9,4,12,25,2,1,2,5,6,3,6,15,3,1,1,5
8334,153395,2023,Poland,Brazil,0,0,1,1,07/07/2023,0,0,1,1,0,0,0,0,0,0,0,0,0,0,0,0,0,0,0,0
8335,153395,2023,Poland,Slovenia,1,0,5,6,05/07/2023,0,0,0,0,6,2,8,16,1,0,4,5,0,3,3,6,2,0,1,3
8336,153395,2023,Serbia,Poland,0,1,4,5,11/06/2023,0,0,0,0,6,2,6,14,1,1,2,4,3,1,6,10,3,0,0,3
8337,153395,2023,Poland,Bulgaria,1,2,15,18,09/06/2023,0,0,4,4,4,1,3,8,1,0,0,1,3,1,9,13,5,0,0,5
8338,153395,2023,Poland,Iran,1,3,14,18,08/06/2023,0,1,5,6,15,2,7,24,0,4,1,5,10,2,17,29,11,0,1,12
8339,153395,2023,Poland,France,2,3,15,20,07/06/2023,0,0,2,2,4,4,7,15,3,1,2,6,7,1,10,18,3,0,1,4
8340,118614,2023,Poland,USA,0,0,0,0,23/07/2023,0,0,1,1,0,0,0,0,0,0,0,0,3,1,17,21,8,1,1,10
8341,118614,2023,Japan,Poland,0,0,0,0,22/07/2023,0,0,2,2,0,0,0,0,0,0,0,0,6,1,10,17,9,5,2,16
8342,118614,2023,Poland,Brazil,0,0,0,0,20/07/2023,0,0,11,11,0,0,0,0,0,0,0,0,3,1,11,15,10,2,0,12
8343,118614,2023,Japan,Poland,0,0,0,0,09/07/2023,0,0,2,2,0,0,0,0,0,0,0,0,2,1,12,15,8,2,1,11
8344,118614,2023,Poland,Canada,0,0,0,0,08/07/2023,0,0,0,0,0,0,0,0,0,0,0,0,0,0,0,0,0,0,0,0
8345,118614,2023,Poland,Brazil,0,0,0,0,07/07/2023,0,0,5,5,0,0,0,0,0,0,0,0,0,0,9,9,3,2,0,5
8346,118614,2023,Poland,Slovenia,0,0,0,0,05/07/2023,0,0,5,5,0,0,0,0,0,0,0,0,3,0,9,12,6,4,1,11
8347,118614,2023,Italy,Poland,0,0,0,0,25/06/2023,0,0,9,9,0,0,0,0,0,0,0,0,1,1,11,13,9,1,2,12
8348,118614,2023,Poland,USA,0,0,0,0,24/06/2023,0,0,4,4,0,0,0,0,0,0,0,0,1,0,9,10,5,2,1,8
8349,118614,2023,Netherlands,Poland,0,0,0,0,22/06/2023,0,0,4,4,0,0,0,0,0,0,0,0,9,3,18,30,6,3,0,9
8350,118614,2023,Germany,Poland,0,0,0,0,21/06/2023,0,0,10,10,0,0,0,0,0,0,0,0,4,0,16,20,14,3,0,17
8351,165942,2023,Poland,USA,1,2,8,11,23/07/2023,30,0,65,95,0,0,0,0,0,2,1,3,0,0,0,0,2,3,0,5
8352,165942,2023,Japan,Poland,0,0,14,14,22/07/2023,20,0,57,77,0,0,0,0,0,3,0,3,0,0,1,1,6,4,1,11
8353,165942,2023,Poland,Brazil,0,0,11,11,20/07/2023,15,1,40,56,0,0,0,0,1,0,5,6,0,0,0,0,3,3,2,8
8354,165942,2023,Japan,Poland,1,0,9,10,09/07/2023,12,0,40,52,0,0,0,0,0,3,1,4,0,0,0,0,3,2,0,5
8355,165942,2023,Poland,Canada,0,0,0,0,08/07/2023,2,0,9,11,0,0,0,0,0,0,0,0,0,0,0,0,1,1,0,2
8356,165942,2023,Poland,Brazil,0,2,10,12,07/07/2023,19,0,60,79,0,0,2,2,0,1,3,4,0,0,0,0,6,1,1,8
8357,165942,2023,Poland,Slovenia,0,1,12,13,05/07/2023,27,0,87,114,0,0,0,0,0,2,2,4,0,0,0,0,7,5,1,13
8358,150734,2023,Poland,USA,1,2,7,10,23/07/2023,0,0,0,0,4,0,1,5,0,3,2,5,0,0,1,1,2,1,0,3
8359,150734,2023,Japan,Poland,3,2,16,21,22/07/2023,0,0,2,2,4,2,3,9,1,5,5,11,0,0,1,1,1,3,2,6
8360,150734,2023,Poland,Brazil,4,2,10,16,20/07/2023,0,0,1,1,6,0,4,10,0,1,7,8,0,0,0,0,2,1,2,5
8361,150734,2023,Japan,Poland,0,0,0,0,09/07/2023,0,0,0,0,0,0,0,0,0,0,0,0,0,0,0,0,0,0,0,0
8362,150734,2023,Poland,Canada,0,0,0,0,08/07/2023,0,0,0,0,0,0,0,0,0,0,0,0,0,0,0,0,0,0,0,0
8363,150734,2023,Poland,Brazil,0,0,0,0,07/07/2023,0,0,0,0,0,0,0,0,0,0,0,0,0,0,0,0,0,0,0,0
8364,150734,2023,Poland,Slovenia,1,6,14,21,05/07/2023,0,0,2,2,8,1,7,16,2,4,5,11,0,0,1,1,5,2,2,9
8365,150734,2023,Serbia,Poland,2,2,10,14,11/06/2023,0,0,0,0,6,2,2,10,0,2,3,5,0,0,0,0,4,0,0,4
8366,150734,2023,Poland,Bulgaria,1,2,12,15,09/06/2023,0,0,2,2,5,6,5,16,2,2,9,13,0,0,0,0,4,0,1,5
8367,150734,2023,Poland,Iran,0,1,15,16,08/06/2023,0,0,0,0,13,1,4,18,2,5,9,16,0,0,0,0,1,0,1,2
8368,150734,2023,Poland,France,0,4,11,15,07/06/2023,0,0,0,0,10,0,3,13,2,2,5,9,1,0,2,3,3,0,0,3
8369,152866,2023,Poland,USA,0,1,5,6,23/07/2023,0,0,4,4,7,2,5,14,1,0,1,2,3,1,11,15,5,1,1,7
8370,152866,2023,Japan,Poland,0,0,0,0,22/07/2023,0,0,0,0,0,0,0,0,0,0,0,0,0,0,0,0,0,0,0,0
8371,152866,2023,Poland,Brazil,0,0,0,0,20/07/2023,0,0,0,0,0,0,0,0,0,0,0,0,0,0,0,0,0,0,0,0
8372,152866,2023,Italy,Poland,0,4,14,18,25/06/2023,0,0,4,4,11,2,12,25,1,2,6,9,6,1,12,19,7,2,2,11
8373,152866,2023,Poland,USA,0,0,4,4,24/06/2023,0,0,1,1,4,2,5,11,0,2,1,3,3,3,4,10,2,2,1,5
8374,152866,2023,Netherlands,Poland,0,6,12,18,22/06/2023,0,0,1,1,8,3,5,16,0,3,0,3,6,2,21,29,7,5,1,13
8375,152866,2023,Germany,Poland,0,1,1,2,21/06/2023,0,0,2,2,0,0,2,2,0,1,0,1,0,0,3,3,1,0,0,1
8376,152869,2023,Poland,USA,1,0,11,12,23/07/2023,0,1,0,1,5,1,3,9,1,4,2,7,0,0,0,0,1,1,0,2
8377,152869,2023,Japan,Poland,0,1,8,9,22/07/2023,0,0,0,0,5,0,0,5,0,2,2,4,0,0,1,1,1,1,0,2
8378,152869,2023,Poland,Brazil,0,0,0,0,20/07/2023,0,0,0,0,0,0,0,0,0,0,0,0,0,0,0,0,0,0,0,0
8379,152869,2023,Japan,Poland,3,3,8,14,09/07/2023,0,0,0,0,5,0,2,7,1,2,4,7,0,0,1,1,2,3,0,5
8380,152869,2023,Poland,Canada,1,3,10,14,08/07/2023,0,0,0,0,6,1,2,9,4,2,3,9,0,0,0,0,2,1,0,3
8381,152869,2023,Poland,Brazil,0,2,5,7,07/07/2023,0,0,1,1,3,0,0,3,2,2,1,5,0,0,1,1,0,1,0,1
8382,152869,2023,Poland,Slovenia,0,1,2,3,05/07/2023,0,0,0,0,0,0,2,2,0,3,0,3,0,0,2,2,0,0,0,0
8383,152869,2023,Italy,Poland,3,5,17,25,25/06/2023,0,0,6,6,1,1,4,6,2,7,4,13,0,0,0,0,1,0,2,3
8384,152869,2023,Poland,USA,1,3,11,15,24/06/2023,0,0,1,1,4,4,1,9,2,3,1,6,0,0,0,0,0,1,0,1
8385,152869,2023,Netherlands,Poland,0,1,7,8,22/06/2023,0,0,1,1,4,0,0,4,1,0,1,2,0,0,0,0,0,1,0,1
8386,152869,2023,Germany,Poland,0,2,11,13,21/06/2023,0,0,1,1,6,1,4,11,4,2,7,13,0,0,2,2,2,1,0,3
8387,124926,2023,Bulgaria,Serbia,0,0,0,0,08/07/2023,0,0,0,0,0,0,0,0,0,0,0,0,0,0,0,0,0,0,0,0
8388,124926,2023,Serbia,France,0,0,0,0,07/07/2023,0,0,0,0,0,0,0,0,0,0,0,0,0,0,0,0,0,0,0,0
8389,124926,2023,Serbia,Cuba,0,1,5,6,07/07/2023,0,0,3,3,1,7,3,11,0,0,1,1,2,2,7,11,2,0,0,2
8390,124926,2023,Argentina,Serbia,0,0,0,0,04/07/2023,0,0,0,0,0,0,0,0,0,0,0,0,0,0,0,0,0,0,0,0
8391,136360,2023,Bulgaria,Serbia,0,0,0,0,08/07/2023,0,0,3,3,0,0,0,0,0,0,0,0,2,1,5,8,4,7,2,13
8392,136360,2023,Serbia,France,0,0,0,0,07/07/2023,0,0,8,8,0,0,0,0,0,0,0,0,2,1,13,16,5,4,3,12
8393,136360,2023,Serbia,Cuba,0,0,0,0,07/07/2023,0,0,6,6,0,0,0,0,0,0,0,0,3,2,11,16,5,2,2,9
8394,136360,2023,Argentina,Serbia,0,0,0,0,04/07/2023,0,1,7,8,0,0,0,0,0,0,0,0,3,1,13,17,4,6,0,10
8395,136360,2023,Netherlands,Serbia,0,0,0,0,25/06/2023,0,0,12,12,0,0,0,0,0,0,0,0,5,5,21,31,8,2,0,10
8396,136360,2023,Serbia,Italy,0,0,0,0,23/06/2023,0,0,10,10,0,0,0,0,0,0,0,0,2,1,7,10,4,1,0,5
8397,136360,2023,Serbia,Germany,0,0,0,0,22/06/2023,0,0,6,6,0,0,0,0,0,0,0,0,3,1,15,19,3,6,0,9
8398,136360,2023,USA,Serbia,0,0,0,0,20/06/2023,0,1,8,9,0,0,0,0,0,0,0,0,6,1,10,17,9,7,0,16
8399,136360,2023,Serbia,Poland,0,0,0,0,11/06/2023,0,0,8,8,0,0,0,0,0,0,0,0,3,1,10,14,10,0,1,11
8400,136360,2023,Japan,Serbia,0,0,0,0,09/06/2023,0,1,4,5,0,0,0,0,0,0,0,0,3,0,11,14,8,2,1,11
8401,136360,2023,Serbia,China,0,0,0,0,08/06/2023,0,0,5,5,0,0,0,0,0,0,0,0,3,0,8,11,8,2,2,12
8402,136360,2023,Slovenia,Serbia,0,0,0,0,07/06/2023,0,0,4,4,0,0,0,0,0,0,0,0,3,1,22,26,10,1,0,11
8403,192041,2023,Bulgaria,Serbia,0,0,0,0,08/07/2023,0,0,0,0,0,0,0,0,0,0,0,0,0,0,0,0,0,0,0,0
8404,192041,2023,Serbia,France,0,0,0,0,07/07/2023,0,0,0,0,0,0,0,0,0,0,0,0,0,0,0,0,0,0,0,0
8405,192041,2023,Serbia,Cuba,0,1,1,2,07/07/2023,0,0,0,0,0,0,0,0,0,0,0,0,0,0,0,0,0,0,0,0
8406,192041,2023,Argentina,Serbia,0,0,0,0,04/07/2023,0,0,0,0,0,0,0,0,0,0,0,0,0,0,0,0,0,0,0,0
8407,192041,2023,Serbia,Poland,0,0,0,0,11/06/2023,0,0,0,0,0,0,0,0,0,0,0,0,0,0,0,0,0,0,0,0
8408,192041,2023,Japan,Serbia,0,0,1,1,09/06/2023,0,0,0,0,0,0,1,1,0,0,0,0,0,0,0,0,0,0,0,0
8409,192041,2023,Serbia,China,0,1,0,1,08/06/2023,0,0,0,0,0,0,1,1,1,0,0,1,0,0,0,0,0,0,0,0
8410,192041,2023,Slovenia,Serbia,0,1,2,3,07/06/2023,0,0,1,1,0,0,0,0,0,0,0,0,0,0,1,1,3,0,0,3
8411,146579,2023,Bulgaria,Serbia,0,1,8,9,08/07/2023,0,0,1,1,4,1,1,6,3,3,5,11,0,0,0,0,1,0,0,1
8412,146579,2023,Serbia,France,2,1,16,19,07/07/2023,0,0,0,0,5,3,2,10,4,3,5,12,0,0,1,1,3,1,0,4
8413,146579,2023,Serbia,Cuba,0,0,13,13,07/07/2023,0,0,1,1,4,1,5,10,3,6,2,11,0,0,0,0,1,1,0,2
8414,146579,2023,Argentina,Serbia,0,2,13,15,04/07/2023,0,0,3,3,5,1,5,11,0,3,1,4,0,0,0,0,5,2,1,8
8415,146579,2023,Netherlands,Serbia,1,1,21,23,25/06/2023,0,0,2,2,11,3,4,18,5,6,4,15,0,0,2,2,3,1,0,4
8416,146579,2023,Serbia,Italy,0,0,0,0,23/06/2023,0,0,0,0,0,0,0,0,0,0,0,0,0,0,0,0,0,0,0,0
8417,146579,2023,Serbia,Germany,2,2,17,21,22/06/2023,0,0,2,2,6,2,1,9,5,4,3,12,0,0,1,1,3,1,2,6
8418,146579,2023,USA,Serbia,1,2,12,15,20/06/2023,0,0,3,3,8,0,2,10,2,3,3,8,0,0,0,0,1,2,1,4
8419,146579,2023,Serbia,Poland,0,0,12,12,11/06/2023,0,0,1,1,4,1,2,7,3,5,3,11,0,0,0,0,4,0,0,4
8420,146579,2023,Japan,Serbia,0,4,8,12,09/06/2023,0,0,0,0,6,0,1,7,1,4,1,6,0,0,0,0,2,0,0,2
8421,146579,2023,Serbia,China,1,0,15,16,08/06/2023,0,0,1,1,4,1,1,6,1,2,1,4,0,0,0,0,2,0,0,2
8422,146579,2023,Slovenia,Serbia,0,1,16,17,07/06/2023,0,0,1,1,7,1,2,10,2,2,0,4,0,0,0,0,1,0,0,1
8423,132022,2023,Bulgaria,Serbia,1,1,16,18,08/07/2023,0,0,2,2,7,1,7,15,1,1,1,3,2,1,12,15,1,2,1,4
8424,132022,2023,Serbia,France,0,4,9,13,07/07/2023,1,0,2,3,11,6,11,28,1,5,5,11,8,0,28,36,3,3,0,6
8425,132022,2023,Serbia,Cuba,0,2,6,8,07/07/2023,0,0,1,1,4,3,3,10,1,1,2,4,1,2,15,18,4,1,0,5
8426,132022,2023,Argentina,Serbia,1,4,7,12,04/07/2023,0,0,3,3,9,6,10,25,0,1,1,2,9,4,22,35,6,2,1,9
8427,132022,2023,Netherlands,Serbia,2,2,22,26,25/06/2023,1,0,5,6,10,6,6,22,1,1,0,2,9,5,25,39,7,2,0,9
8428,132022,2023,Serbia,Italy,0,0,0,0,23/06/2023,0,0,0,0,0,0,0,0,0,0,0,0,0,0,0,0,0,0,0,0
8429,132022,2023,Serbia,Germany,0,2,14,16,22/06/2023,0,1,8,9,11,1,15,27,1,4,3,8,7,5,16,28,8,0,3,11
8430,132022,2023,USA,Serbia,1,4,6,11,20/06/2023,0,0,5,5,6,5,12,23,0,0,3,3,2,2,19,23,2,2,0,4
8431,162122,2023,Bulgaria,Serbia,0,0,0,0,08/07/2023,0,0,0,0,0,0,0,0,0,0,0,0,0,0,0,0,0,0,0,0
8432,162122,2023,Serbia,France,0,5,13,18,07/07/2023,0,0,3,3,9,6,10,25,0,3,4,7,5,1,13,19,4,3,2,9
8433,162122,2023,Serbia,Cuba,2,6,14,22,07/07/2023,0,0,1,1,13,6,9,28,1,4,1,6,8,1,24,33,10,2,0,12
8434,162122,2023,Argentina,Serbia,1,3,10,14,04/07/2023,0,0,5,5,14,3,14,31,1,2,1,4,3,0,21,24,6,4,0,10
8435,162122,2023,Netherlands,Serbia,2,3,10,15,25/06/2023,0,0,1,1,20,6,8,34,4,2,5,11,6,4,9,19,5,3,0,8
8436,162122,2023,Serbia,Italy,0,2,7,9,23/06/2023,0,0,6,6,10,6,8,24,0,2,0,2,3,1,13,17,2,2,0,4
8437,162122,2023,Serbia,Germany,1,3,14,18,22/06/2023,0,0,5,5,12,1,2,15,1,3,3,7,1,3,18,22,8,2,0,10
8438,162122,2023,USA,Serbia,1,1,6,8,20/06/2023,1,0,1,2,4,4,5,13,0,0,0,0,1,1,11,13,3,3,0,6
8439,162122,2023,Serbia,Poland,3,3,7,13,11/06/2023,0,0,3,3,12,1,4,17,0,2,0,2,5,0,2,7,1,0,2,3
8440,162122,2023,Japan,Serbia,1,5,14,20,09/06/2023,0,0,2,2,8,0,12,20,1,2,1,4,7,0,19,26,5,0,0,5
8441,162122,2023,Serbia,China,4,1,10,15,08/06/2023,0,0,2,2,10,4,6,20,2,4,1,7,9,0,11,20,6,0,2,8
8442,162122,2023,Slovenia,Serbia,1,2,12,15,07/06/2023,0,0,5,5,12,2,14,28,1,2,1,4,7,0,16,23,15,0,0,15
8443,173249,2023,Bulgaria,Serbia,0,0,0,0,08/07/2023,0,0,2,2,0,0,0,0,0,0,0,0,0,0,0,0,0,0,0,0
8444,173249,2023,Serbia,France,0,0,0,0,07/07/2023,0,0,0,0,0,0,0,0,0,2,0,2,0,0,0,0,1,0,0,1
8445,173249,2023,Serbia,Cuba,0,0,0,0,07/07/2023,2,0,1,3,0,0,0,0,0,0,2,2,0,0,0,0,0,0,0,0
8446,173249,2023,Argentina,Serbia,0,0,1,1,04/07/2023,1,0,14,15,0,0,0,0,0,0,1,1,0,0,0,0,3,0,0,3
8447,173249,2023,Netherlands,Serbia,0,0,0,0,25/06/2023,0,0,1,1,0,0,0,0,0,0,0,0,0,0,0,0,0,0,0,0
8448,173249,2023,Serbia,Italy,0,1,7,8,23/06/2023,14,1,61,76,0,0,0,0,0,2,2,4,0,0,1,1,5,2,0,7
8449,173249,2023,Serbia,Germany,0,0,0,0,22/06/2023,1,0,4,5,0,0,0,0,0,0,0,0,0,0,0,0,0,0,0,0
8450,173249,2023,USA,Serbia,0,0,0,0,20/06/2023,2,0,5,7,0,0,0,0,0,0,0,0,0,0,0,0,0,0,0,0
8451,173249,2023,Serbia,Poland,0,0,0,0,11/06/2023,0,0,0,0,0,0,0,0,0,0,0,0,0,0,0,0,0,0,0,0
8452,173249,2023,Japan,Serbia,0,5,7,12,09/06/2023,15,0,69,84,0,0,1,1,0,3,2,5,0,0,0,0,0,0,0,0
8453,173249,2023,Serbia,China,0,0,0,0,08/06/2023,2,0,5,7,0,0,0,0,0,0,0,0,0,0,0,0,0,0,0,0
8454,173249,2023,Slovenia,Serbia,0,0,3,3,07/06/2023,2,0,14,16,0,0,0,0,1,1,0,2,0,0,0,0,2,0,0,2
8455,173251,2023,Bulgaria,Serbia,2,4,8,14,08/07/2023,0,0,1,1,9,5,8,22,0,1,4,5,8,1,17,26,5,4,1,10
8456,173251,2023,Serbia,France,0,0,0,0,07/07/2023,0,0,0,0,0,0,1,1,0,0,0,0,0,0,1,1,0,0,0,0
8457,173251,2023,Serbia,Cuba,0,0,0,0,07/07/2023,0,0,0,0,0,0,0,0,0,0,0,0,0,0,0,0,0,0,0,0
8458,173251,2023,Argentina,Serbia,0,0,1,1,04/07/2023,0,0,0,0,2,1,1,4,0,0,0,0,0,0,1,1,1,0,0,1
8459,173251,2023,Netherlands,Serbia,0,1,1,2,25/06/2023,0,0,0,0,3,0,4,7,0,0,1,1,1,0,4,5,0,0,1,1
8460,173251,2023,Serbia,Italy,0,2,10,12,23/06/2023,0,0,0,0,14,5,10,29,1,1,1,3,3,3,36,42,5,2,0,7
8461,173251,2023,Serbia,Germany,0,0,0,0,22/06/2023,0,0,0,0,0,0,0,0,0,0,0,0,0,0,0,0,0,0,0,0
8462,173251,2023,USA,Serbia,0,5,5,10,20/06/2023,0,0,0,0,5,6,10,21,1,1,1,3,1,2,21,24,7,1,0,8
8463,173251,2023,Serbia,Poland,1,2,7,10,11/06/2023,0,0,1,1,5,1,8,14,1,0,2,3,3,2,18,23,3,0,0,3
8464,173251,2023,Japan,Serbia,1,4,9,14,09/06/2023,0,0,1,1,17,2,11,30,4,1,1,6,3,4,24,31,4,1,1,6
8465,173251,2023,Serbia,China,0,0,0,0,08/06/2023,0,0,0,0,0,0,0,0,0,0,0,0,0,0,0,0,0,0,0,0
8466,173251,2023,Slovenia,Serbia,0,1,6,7,07/06/2023,0,0,0,0,7,3,9,19,1,0,1,2,3,1,17,21,7,0,0,7
8467,150382,2023,Bulgaria,Serbia,0,0,0,0,08/07/2023,0,0,0,0,0,0,0,0,0,0,0,0,0,0,0,0,0,0,0,0
8468,150382,2023,Serbia,France,0,0,0,0,07/07/2023,0,0,0,0,0,0,0,0,0,0,0,0,0,0,0,0,0,0,0,0
8469,150382,2023,Serbia,Cuba,0,0,0,0,07/07/2023,0,0,0,0,0,0,0,0,0,0,0,0,0,0,0,0,0,0,0,0
8470,150382,2023,Argentina,Serbia,0,0,0,0,04/07/2023,0,0,0,0,0,0,0,0,0,0,0,0,0,0,0,0,0,0,0,0
8471,150382,2023,Netherlands,Serbia,0,0,0,0,25/06/2023,0,0,0,0,0,0,0,0,0,0,0,0,0,0,0,0,0,0,0,0
8472,150382,2023,Serbia,Italy,1,0,9,10,23/06/2023,0,0,0,0,3,1,2,6,0,2,5,7,0,0,2,2,2,1,1,4
8473,150382,2023,Serbia,Germany,0,0,0,0,22/06/2023,0,0,0,0,0,0,0,0,0,0,0,0,0,0,0,0,0,0,0,0
8474,150382,2023,USA,Serbia,0,0,0,0,20/06/2023,0,0,0,0,0,0,0,0,0,0,0,0,0,0,0,0,0,0,0,0
8475,143794,2023,Bulgaria,Serbia,1,2,11,14,08/07/2023,0,0,3,3,13,4,6,23,1,1,2,4,0,0,0,0,5,2,2,9
8476,143794,2023,Serbia,France,0,5,10,15,07/07/2023,0,0,4,4,16,6,10,32,0,1,1,2,0,0,0,0,8,1,0,9
8477,143794,2023,Serbia,Cuba,2,4,14,20,07/07/2023,0,0,4,4,15,7,13,35,1,3,3,7,0,1,0,1,3,4,2,9
8478,143794,2023,Argentina,Serbia,2,3,10,15,04/07/2023,0,0,3,3,8,11,6,25,2,2,4,8,0,0,0,0,4,4,0,8
8479,143794,2023,Netherlands,Serbia,1,7,14,22,25/06/2023,0,0,0,0,18,5,11,34,1,4,2,7,0,0,0,0,4,0,0,4
8480,143794,2023,Serbia,Italy,0,0,0,0,23/06/2023,0,0,0,0,0,0,0,0,0,0,0,0,0,0,0,0,0,0,0,0
8481,143794,2023,Serbia,Germany,1,4,10,15,22/06/2023,0,0,2,2,15,7,17,39,0,1,7,8,0,0,1,1,2,3,1,6
8482,143794,2023,USA,Serbia,3,3,9,15,20/06/2023,0,0,3,3,16,4,17,37,0,4,3,7,0,0,0,0,4,4,1,9
8483,143794,2023,Serbia,Poland,1,3,7,11,11/06/2023,0,0,2,2,18,3,9,30,0,1,1,2,0,0,0,0,6,0,0,6
8484,143794,2023,Japan,Serbia,0,4,10,14,09/06/2023,0,0,1,1,17,4,10,31,0,0,1,1,0,0,0,0,6,0,0,6
8485,143794,2023,Serbia,China,2,2,13,17,08/06/2023,0,0,2,2,16,5,8,29,1,0,2,3,0,0,2,2,3,0,1,4
8486,143794,2023,Slovenia,Serbia,0,4,12,16,07/06/2023,0,0,3,3,20,6,11,37,1,2,4,7,0,0,0,0,6,1,0,7
8487,116525,2023,Bulgaria,Serbia,0,0,0,0,08/07/2023,0,0,0,0,0,0,0,0,0,0,0,0,0,0,0,0,0,0,0,0
8488,116525,2023,Serbia,France,0,0,0,0,07/07/2023,0,0,0,0,0,0,0,0,0,0,0,0,0,0,0,0,0,0,0,0
8489,116525,2023,Serbia,Cuba,0,0,0,0,07/07/2023,0,0,0,0,0,0,0,0,0,0,0,0,0,0,0,0,0,0,0,0
8490,116525,2023,Argentina,Serbia,0,0,0,0,04/07/2023,0,0,0,0,0,0,0,0,0,0,0,0,0,0,0,0,0,0,0,0
8491,173250,2023,Bulgaria,Serbia,0,1,7,8,08/07/2023,20,0,41,61,1,0,0,1,0,4,3,7,0,0,0,0,3,1,0,4
8492,173250,2023,Serbia,France,0,1,13,14,07/07/2023,21,0,66,87,0,0,0,0,2,1,4,7,0,0,0,0,4,1,0,5
8493,173250,2023,Serbia,Cuba,2,3,12,17,07/07/2023,30,1,52,83,2,0,1,3,2,3,3,8,0,0,0,0,3,1,0,4
8494,173250,2023,Argentina,Serbia,0,0,7,7,04/07/2023,14,0,61,75,1,0,0,1,0,2,1,3,0,0,1,1,3,4,0,7
8495,173250,2023,Netherlands,Serbia,0,4,13,17,25/06/2023,33,0,67,100,1,0,1,2,0,3,4,7,0,0,0,0,9,3,1,13
8496,173250,2023,Serbia,Italy,0,0,0,0,23/06/2023,0,0,0,0,0,0,0,0,0,0,0,0,0,0,0,0,0,0,0,0
8497,173250,2023,Serbia,Germany,0,1,11,12,22/06/2023,17,0,57,74,0,0,0,0,1,3,1,5,0,1,1,2,7,8,0,15
8498,173250,2023,USA,Serbia,0,2,13,15,20/06/2023,25,0,64,89,0,0,2,2,0,3,3,6,0,0,1,1,8,7,1,16
8499,173250,2023,Serbia,Poland,1,1,14,16,11/06/2023,7,0,50,57,0,0,2,2,1,0,0,1,0,0,0,0,6,0,0,6
8500,173250,2023,Japan,Serbia,0,0,1,1,09/06/2023,2,0,3,5,0,0,0,0,0,0,0,0,0,0,0,0,1,0,0,1
8501,173250,2023,Serbia,China,0,0,10,10,08/06/2023,18,1,48,67,0,0,0,0,0,3,1,4,0,0,0,0,5,0,1,6
8502,173250,2023,Slovenia,Serbia,0,3,8,11,07/06/2023,10,0,76,86,1,0,0,1,2,1,1,4,0,0,0,0,1,0,0,1
8503,168276,2023,Bulgaria,Serbia,0,0,0,0,08/07/2023,0,0,0,0,0,0,0,0,0,0,0,0,0,0,0,0,0,0,0,0
8504,168276,2023,Serbia,France,0,0,0,0,07/07/2023,0,0,0,0,0,0,0,0,0,0,0,0,0,0,0,0,0,0,0,0
8505,168276,2023,Serbia,Cuba,0,0,0,0,07/07/2023,0,0,0,0,0,0,0,0,0,0,0,0,0,0,0,0,0,0,0,0
8506,168276,2023,Argentina,Serbia,0,1,1,2,04/07/2023,0,0,2,2,3,2,1,6,0,0,0,0,0,0,0,0,2,1,0,3
8507,168276,2023,Netherlands,Serbia,0,0,0,0,25/06/2023,0,0,0,0,0,0,0,0,0,0,0,0,0,0,0,0,0,0,0,0
8508,168276,2023,Serbia,Italy,0,5,3,8,23/06/2023,0,0,0,0,10,8,8,26,2,2,3,7,0,0,0,0,3,4,1,8
8509,168276,2023,Serbia,Germany,0,0,1,1,22/06/2023,0,0,0,0,0,0,0,0,0,0,0,0,0,0,0,0,0,0,0,0
8510,168276,2023,USA,Serbia,0,0,3,3,20/06/2023,0,0,0,0,1,1,2,4,1,0,0,1,0,0,0,0,0,1,0,1
8511,168276,2023,Serbia,Poland,0,0,0,0,11/06/2023,0,0,0,0,0,0,0,0,0,0,0,0,0,0,0,0,0,0,0,0
8512,168276,2023,Japan,Serbia,0,0,1,1,09/06/2023,0,0,0,0,1,0,0,1,0,1,1,2,0,0,0,0,0,0,0,0
8513,168276,2023,Serbia,China,0,1,1,2,08/06/2023,0,0,0,0,0,1,1,2,0,0,0,0,0,0,0,0,2,0,0,2
8514,168276,2023,Slovenia,Serbia,0,0,5,5,07/06/2023,0,0,1,1,3,1,1,5,0,1,0,1,0,0,0,0,1,0,0,1
8515,164985,2023,Bulgaria,Serbia,1,1,9,11,08/07/2023,0,0,0,0,6,0,2,8,0,4,6,10,0,0,0,0,2,0,1,3
8516,164985,2023,Serbia,France,0,2,14,16,07/07/2023,0,0,1,1,7,0,1,8,3,5,3,11,0,0,1,1,2,2,0,4
8517,164985,2023,Serbia,Cuba,1,2,14,17,07/07/2023,0,0,3,3,6,0,1,7,6,4,3,13,0,0,0,0,2,0,0,2
8518,164985,2023,Argentina,Serbia,1,1,10,12,04/07/2023,0,0,1,1,4,3,1,8,2,4,7,13,0,0,0,0,3,0,0,3
8519,164985,2023,Netherlands,Serbia,0,0,12,12,25/06/2023,0,0,1,1,7,1,2,10,1,5,9,15,0,0,1,1,2,0,1,3
8520,164985,2023,Serbia,Italy,0,0,6,6,23/06/2023,0,0,0,0,3,0,2,5,3,2,2,7,0,0,0,0,0,1,1,2
8521,164985,2023,Serbia,Germany,0,1,10,11,22/06/2023,0,0,0,0,7,1,4,12,4,4,7,15,0,0,0,0,2,0,1,3
8522,164985,2023,USA,Serbia,0,3,5,8,20/06/2023,0,0,1,1,5,0,1,6,0,2,4,6,0,0,0,0,3,0,0,3
8523,164985,2023,Serbia,Poland,0,0,11,11,11/06/2023,0,0,2,2,4,0,1,5,4,5,5,14,0,0,0,0,1,0,0,1
8524,164985,2023,Japan,Serbia,0,0,13,13,09/06/2023,0,0,0,0,1,0,5,6,2,3,0,5,1,0,1,2,1,0,0,1
8525,164985,2023,Serbia,China,1,0,11,12,08/06/2023,0,0,0,0,8,0,4,12,3,1,3,7,0,0,1,1,1,0,0,1
8526,164985,2023,Slovenia,Serbia,0,0,16,16,07/06/2023,0,0,0,0,3,1,3,7,1,4,7,12,0,0,2,2,0,0,0,0
8527,114962,2023,Japan,Slovenia,0,2,5,7,20/07/2023,0,0,0,0,11,0,5,16,1,10,8,19,2,0,3,5,3,0,0,3
8528,114962,2023,Slovenia,Netherlands,0,2,9,11,09/07/2023,0,0,2,2,5,1,0,6,4,4,3,11,1,0,0,1,1,0,0,1
8529,114962,2023,Slovenia,Italy,0,2,6,8,07/07/2023,0,0,0,0,1,1,4,6,1,2,3,6,0,0,0,0,3,1,0,4
8530,114962,2023,China,Slovenia,0,3,14,17,06/07/2023,0,0,0,0,5,3,4,12,1,5,4,10,0,0,0,0,3,0,2,5
8531,114962,2023,Poland,Slovenia,0,2,11,13,05/07/2023,0,0,1,1,7,0,3,10,1,3,8,12,0,0,1,1,3,2,2,7
8532,114962,2023,Brazil,Slovenia,0,3,10,13,24/06/2023,0,0,2,2,6,1,0,7,0,2,4,6,0,0,0,0,0,2,0,2
8533,114962,2023,Slovenia,Cuba,1,1,19,21,22/06/2023,0,0,1,1,4,0,4,8,1,2,0,3,0,0,2,2,0,0,0,0
8534,114962,2023,Slovenia,Canada,2,1,5,8,21/06/2023,0,0,1,1,5,0,4,9,2,3,6,11,2,0,0,2,1,0,0,1
8535,114962,2023,Argentina,Slovenia,0,4,13,17,20/06/2023,0,0,1,1,7,1,2,10,0,1,4,5,1,0,0,1,3,1,1,5
8536,114962,2023,Slovenia,Iran,0,2,7,9,11/06/2023,0,0,0,0,2,0,2,4,1,3,4,8,0,0,0,0,5,1,0,6
8537,114962,2023,France,Slovenia,0,2,15,17,10/06/2023,0,0,0,0,3,1,3,7,2,3,2,7,0,0,2,2,1,0,0,1
8538,114962,2023,Slovenia,Bulgaria,0,2,6,8,08/06/2023,0,0,0,0,4,1,3,8,0,0,4,4,1,0,2,3,1,0,0,1
8539,114962,2023,Slovenia,Serbia,0,4,12,16,07/06/2023,0,0,0,0,6,1,6,13,4,3,5,12,0,0,0,0,7,0,0,7
8540,168715,2023,Japan,Slovenia,0,1,6,7,20/07/2023,7,0,26,33,0,0,0,0,0,3,2,5,0,0,0,0,1,0,0,1
8541,168715,2023,Slovenia,Netherlands,0,1,1,2,09/07/2023,0,0,0,0,0,0,0,0,0,0,0,0,0,0,0,0,1,0,0,1
8542,168715,2023,Slovenia,Italy,0,1,0,1,07/07/2023,1,0,5,6,0,0,1,1,0,1,1,2,0,0,0,0,0,1,0,1
8543,168715,2023,China,Slovenia,0,0,2,2,06/07/2023,4,0,14,18,0,0,0,0,0,1,1,2,0,0,0,0,2,0,0,2
8544,168715,2023,Poland,Slovenia,0,1,2,3,05/07/2023,2,0,18,20,0,0,0,0,1,0,2,3,0,0,0,0,0,0,0,0
8545,168715,2023,Brazil,Slovenia,0,0,2,2,24/06/2023,2,0,4,6,0,0,0,0,0,0,0,0,0,0,0,0,1,1,0,2
8546,168715,2023,Slovenia,Cuba,0,0,0,0,22/06/2023,0,0,0,0,0,0,0,0,0,0,0,0,0,0,0,0,0,0,0,0
8547,168715,2023,Slovenia,Canada,0,0,0,0,21/06/2023,0,0,0,0,0,0,0,0,0,0,0,0,0,0,0,0,0,0,0,0
8548,168715,2023,Argentina,Slovenia,0,0,1,1,20/06/2023,0,0,2,2,0,0,0,0,0,0,0,0,0,0,0,0,0,0,0,0
8549,168715,2023,Slovenia,Iran,0,1,0,1,11/06/2023,0,0,0,0,0,0,0,0,0,0,0,0,0,0,0,0,0,0,0,0
8550,168715,2023,France,Slovenia,0,2,12,14,10/06/2023,10,0,67,77,0,0,1,1,3,1,1,5,0,0,0,0,3,0,1,4
8551,168715,2023,Slovenia,Bulgaria,0,0,0,0,08/06/2023,0,0,3,3,0,0,0,0,0,1,0,1,0,0,0,0,1,0,0,1
8552,168715,2023,Slovenia,Serbia,0,0,1,1,07/06/2023,0,0,1,1,0,0,0,0,0,0,0,0,0,0,0,0,1,0,0,1
8553,151391,2023,Japan,Slovenia,0,2,11,13,20/07/2023,0,0,1,1,2,0,1,3,1,3,3,7,0,0,0,0,0,0,0,0
8554,151391,2023,Slovenia,Netherlands,0,1,15,16,09/07/2023,0,0,0,0,7,0,2,9,0,1,3,4,0,0,0,0,0,1,0,1
8555,151391,2023,Slovenia,Italy,0,1,4,5,07/07/2023,0,0,2,2,1,4,1,6,1,0,3,4,0,0,2,2,1,0,0,1
8556,151391,2023,China,Slovenia,4,3,16,23,06/07/2023,0,0,7,7,8,1,1,10,1,3,4,8,0,1,2,3,6,1,0,7
8557,151391,2023,Poland,Slovenia,2,3,20,25,05/07/2023,0,0,3,3,5,0,6,11,4,6,5,15,0,0,4,4,7,1,1,9
8558,151391,2023,Brazil,Slovenia,0,2,15,17,24/06/2023,0,0,4,4,3,1,2,6,1,5,6,12,0,0,4,4,2,3,0,5
8559,151391,2023,Slovenia,Cuba,0,2,13,15,22/06/2023,0,0,2,2,3,0,2,5,6,1,5,12,0,0,0,0,0,1,1,2
8560,151391,2023,Slovenia,Canada,0,0,16,16,21/06/2023,0,0,2,2,4,0,2,6,1,7,6,14,2,0,3,5,4,1,0,5
8561,151391,2023,Argentina,Slovenia,1,2,14,17,20/06/2023,0,0,2,2,3,0,7,10,4,1,6,11,0,0,0,0,1,1,1,3
8562,151391,2023,Slovenia,Iran,1,2,13,16,11/06/2023,0,0,1,1,4,0,1,5,1,3,1,5,0,0,0,0,3,0,0,3
8563,151391,2023,France,Slovenia,0,4,16,20,10/06/2023,0,0,2,2,5,2,4,11,3,3,13,19,0,0,1,1,0,0,0,0
8564,151391,2023,Slovenia,Bulgaria,1,1,10,12,08/06/2023,0,0,1,1,4,0,2,6,0,2,4,6,0,0,1,1,2,0,0,2
8565,151391,2023,Slovenia,Serbia,1,2,19,22,07/06/2023,0,0,0,0,6,0,3,9,1,10,6,17,1,0,0,1,5,0,0,5
8566,151405,2023,Japan,Slovenia,0,0,0,0,20/07/2023,0,0,0,0,0,0,0,0,0,0,0,0,0,0,0,0,0,0,0,0
8567,151405,2023,Slovenia,Netherlands,0,1,0,1,09/07/2023,0,0,0,0,0,0,0,0,0,0,0,0,0,0,0,0,0,0,0,0
8568,151405,2023,Slovenia,Italy,0,0,0,0,07/07/2023,0,0,0,0,0,0,0,0,0,0,0,0,0,0,0,0,0,0,0,0
8569,151405,2023,China,Slovenia,0,0,0,0,06/07/2023,0,0,0,0,0,0,0,0,0,0,0,0,0,0,0,0,0,0,0,0
8570,151405,2023,Poland,Slovenia,0,0,0,0,05/07/2023,0,0,0,0,0,0,0,0,0,0,0,0,0,0,0,0,0,0,0,0
8571,151405,2023,Brazil,Slovenia,0,0,0,0,24/06/2023,0,0,0,0,0,0,0,0,0,0,0,0,0,0,0,0,0,0,0,0
8572,151405,2023,Slovenia,Cuba,0,0,1,1,22/06/2023,0,0,0,0,0,0,0,0,0,0,0,0,0,0,0,0,1,0,0,1
8573,151405,2023,Slovenia,Canada,0,0,0,0,21/06/2023,0,0,0,0,1,0,1,2,0,1,0,1,0,0,0,0,0,0,0,0
8574,151405,2023,Argentina,Slovenia,0,1,4,5,20/06/2023,0,0,0,0,0,0,0,0,0,0,0,0,0,0,0,0,0,0,0,0
8575,151405,2023,Slovenia,Iran,0,0,0,0,11/06/2023,0,0,0,0,0,0,0,0,0,0,0,0,0,0,0,0,0,0,0,0
8576,151405,2023,France,Slovenia,0,0,0,0,10/06/2023,0,0,0,0,0,0,0,0,0,0,0,0,0,0,0,0,0,0,0,0
8577,151405,2023,Slovenia,Bulgaria,0,2,9,11,08/06/2023,0,0,1,1,5,5,5,15,0,1,0,1,0,0,1,1,0,0,1,1
8578,151405,2023,Slovenia,Serbia,0,0,1,1,07/06/2023,0,0,0,0,0,1,1,2,0,1,1,2,0,0,0,0,0,0,0,0
8579,161756,2023,Japan,Slovenia,0,0,0,0,20/07/2023,0,0,0,0,0,0,0,0,0,0,0,0,0,0,0,0,0,0,0,0
8580,161756,2023,Slovenia,Netherlands,0,0,0,0,09/07/2023,0,0,0,0,0,0,0,0,0,0,0,0,0,0,0,0,0,0,0,0
8581,161756,2023,Slovenia,Italy,0,0,0,0,07/07/2023,0,0,0,0,0,0,0,0,0,0,0,0,0,0,0,0,0,0,0,0
8582,161756,2023,China,Slovenia,0,0,0,0,06/07/2023,0,0,0,0,0,0,0,0,0,0,0,0,0,0,0,0,0,0,0,0
8583,161756,2023,Poland,Slovenia,0,0,0,0,05/07/2023,0,0,0,0,0,0,0,0,0,0,0,0,0,0,0,0,0,0,0,0
8584,161756,2023,Brazil,Slovenia,0,0,0,0,24/06/2023,0,0,0,0,0,0,0,0,0,0,0,0,0,0,0,0,0,0,0,0
8585,161756,2023,Slovenia,Cuba,0,0,0,0,22/06/2023,0,0,0,0,0,0,0,0,0,0,0,0,0,0,0,0,0,0,0,0
8586,161756,2023,Slovenia,Canada,0,0,0,0,21/06/2023,0,0,0,0,0,0,0,0,0,0,0,0,1,1,1,3,0,0,0,0
8587,161756,2023,Argentina,Slovenia,0,0,0,0,20/06/2023,0,0,0,0,0,0,0,0,0,0,0,0,0,0,0,0,0,0,0,0
8588,161756,2023,Slovenia,Iran,0,0,0,0,11/06/2023,0,0,0,0,0,0,0,0,0,0,0,0,0,0,0,0,0,0,0,0
8589,161756,2023,France,Slovenia,0,0,0,0,10/06/2023,0,0,0,0,0,0,0,0,0,0,0,0,0,0,0,0,0,0,0,0
8590,161756,2023,Slovenia,Bulgaria,0,0,0,0,08/06/2023,0,0,0,0,0,0,0,0,0,0,0,0,0,0,0,0,0,0,0,0
8591,161756,2023,Slovenia,Serbia,0,0,0,0,07/06/2023,0,0,0,0,0,0,0,0,0,0,0,0,0,0,0,0,0,0,0,0
8592,151404,2023,Japan,Slovenia,0,0,0,0,20/07/2023,0,0,0,0,0,0,0,0,0,0,0,0,0,0,0,0,0,0,0,0
8593,151404,2023,Slovenia,Netherlands,0,0,0,0,09/07/2023,0,0,0,0,0,0,0,0,0,0,0,0,0,0,0,0,0,0,0,0
8594,151404,2023,Slovenia,Italy,0,0,5,5,07/07/2023,0,0,1,1,4,1,3,8,0,4,2,6,0,0,0,0,0,1,1,2
8595,151404,2023,China,Slovenia,0,0,0,0,06/07/2023,0,0,0,0,0,0,0,0,0,0,0,0,0,0,0,0,0,0,0,0
8596,151404,2023,Poland,Slovenia,0,0,0,0,05/07/2023,0,0,0,0,0,0,0,0,0,0,0,0,0,0,0,0,0,0,0,0
8597,151404,2023,Brazil,Slovenia,0,0,0,0,24/06/2023,0,0,0,0,0,0,0,0,0,0,0,0,0,0,0,0,0,0,0,0
8598,151404,2023,Slovenia,Cuba,0,0,0,0,22/06/2023,0,0,0,0,0,0,0,0,0,0,0,0,0,0,0,0,0,0,0,0
8599,151404,2023,Slovenia,Canada,0,1,0,1,21/06/2023,0,0,0,0,1,0,1,2,0,0,0,0,0,0,0,0,0,0,0,0
8600,151404,2023,Argentina,Slovenia,0,0,0,0,20/06/2023,0,0,0,0,0,0,0,0,0,0,0,0,0,0,0,0,0,0,0,0
8601,151404,2023,Slovenia,Iran,0,0,0,0,11/06/2023,0,0,0,0,0,0,0,0,0,0,0,0,0,0,0,0,0,0,0,0
8602,151404,2023,France,Slovenia,0,0,0,0,10/06/2023,0,0,0,0,0,0,0,0,0,0,0,0,0,0,0,0,0,0,0,0
8603,151404,2023,Slovenia,Bulgaria,0,0,0,0,08/06/2023,0,0,0,0,0,0,0,0,0,0,0,0,0,0,0,0,0,0,0,0
8604,151404,2023,Slovenia,Serbia,0,0,0,0,07/06/2023,0,0,0,0,0,0,0,0,0,0,0,0,0,0,0,0,0,0,0,0
8605,144483,2023,Japan,Slovenia,0,0,0,0,20/07/2023,0,0,0,0,0,0,0,0,0,0,0,0,0,0,0,0,0,0,0,0
8606,144483,2023,Slovenia,Netherlands,0,0,0,0,09/07/2023,0,0,0,0,0,0,0,0,0,0,0,0,0,0,0,0,0,0,0,0
8607,144483,2023,Slovenia,Italy,0,0,0,0,07/07/2023,0,0,0,0,0,0,0,0,0,0,0,0,0,0,0,0,0,0,0,0
8608,144483,2023,China,Slovenia,0,0,0,0,06/07/2023,0,0,0,0,0,0,0,0,0,0,0,0,0,0,0,0,0,0,0,0
8609,144483,2023,Poland,Slovenia,0,0,0,0,05/07/2023,0,0,0,0,0,0,0,0,0,0,0,0,0,0,0,0,0,0,0,0
8610,144483,2023,Brazil,Slovenia,0,0,0,0,24/06/2023,0,0,0,0,0,0,0,0,0,0,0,0,0,0,0,0,0,0,0,0
8611,144483,2023,Slovenia,Cuba,0,0,0,0,22/06/2023,0,0,0,0,0,0,0,0,0,0,0,0,0,0,0,0,0,0,0,0
8612,144483,2023,Slovenia,Canada,0,0,0,0,21/06/2023,0,0,0,0,0,0,0,0,0,0,0,0,0,0,0,0,0,0,0,0
8613,144483,2023,Argentina,Slovenia,0,0,0,0,20/06/2023,0,0,0,0,0,0,0,0,0,0,0,0,0,0,0,0,0,0,0,0
8614,144483,2023,Slovenia,Iran,0,0,0,0,11/06/2023,0,0,0,0,0,0,0,0,0,0,0,0,0,0,0,0,0,0,0,0
8615,144483,2023,France,Slovenia,0,0,0,0,10/06/2023,0,0,0,0,0,0,0,0,0,0,0,0,0,0,0,0,0,0,0,0
8616,144483,2023,Slovenia,Bulgaria,0,0,0,0,08/06/2023,0,0,0,0,0,0,0,0,0,0,0,0,0,0,0,0,0,0,0,0
8617,144483,2023,Slovenia,Serbia,0,0,0,0,07/06/2023,0,0,0,0,0,0,0,0,0,0,0,0,0,0,0,0,0,0,0,0
8618,144415,2023,Japan,Slovenia,0,0,0,0,20/07/2023,0,0,11,11,0,0,0,0,0,0,0,0,5,1,4,10,9,7,1,17
8619,144415,2023,Slovenia,Netherlands,0,0,0,0,09/07/2023,0,0,6,6,0,0,0,0,0,0,0,0,7,0,16,23,3,1,1,5
8620,144415,2023,Slovenia,Italy,0,0,0,0,07/07/2023,0,0,7,7,0,0,0,0,0,0,0,0,7,1,11,19,7,2,2,11
8621,144415,2023,China,Slovenia,0,0,0,0,06/07/2023,0,1,9,10,0,0,0,0,0,0,0,0,9,2,11,22,13,2,1,16
8622,144415,2023,Poland,Slovenia,0,0,0,0,05/07/2023,0,0,6,6,0,0,0,0,0,0,0,0,14,2,12,28,16,5,2,23
8623,144415,2023,Brazil,Slovenia,0,0,0,0,24/06/2023,0,0,7,7,0,0,0,0,0,0,0,0,4,2,16,22,15,8,0,23
8624,144415,2023,Slovenia,Cuba,0,0,0,0,22/06/2023,0,0,6,6,0,0,0,0,0,0,0,0,4,2,13,19,9,1,1,11
8625,144415,2023,Slovenia,Canada,0,0,0,0,21/06/2023,0,0,3,3,0,0,0,0,0,0,0,0,2,0,5,7,5,3,5,13
8626,144415,2023,Argentina,Slovenia,0,0,0,0,20/06/2023,0,0,3,3,0,0,0,0,0,0,0,0,7,0,10,17,9,5,1,15
8627,144415,2023,Slovenia,Iran,0,0,0,0,11/06/2023,0,0,3,3,0,0,0,0,0,0,0,0,6,0,13,19,9,1,1,11
8628,144415,2023,France,Slovenia,0,0,0,0,10/06/2023,0,0,10,10,0,0,0,0,0,0,0,0,5,1,5,11,12,0,0,12
8629,144415,2023,Slovenia,Bulgaria,0,0,0,0,08/06/2023,0,0,1,1,0,0,0,0,0,0,0,0,6,1,9,16,11,2,0,13
8630,144415,2023,Slovenia,Serbia,0,0,0,0,07/06/2023,0,0,3,3,0,0,0,0,0,0,0,0,11,0,12,23,10,1,1,12
8631,155920,2023,Japan,Slovenia,0,0,4,4,20/07/2023,0,0,0,0,0,1,2,3,0,1,1,2,2,0,6,8,0,1,0,1
8632,155920,2023,Slovenia,Netherlands,0,0,0,0,09/07/2023,0,0,0,0,0,0,0,0,0,0,0,0,0,0,0,0,0,0,0,0
8633,155920,2023,Slovenia,Italy,0,0,1,1,07/07/2023,0,0,0,0,2,0,6,8,0,1,0,1,2,2,4,8,0,0,0,0
8634,155920,2023,China,Slovenia,1,0,15,16,06/07/2023,0,0,8,8,17,3,13,33,0,8,3,11,8,0,10,18,3,1,1,5
8635,155920,2023,Poland,Slovenia,0,1,2,3,05/07/2023,0,0,2,2,3,1,0,4,1,0,0,1,1,0,2,3,0,0,0,0
8636,155920,2023,Brazil,Slovenia,0,2,5,7,24/06/2023,0,0,1,1,6,0,7,13,0,3,2,5,3,1,6,10,0,1,1,2
8637,155920,2023,Slovenia,Cuba,0,3,5,8,22/06/2023,0,0,1,1,12,2,7,21,1,2,1,4,3,0,8,11,4,3,0,7
8638,155920,2023,Slovenia,Canada,0,0,1,1,21/06/2023,0,0,0,0,3,0,0,3,1,0,2,3,0,0,0,0,0,0,1,1
8639,155920,2023,Argentina,Slovenia,0,0,0,0,20/06/2023,0,0,0,0,0,0,0,0,1,0,0,1,0,0,0,0,0,0,0,0
8640,155920,2023,Slovenia,Iran,0,0,0,0,11/06/2023,0,0,0,0,0,0,0,0,0,0,0,0,0,0,0,0,0,0,0,0
8641,155920,2023,France,Slovenia,0,0,0,0,10/06/2023,0,0,0,0,0,0,0,0,0,0,0,0,0,0,0,0,0,0,0,0
8642,155920,2023,Slovenia,Bulgaria,0,0,1,1,08/06/2023,0,0,0,0,1,0,0,1,0,0,0,0,1,0,2,3,0,0,0,0
8643,155920,2023,Slovenia,Serbia,0,0,0,0,07/06/2023,0,0,0,0,0,0,0,0,0,0,0,0,0,0,0,0,0,0,0,0
8644,119018,2023,Japan,Slovenia,0,0,6,6,20/07/2023,9,1,35,45,0,0,1,1,0,2,2,4,0,0,0,0,3,3,0,6
8645,119018,2023,Slovenia,Netherlands,0,0,11,11,09/07/2023,21,0,41,62,0,0,2,2,0,4,1,5,0,0,1,1,4,7,0,11
8646,119018,2023,Slovenia,Italy,0,1,7,8,07/07/2023,20,1,46,67,0,0,0,0,0,1,3,4,0,0,0,0,7,3,3,13
8647,119018,2023,China,Slovenia,0,2,7,9,06/07/2023,22,0,61,83,1,0,0,1,0,1,2,3,0,0,0,0,6,1,1,8
8648,119018,2023,Poland,Slovenia,0,0,13,13,05/07/2023,21,1,81,103,1,0,0,1,0,1,2,3,0,0,0,0,5,6,0,11
8649,119018,2023,Brazil,Slovenia,0,1,13,14,24/06/2023,24,1,52,77,0,0,2,2,1,2,6,9,0,0,0,0,11,4,0,15
8650,119018,2023,Slovenia,Cuba,0,2,12,14,22/06/2023,16,0,50,66,1,1,0,2,1,0,4,5,0,0,0,0,2,4,1,7
8651,119018,2023,Slovenia,Canada,1,2,6,9,21/06/2023,21,0,41,62,0,0,1,1,0,1,2,3,0,0,1,1,7,2,2,11
8652,119018,2023,Argentina,Slovenia,0,0,11,11,20/06/2023,22,0,58,80,0,0,2,2,1,1,1,3,0,0,1,1,8,2,3,13
8653,119018,2023,Slovenia,Iran,0,0,8,8,11/06/2023,14,1,61,76,0,0,0,0,2,1,1,4,0,0,0,0,6,0,1,7
8654,119018,2023,France,Slovenia,0,0,1,1,10/06/2023,2,0,7,9,0,0,0,0,1,0,1,2,0,0,0,0,1,0,0,1
8655,119018,2023,Slovenia,Bulgaria,0,3,6,9,08/06/2023,17,0,52,69,1,0,1,2,0,0,2,2,0,0,1,1,0,0,1,1
8656,119018,2023,Slovenia,Serbia,0,2,9,11,07/06/2023,14,1,96,111,2,1,1,4,0,4,4,8,0,0,1,1,3,0,1,4
8657,114957,2023,Japan,Slovenia,0,3,8,11,20/07/2023,0,0,4,4,12,4,14,30,0,2,4,6,2,0,12,14,7,2,1,10
8658,114957,2023,Slovenia,Netherlands,2,1,13,16,09/07/2023,0,0,3,3,12,5,4,21,0,0,1,1,3,3,9,15,4,5,1,10
8659,114957,2023,Slovenia,Italy,0,2,8,10,07/07/2023,0,0,5,5,10,3,11,24,0,1,2,3,1,0,16,17,5,1,0,6
8660,114957,2023,China,Slovenia,0,3,15,18,06/07/2023,0,0,5,5,13,1,17,31,0,4,2,6,10,1,18,29,7,2,0,9
8661,114957,2023,Poland,Slovenia,2,5,13,20,05/07/2023,0,1,6,7,14,6,21,41,0,5,2,7,5,3,20,28,6,4,0,10
8662,114957,2023,Brazil,Slovenia,1,2,12,15,24/06/2023,0,0,7,7,15,2,10,27,1,4,2,7,3,1,17,21,6,3,0,9
8663,114957,2023,Slovenia,Cuba,3,6,10,19,22/06/2023,0,0,5,5,16,0,5,21,0,4,2,6,3,1,11,15,3,3,0,6
8664,114957,2023,Slovenia,Canada,0,1,12,13,21/06/2023,0,0,3,3,9,3,12,24,0,1,0,1,5,0,10,15,4,2,0,6
8665,114957,2023,Argentina,Slovenia,1,3,11,15,20/06/2023,0,0,6,6,11,6,7,24,0,3,0,3,10,2,16,28,5,0,0,5
8666,114957,2023,Slovenia,Iran,5,4,5,14,11/06/2023,0,0,6,6,6,5,10,21,2,3,1,6,6,1,13,20,6,0,0,6
8667,114957,2023,France,Slovenia,1,4,7,12,10/06/2023,0,0,1,1,14,2,12,28,1,0,0,1,8,2,21,31,8,0,3,11
8668,114957,2023,Slovenia,Bulgaria,2,1,7,10,08/06/2023,0,0,2,2,11,5,6,22,0,1,1,2,4,1,9,14,3,0,1,4
8669,114957,2023,Slovenia,Serbia,1,2,16,19,07/06/2023,0,0,8,8,21,5,9,35,0,1,1,2,5,0,16,21,12,0,2,14
8670,136918,2023,Japan,Slovenia,0,1,9,10,20/07/2023,0,0,3,3,8,2,12,22,1,0,0,1,4,1,12,17,3,4,1,8
8671,136918,2023,Slovenia,Netherlands,1,5,9,15,09/07/2023,0,0,4,4,8,2,5,15,4,3,2,9,2,0,5,7,3,2,0,5
8672,136918,2023,Slovenia,Italy,1,2,8,11,07/07/2023,0,0,6,6,8,6,6,20,3,3,2,8,0,1,3,4,5,2,0,7
8673,136918,2023,China,Slovenia,1,3,9,13,06/07/2023,0,0,3,3,18,8,18,44,2,2,2,6,0,1,4,5,5,6,3,14
8674,136918,2023,Poland,Slovenia,0,7,10,17,05/07/2023,0,1,5,6,19,8,17,44,1,2,1,4,1,0,10,11,9,3,2,14
8675,136918,2023,Brazil,Slovenia,0,4,14,18,24/06/2023,0,0,4,4,18,7,12,37,0,7,1,8,2,0,10,12,1,3,1,5
8676,136918,2023,Slovenia,Cuba,1,5,10,16,22/06/2023,0,0,4,4,12,2,6,20,1,2,2,5,2,0,3,5,2,6,1,9
8677,136918,2023,Slovenia,Canada,2,2,12,16,21/06/2023,0,0,2,2,9,2,4,15,1,1,1,3,6,0,6,12,3,3,2,8
8678,136918,2023,Argentina,Slovenia,3,5,12,20,20/06/2023,0,0,3,3,12,4,8,24,3,2,2,7,5,0,4,9,2,3,1,6
8679,136918,2023,Slovenia,Iran,0,4,9,13,11/06/2023,0,0,5,5,8,1,16,25,1,1,5,7,0,0,9,9,7,0,1,8
8680,136918,2023,France,Slovenia,0,5,10,15,10/06/2023,0,0,3,3,7,4,17,28,0,2,1,3,2,0,7,9,11,0,1,12
8681,136918,2023,Slovenia,Bulgaria,0,0,4,4,08/06/2023,0,1,1,2,7,1,1,9,1,2,2,5,2,0,6,8,4,0,0,4
8682,136918,2023,Slovenia,Serbia,0,3,11,14,07/06/2023,0,0,1,1,11,7,5,23,0,4,1,5,2,0,12,14,6,0,0,6
8683,168747,2023,Japan,Slovenia,0,1,7,8,20/07/2023,0,0,2,2,8,2,11,21,2,7,0,9,3,0,6,9,7,2,1,10
8684,168747,2023,Slovenia,Netherlands,1,2,5,8,09/07/2023,0,0,1,1,8,6,9,23,2,6,1,9,1,0,6,7,5,2,0,7
8685,168747,2023,Slovenia,Italy,0,2,3,5,07/07/2023,0,0,0,0,5,3,12,20,1,2,1,4,1,2,12,15,4,1,0,5
8686,168747,2023,China,Slovenia,0,0,0,0,06/07/2023,0,0,0,0,0,0,0,0,0,0,0,0,0,0,0,0,0,0,0,0
8687,168747,2023,Poland,Slovenia,1,0,18,19,05/07/2023,0,0,2,2,15,3,13,31,1,3,2,6,1,1,15,17,3,5,1,9
8688,168747,2023,Brazil,Slovenia,0,2,4,6,24/06/2023,0,0,1,1,7,1,7,15,0,1,3,4,1,0,5,6,2,1,0,3
8689,168747,2023,Slovenia,Cuba,0,2,1,3,22/06/2023,0,0,0,0,1,0,5,6,0,2,0,2,0,1,4,5,0,1,1,2
8690,168747,2023,Slovenia,Canada,2,3,5,10,21/06/2023,0,0,3,3,16,1,5,22,1,2,6,9,1,1,6,8,4,1,1,6
8691,168747,2023,Argentina,Slovenia,0,4,5,9,20/06/2023,0,0,2,2,16,1,11,28,0,2,2,4,7,0,4,11,4,0,1,5
8692,168747,2023,Slovenia,Iran,4,3,5,12,11/06/2023,0,0,2,2,20,3,10,33,1,7,1,9,3,0,6,9,4,0,0,4
8693,168747,2023,France,Slovenia,2,7,7,16,10/06/2023,0,0,3,3,17,5,10,32,2,0,1,3,4,0,8,12,6,0,1,7
8694,168747,2023,Slovenia,Bulgaria,0,1,9,10,08/06/2023,0,0,0,0,5,4,6,15,2,2,0,4,5,2,8,15,3,0,1,4
8695,168747,2023,Slovenia,Serbia,0,4,11,15,07/06/2023,0,0,0,0,22,2,19,43,2,2,0,4,6,1,17,24,1,0,0,1
8696,182325,2023,Japan,Slovenia,0,0,0,0,20/07/2023,0,0,0,0,0,0,0,0,0,0,0,0,0,0,0,0,0,0,0,0
8697,182325,2023,Slovenia,Netherlands,0,0,0,0,09/07/2023,0,0,0,0,0,0,0,0,0,0,0,0,0,0,0,0,0,0,0,0
8698,182325,2023,Slovenia,Italy,0,0,0,0,07/07/2023,0,0,0,0,0,0,0,0,0,0,0,0,0,0,0,0,0,0,0,0
8699,182325,2023,China,Slovenia,0,0,0,0,06/07/2023,0,0,0,0,0,0,0,0,0,0,0,0,0,0,0,0,0,0,0,0
8700,182325,2023,Poland,Slovenia,0,0,0,0,05/07/2023,0,0,0,0,0,0,0,0,0,0,0,0,0,0,0,0,0,0,0,0
8701,182325,2023,Brazil,Slovenia,0,0,0,0,24/06/2023,0,0,0,0,0,0,0,0,0,0,0,0,0,0,0,0,0,0,0,0
8702,182325,2023,Slovenia,Cuba,0,0,0,0,22/06/2023,0,0,0,0,1,0,0,1,0,0,0,0,0,0,0,0,0,0,0,0
8703,182325,2023,Slovenia,Canada,0,0,0,0,21/06/2023,0,0,0,0,0,0,0,0,0,0,0,0,0,0,0,0,0,0,0,0
8704,182325,2023,Argentina,Slovenia,0,0,0,0,20/06/2023,0,0,0,0,0,0,0,0,0,0,0,0,0,0,0,0,0,0,0,0
8705,118893,2023,Poland,USA,1,1,10,12,23/07/2023,0,0,0,0,9,6,7,22,0,3,0,3,0,1,5,6,3,2,1,6
8706,118893,2023,USA,Italy,0,2,11,13,22/07/2023,0,0,1,1,17,1,7,25,0,2,3,5,0,0,1,1,8,2,0,10
8707,118893,2023,USA,France,2,2,10,14,19/07/2023,0,0,3,3,20,2,15,37,0,1,3,4,0,0,1,1,7,3,0,10
8708,118893,2023,USA,Bulgaria,1,2,6,9,10/07/2023,0,0,0,0,6,2,3,11,1,3,6,10,0,0,0,0,2,0,1,3
8709,118893,2023,USA,France,1,1,11,13,09/07/2023,0,0,3,3,7,2,5,14,0,2,0,2,0,0,2,2,4,2,0,6
8710,118893,2023,USA,Argentina,2,6,13,21,08/07/2023,0,0,4,4,17,8,13,38,0,2,8,10,0,0,3,3,7,1,2,10
8711,118893,2023,USA,Cuba,4,4,11,19,06/07/2023,0,0,0,0,9,2,8,19,0,4,3,7,0,0,2,2,4,0,0,4
8712,118893,2023,Poland,USA,2,0,13,15,24/06/2023,0,0,3,3,7,3,5,15,0,3,4,7,0,0,1,1,9,2,0,11
8713,118893,2023,Iran,USA,0,2,5,7,23/06/2023,0,0,1,1,13,2,7,22,0,3,0,3,0,0,2,2,4,3,0,7
8714,118893,2023,USA,China,0,0,2,2,21/06/2023,0,0,1,1,1,0,0,1,0,0,0,0,0,0,0,0,0,1,0,1
8715,118893,2023,USA,Serbia,2,2,16,20,20/06/2023,0,0,5,5,10,4,8,22,4,0,5,9,0,0,2,2,7,7,2,16
8716,118893,2023,USA,Brazil,0,0,0,0,11/06/2023,0,0,0,0,0,0,0,0,0,0,0,0,0,0,0,0,0,0,0,0
8717,118893,2023,Canada,USA,1,3,9,13,11/06/2023,0,0,2,2,14,3,6,23,3,3,3,9,0,0,4,4,6,1,0,7
8718,118893,2023,Italy,USA,1,3,2,6,08/06/2023,0,1,0,1,6,0,13,19,0,3,2,5,0,0,1,1,6,2,4,12
8719,118893,2023,USA,Netherlands,0,0,0,0,07/06/2023,0,0,0,0,0,0,0,0,0,0,0,0,0,0,0,0,0,0,0,0
8720,132624,2023,Poland,USA,0,2,4,6,23/07/2023,0,0,1,1,9,5,4,18,2,3,3,8,5,0,14,19,2,2,0,4
8721,132624,2023,USA,Italy,0,0,0,0,22/07/2023,0,0,0,0,0,0,0,0,0,0,0,0,0,0,0,0,0,0,0,0
8722,132624,2023,USA,Bulgaria,0,0,0,0,10/07/2023,0,0,0,0,0,0,0,0,0,0,0,0,0,0,0,0,0,0,0,0
8723,132624,2023,USA,France,1,3,6,10,09/07/2023,0,0,1,1,11,5,6,22,2,2,4,8,4,2,14,20,3,1,0,4
8724,132624,2023,USA,Argentina,0,0,0,0,08/07/2023,0,0,0,0,0,0,0,0,0,0,0,0,0,0,0,0,0,0,0,0
8725,132624,2023,USA,Cuba,1,5,5,11,06/07/2023,0,0,2,2,9,1,9,19,2,2,2,6,2,0,4,6,0,1,0,1
8726,132624,2023,Poland,USA,1,4,4,9,24/06/2023,0,0,0,0,8,4,7,19,2,1,1,4,1,1,13,15,8,1,0,9
8727,132624,2023,Iran,USA,7,1,14,22,23/06/2023,0,0,2,2,2,3,11,16,0,3,1,4,4,1,16,21,1,3,0,4
8728,132624,2023,USA,China,0,0,0,0,21/06/2023,0,0,0,0,0,0,0,0,0,0,0,0,0,0,0,0,0,0,0,0
8729,132624,2023,USA,Serbia,2,3,14,19,20/06/2023,0,0,3,3,13,1,12,26,0,1,1,2,3,3,13,19,6,2,0,8
8730,132624,2023,USA,Brazil,0,1,5,6,11/06/2023,0,0,3,3,7,1,10,18,0,3,3,6,2,3,10,15,3,0,0,3
8731,132624,2023,Canada,USA,1,3,8,12,11/06/2023,0,0,3,3,16,1,8,25,0,5,1,6,4,0,6,10,5,3,0,8
8732,132624,2023,Italy,USA,0,0,0,0,08/06/2023,0,0,0,0,0,0,0,0,0,0,0,0,0,0,0,0,0,0,0,0
8733,132624,2023,USA,Netherlands,0,4,5,9,07/06/2023,0,0,3,3,9,3,10,22,2,1,0,3,6,1,17,24,1,0,0,1
8734,147721,2023,Poland,USA,0,0,0,0,23/07/2023,0,0,0,0,0,0,0,0,0,0,0,0,0,0,0,0,0,0,0,0
8735,147721,2023,USA,Italy,0,0,0,0,22/07/2023,0,0,0,0,0,0,0,0,0,0,0,0,0,0,0,0,0,0,0,0
8736,147721,2023,USA,France,0,0,0,0,19/07/2023,0,0,0,0,0,0,0,0,0,0,0,0,0,0,0,0,0,0,0,0
8737,147721,2023,USA,Bulgaria,0,2,3,5,10/07/2023,0,0,2,2,6,1,5,12,2,0,2,4,0,0,0,0,4,0,0,4
8738,147721,2023,USA,France,0,0,0,0,09/07/2023,0,0,0,0,0,0,0,0,0,0,0,0,0,0,0,0,0,0,0,0
8739,147721,2023,USA,Argentina,0,0,3,3,08/07/2023,0,0,0,0,1,0,5,6,0,5,1,6,0,0,0,0,0,0,1,1
8740,147721,2023,USA,Cuba,0,0,0,0,06/07/2023,0,0,0,0,0,0,0,0,0,0,0,0,0,0,0,0,0,0,0,0
8741,147721,2023,Poland,USA,0,3,6,9,24/06/2023,0,0,1,1,4,0,3,7,1,3,4,8,0,0,0,0,1,0,0,1
8742,147721,2023,Iran,USA,0,0,0,0,23/06/2023,0,0,0,0,0,0,0,0,0,0,0,0,0,0,0,0,0,0,0,0
8743,147721,2023,USA,China,0,0,0,0,21/06/2023,0,0,0,0,0,0,0,0,0,0,0,0,0,0,0,0,0,0,0,0
8744,147721,2023,USA,Serbia,0,1,12,13,20/06/2023,0,0,1,1,10,0,3,13,0,4,4,8,0,0,0,0,0,1,0,1
8745,147721,2023,USA,Brazil,0,0,0,0,11/06/2023,0,0,0,0,0,0,0,0,0,0,0,0,0,0,0,0,0,0,0,0
8746,147721,2023,Canada,USA,2,2,12,16,11/06/2023,0,0,1,1,4,0,3,7,1,1,3,5,0,0,0,0,2,0,0,2
8747,147721,2023,Italy,USA,0,0,0,0,08/06/2023,0,0,0,0,0,0,0,0,0,0,0,0,0,0,0,0,0,0,0,0
8748,147721,2023,USA,Netherlands,0,1,15,16,07/06/2023,0,0,0,0,5,0,4,9,0,2,3,5,1,0,0,1,2,1,1,4
8749,139254,2023,Poland,USA,1,3,12,16,23/07/2023,0,0,4,4,13,3,7,23,0,6,0,6,6,1,13,20,7,4,1,12
8750,139254,2023,USA,Italy,0,2,9,11,22/07/2023,0,1,2,3,8,4,5,17,3,1,7,11,2,2,16,20,6,3,2,11
8751,139254,2023,USA,France,0,4,7,11,19/07/2023,0,0,5,5,10,5,8,23,2,2,8,12,5,2,13,20,6,1,0,7
8752,139254,2023,USA,Bulgaria,0,0,0,0,10/07/2023,0,0,0,0,0,0,0,0,0,0,0,0,0,0,0,0,0,0,0,0
8753,139254,2023,USA,France,0,4,9,13,09/07/2023,0,0,4,4,9,7,6,22,2,1,3,6,4,1,11,16,1,0,0,1
8754,139254,2023,USA,Argentina,2,4,18,24,08/07/2023,0,0,6,6,22,7,12,41,1,3,4,8,8,3,29,40,8,2,0,10
8755,139254,2023,USA,Cuba,1,4,7,12,06/07/2023,0,0,4,4,7,0,6,13,1,2,0,3,4,1,8,13,2,0,1,3
8756,139254,2023,Poland,USA,2,5,4,11,24/06/2023,0,0,2,2,14,2,10,26,1,3,2,6,3,1,14,18,5,2,0,7
8757,139254,2023,Iran,USA,0,0,0,0,23/06/2023,0,0,0,0,0,0,0,0,0,0,0,0,0,0,0,0,0,0,0,0
8758,139254,2023,USA,China,0,2,7,9,21/06/2023,0,0,4,4,11,1,3,15,0,3,0,3,4,4,15,23,3,1,0,4
8759,139254,2023,USA,Serbia,2,7,12,21,20/06/2023,0,1,1,2,14,5,11,30,1,5,5,11,6,2,23,31,7,1,0,8
8760,139254,2023,USA,Brazil,1,2,4,7,11/06/2023,0,0,2,2,7,3,5,15,0,1,2,3,3,1,18,22,2,0,1,3
8761,139254,2023,Canada,USA,0,4,7,11,11/06/2023,0,0,4,4,9,5,5,19,0,4,3,7,3,0,22,25,5,0,1,6
8762,139254,2023,Italy,USA,4,2,10,16,08/06/2023,0,0,4,4,9,1,5,15,2,3,1,6,4,1,5,10,7,1,0,8
8763,139254,2023,USA,Netherlands,3,3,3,9,07/06/2023,0,0,2,2,10,2,8,20,0,1,1,2,6,0,9,15,4,0,2,6
8764,170104,2023,Poland,USA,0,0,0,0,23/07/2023,0,0,1,1,1,1,0,2,0,0,0,0,0,0,0,0,1,0,0,1
8765,170104,2023,USA,Italy,0,0,0,0,22/07/2023,0,0,0,0,0,0,0,0,0,0,0,0,0,0,0,0,0,0,0,0
8766,170104,2023,USA,France,0,1,0,1,19/07/2023,0,0,0,0,0,0,0,0,0,0,0,0,0,0,0,0,0,0,0,0
8767,170104,2023,Poland,USA,0,1,1,2,24/06/2023,0,0,0,0,0,0,0,0,0,0,0,0,0,0,0,0,0,0,0,0
8768,170104,2023,Iran,USA,1,1,1,3,23/06/2023,0,0,0,0,0,0,0,0,0,0,0,0,0,0,0,0,0,0,0,0
8769,170104,2023,USA,China,0,2,11,13,21/06/2023,0,0,0,0,10,1,7,18,1,1,2,4,0,0,0,0,4,3,1,8
8770,170104,2023,USA,Serbia,0,0,0,0,20/06/2023,0,0,0,0,0,0,0,0,0,0,0,0,0,0,0,0,0,0,0,0
8771,170104,2023,USA,Brazil,3,4,6,13,11/06/2023,0,0,0,0,8,7,7,22,0,3,1,4,0,0,0,0,4,4,0,8
8772,170104,2023,Canada,USA,0,0,0,0,11/06/2023,0,0,0,0,0,0,0,0,0,0,0,0,0,0,0,0,0,0,0,0
8773,170104,2023,Italy,USA,0,0,0,0,08/06/2023,0,0,0,0,0,0,2,2,0,0,0,0,0,0,0,0,0,0,0,0
8774,170104,2023,USA,Netherlands,2,2,8,12,07/06/2023,0,0,0,0,8,3,8,19,2,2,1,5,0,0,0,0,4,3,3,10
8775,142445,2023,Poland,USA,0,0,0,0,23/07/2023,0,0,0,0,0,0,0,0,0,0,0,0,0,0,0,0,0,0,0,0
8776,142445,2023,USA,Italy,0,0,0,0,22/07/2023,0,0,0,0,0,0,0,0,0,0,0,0,0,0,0,0,0,0,0,0
8777,142445,2023,USA,France,0,0,0,0,19/07/2023,0,0,0,0,0,0,0,0,0,0,0,0,0,0,0,0,0,0,0,0
8778,142445,2023,Poland,USA,0,0,0,0,24/06/2023,0,0,0,0,0,0,0,0,0,0,0,0,0,0,0,0,0,0,0,0
8779,142445,2023,Iran,USA,0,0,0,0,23/06/2023,0,0,0,0,0,0,0,0,0,0,0,0,0,0,0,0,0,0,0,0
8780,142445,2023,USA,China,0,0,0,0,21/06/2023,0,0,4,4,0,0,0,0,0,0,0,0,2,0,3,5,1,2,0,3
8781,142445,2023,USA,Serbia,0,0,0,0,20/06/2023,0,0,0,0,0,0,0,0,0,0,0,0,0,0,0,0,0,0,0,0
8782,124879,2023,Poland,USA,0,2,12,14,23/07/2023,28,0,60,88,0,0,1,1,0,0,3,3,0,0,0,0,2,2,1,5
8783,124879,2023,USA,Italy,0,0,10,10,22/07/2023,23,0,44,67,1,0,1,2,2,1,4,7,0,0,2,2,3,2,0,5
8784,124879,2023,USA,France,1,2,20,23,19/07/2023,49,0,52,101,0,0,1,1,0,5,2,7,0,0,1,1,12,3,1,16
8785,124879,2023,USA,Bulgaria,0,0,0,0,10/07/2023,0,0,0,0,0,0,0,0,0,0,0,0,0,0,0,0,0,0,0,0
8786,124879,2023,USA,France,0,1,12,13,09/07/2023,22,0,38,60,0,0,2,2,3,2,4,9,0,0,1,1,6,1,1,8
8787,124879,2023,USA,Argentina,0,2,21,23,08/07/2023,38,0,86,124,1,1,1,3,0,5,2,7,0,0,0,0,10,3,1,14
8788,124879,2023,USA,Cuba,0,2,6,8,06/07/2023,25,0,30,55,1,0,0,1,1,0,1,2,0,1,0,1,2,0,0,2
8789,124879,2023,Poland,USA,1,1,13,15,24/06/2023,16,1,43,60,1,0,1,2,4,4,4,12,0,0,0,0,4,0,3,7
8790,124879,2023,Iran,USA,0,2,8,10,23/06/2023,23,0,32,55,0,0,0,0,2,0,0,2,0,0,0,0,4,2,0,6
8791,124879,2023,USA,China,0,0,1,1,21/06/2023,5,0,2,7,0,0,0,0,0,1,0,1,0,0,0,0,1,0,1,2
8792,124879,2023,USA,Serbia,0,0,10,10,20/06/2023,35,0,47,82,0,1,3,4,0,2,2,4,0,0,0,0,7,5,1,13
8793,124879,2023,USA,Brazil,0,0,0,0,11/06/2023,1,0,0,1,0,0,0,0,0,0,0,0,0,0,0,0,0,0,0,0
8794,124879,2023,Canada,USA,0,0,14,14,11/06/2023,17,1,57,75,0,0,1,1,0,3,1,4,0,0,0,0,3,4,0,7
8795,124879,2023,Italy,USA,1,1,9,11,08/06/2023,16,1,35,52,1,0,2,3,1,2,4,7,0,0,1,1,0,2,1,3
8796,124879,2023,USA,Netherlands,1,0,12,13,07/06/2023,27,0,36,63,1,0,0,1,2,0,2,4,0,0,0,0,8,2,0,10
8797,118901,2023,Poland,USA,0,1,6,7,23/07/2023,0,0,0,0,4,1,3,8,3,2,3,8,0,0,1,1,0,0,1,1
8798,118901,2023,USA,Italy,0,2,10,12,22/07/2023,0,0,4,4,3,1,3,7,1,5,6,12,2,0,0,2,1,2,0,3
8799,118901,2023,USA,France,1,3,9,13,19/07/2023,0,0,1,1,6,1,4,11,2,6,6,14,0,0,2,2,4,0,0,4
8800,118901,2023,USA,Bulgaria,0,0,0,0,10/07/2023,0,0,0,0,0,0,0,0,0,0,0,0,0,0,0,0,0,0,0,0
8801,118901,2023,USA,France,1,1,10,12,09/07/2023,0,0,4,4,4,0,4,8,0,5,7,12,0,0,0,0,0,0,2,2
8802,118901,2023,USA,Argentina,0,5,12,17,08/07/2023,0,0,2,2,11,1,3,15,2,7,5,14,0,0,1,1,1,0,1,2
8803,118901,2023,USA,Cuba,1,2,9,12,06/07/2023,0,0,0,0,4,1,0,5,1,2,3,6,1,0,0,1,1,0,0,1
8804,118901,2023,Poland,USA,1,2,10,13,24/06/2023,0,0,0,0,4,1,0,5,0,2,3,5,0,0,1,1,1,1,0,2
8805,118901,2023,Iran,USA,0,0,0,0,23/06/2023,0,0,0,0,0,0,0,0,0,0,0,0,0,0,0,0,0,0,0,0
8806,118901,2023,USA,China,4,5,15,24,21/06/2023,0,0,0,0,5,0,1,6,1,3,5,9,0,0,1,1,1,1,0,2
8807,118901,2023,USA,Serbia,0,0,0,0,20/06/2023,0,0,0,0,0,0,0,0,0,0,0,0,0,0,0,0,0,0,0,0
8808,118901,2023,USA,Brazil,0,5,11,16,11/06/2023,0,0,1,1,5,1,4,10,0,6,5,11,0,0,0,0,3,1,0,4
8809,118901,2023,Canada,USA,0,0,0,0,11/06/2023,0,0,0,0,0,0,0,0,0,0,0,0,0,0,0,0,0,0,0,0
8810,118901,2023,Italy,USA,1,2,6,9,08/06/2023,0,0,0,0,7,0,1,8,2,1,4,7,0,0,0,0,4,0,0,4
8811,118901,2023,USA,Netherlands,0,0,0,0,07/06/2023,0,0,0,0,0,0,0,0,0,0,0,0,0,0,0,0,0,0,0,0
8812,147421,2023,Poland,USA,0,0,0,0,23/07/2023,3,0,2,5,0,0,1,1,1,1,0,2,0,0,0,0,0,0,0,0
8813,147421,2023,USA,Italy,0,0,0,0,22/07/2023,0,0,0,0,0,0,0,0,0,0,0,0,0,0,0,0,0,0,0,0
8814,147421,2023,USA,France,0,0,3,3,19/07/2023,0,0,0,0,0,0,0,0,0,0,0,0,0,0,0,0,2,0,0,2
8815,147421,2023,USA,Bulgaria,1,5,7,13,10/07/2023,17,1,56,74,2,0,2,4,2,1,4,7,0,0,0,0,5,0,0,5
8816,147421,2023,USA,France,0,0,0,0,09/07/2023,0,0,0,0,0,0,0,0,0,0,0,0,0,0,0,0,0,0,0,0
8817,147421,2023,USA,Argentina,0,0,2,2,08/07/2023,0,0,0,0,0,0,0,0,0,0,0,0,0,0,0,0,0,0,0,0
8818,147421,2023,USA,Cuba,0,0,0,0,06/07/2023,0,0,0,0,0,0,0,0,0,0,0,0,0,0,0,0,0,0,0,0
8819,147421,2023,USA,Brazil,0,2,11,13,11/06/2023,24,1,68,93,3,1,0,4,1,3,3,7,0,0,0,0,6,2,2,10
8820,147421,2023,Canada,USA,0,0,0,0,11/06/2023,0,0,0,0,0,0,0,0,0,0,0,0,0,0,0,0,0,0,0,0
8821,147421,2023,Italy,USA,0,0,0,0,08/06/2023,0,0,1,1,0,0,0,0,0,0,0,0,0,0,0,0,0,0,0,0
8822,147421,2023,USA,Netherlands,0,0,0,0,07/06/2023,0,0,0,0,0,0,0,0,0,0,0,0,0,0,0,0,0,0,0,0
8823,143682,2023,Poland,USA,0,1,10,11,23/07/2023,0,0,2,2,7,3,5,15,2,0,0,2,2,4,8,14,5,5,0,10
8824,143682,2023,USA,Italy,2,2,9,13,22/07/2023,0,0,3,3,12,3,11,26,2,0,2,4,2,2,3,7,10,2,1,13
8825,143682,2023,USA,France,0,4,16,20,19/07/2023,0,1,3,4,14,5,11,30,2,3,0,5,7,1,20,28,9,1,1,11
8826,143682,2023,USA,Bulgaria,0,5,9,14,10/07/2023,0,0,2,2,10,2,13,25,2,0,1,3,3,0,18,21,10,1,1,12
8827,143682,2023,USA,France,0,0,0,0,09/07/2023,0,0,0,0,0,0,0,0,0,0,0,0,0,0,0,0,0,0,0,0
8828,143682,2023,USA,Argentina,2,4,11,17,08/07/2023,0,0,4,4,15,4,18,37,1,2,2,5,11,0,24,35,10,2,1,13
8829,143682,2023,USA,Cuba,0,1,0,1,06/07/2023,0,0,0,0,3,0,0,3,0,0,1,1,0,0,0,0,0,0,0,0
8830,143682,2023,Poland,USA,0,0,0,0,24/06/2023,0,0,0,0,0,0,0,0,0,0,0,0,0,0,0,0,0,0,0,0
8831,143682,2023,Iran,USA,2,2,7,11,23/06/2023,0,0,0,0,7,3,6,16,0,0,1,1,7,1,7,15,1,2,0,3
8832,143682,2023,USA,China,1,3,8,12,21/06/2023,0,0,5,5,12,0,7,19,2,5,1,8,4,1,19,24,5,3,0,8
8833,143682,2023,USA,Serbia,0,0,0,0,20/06/2023,0,0,0,0,0,0,0,0,0,0,0,0,0,0,0,0,0,0,0,0
8834,133463,2023,Poland,USA,0,0,0,0,23/07/2023,0,0,0,0,1,0,2,3,0,0,0,0,1,0,2,3,0,0,0,0
8835,133463,2023,USA,Italy,0,0,0,0,22/07/2023,0,0,0,0,0,0,0,0,0,0,0,0,0,0,0,0,0,0,0,0
8836,133463,2023,USA,France,0,0,6,6,19/07/2023,0,0,2,2,4,1,4,9,0,0,3,3,1,0,6,7,2,1,1,4
8837,133463,2023,USA,Bulgaria,0,2,9,11,10/07/2023,0,0,6,6,13,3,8,24,1,2,0,3,3,0,17,20,4,1,1,6
8838,133463,2023,USA,France,0,0,0,0,09/07/2023,0,0,0,0,0,0,0,0,0,0,0,0,0,0,0,0,2,0,0,2
8839,133463,2023,USA,Argentina,0,0,0,0,08/07/2023,0,0,0,0,0,0,0,0,0,0,0,0,0,0,0,0,0,0,0,0
8840,133463,2023,USA,Cuba,0,0,0,0,06/07/2023,0,0,0,0,0,0,0,0,0,0,0,0,0,0,0,0,0,0,0,0
8841,133463,2023,USA,Brazil,0,0,6,6,11/06/2023,0,0,0,0,3,2,5,10,1,1,0,2,1,1,4,6,3,1,0,4
8842,133463,2023,Canada,USA,0,0,0,0,11/06/2023,0,0,0,0,0,0,0,0,0,0,0,0,0,0,0,0,0,0,0,0
8843,133463,2023,Italy,USA,2,1,15,18,08/06/2023,0,0,1,1,7,1,4,12,0,2,1,3,2,0,13,15,4,0,0,4
8844,133463,2023,USA,Netherlands,0,0,0,0,07/06/2023,0,0,0,0,0,0,0,0,0,0,0,0,0,0,0,0,0,0,0,0
8845,148120,2023,Poland,USA,1,1,2,4,23/07/2023,0,0,0,0,1,0,0,1,0,2,2,4,0,0,0,0,2,0,1,3
8846,148120,2023,USA,Italy,0,0,0,0,22/07/2023,0,0,0,0,0,0,0,0,0,0,0,0,0,0,0,0,0,0,0,0
8847,148120,2023,USA,France,0,2,6,8,19/07/2023,0,0,0,0,5,2,4,11,1,6,3,10,0,0,0,0,1,1,0,2
8848,148120,2023,USA,Bulgaria,1,1,6,8,10/07/2023,0,1,1,2,0,0,1,1,1,1,0,2,0,0,1,1,0,0,0,0
8849,148120,2023,USA,France,1,2,10,13,09/07/2023,0,0,1,1,7,0,1,8,1,3,2,6,0,0,1,1,0,0,0,0
8850,148120,2023,USA,Argentina,0,0,0,0,08/07/2023,0,0,0,0,0,0,0,0,0,0,0,0,0,0,0,0,0,0,0,0
8851,148120,2023,USA,Cuba,0,0,0,0,06/07/2023,0,0,0,0,0,0,0,0,0,0,0,0,0,0,0,0,0,0,0,0
8852,148120,2023,Poland,USA,0,0,0,0,24/06/2023,0,0,0,0,0,0,0,0,0,0,0,0,0,0,0,0,0,0,0,0
8853,148120,2023,Iran,USA,1,2,4,7,23/06/2023,0,0,2,2,10,0,3,13,2,1,2,5,0,0,0,0,1,1,2,4
8854,148120,2023,USA,China,1,4,4,9,21/06/2023,0,0,0,0,9,0,2,11,0,3,2,5,0,0,0,0,1,1,0,2
8855,148120,2023,USA,Serbia,0,0,0,0,20/06/2023,0,0,0,0,0,0,0,0,0,0,0,0,0,0,0,0,0,0,0,0
8856,148120,2023,USA,Brazil,0,3,10,13,11/06/2023,0,0,0,0,6,0,3,9,0,0,4,4,0,0,0,0,3,0,0,3
8857,148120,2023,Canada,USA,0,0,0,0,11/06/2023,0,0,0,0,0,0,0,0,0,0,0,0,0,0,0,0,0,0,0,0
8858,148120,2023,Italy,USA,1,2,11,14,08/06/2023,0,0,1,1,5,0,1,6,2,4,4,10,0,0,0,0,0,0,0,0
8859,148120,2023,USA,Netherlands,0,0,0,0,07/06/2023,0,0,0,0,0,0,0,0,0,0,0,0,0,0,0,0,0,0,0,0
8860,116069,2023,Poland,USA,0,2,14,16,23/07/2023,0,1,0,1,6,0,5,11,0,4,2,6,0,0,1,1,3,1,3,7
8861,116069,2023,USA,Italy,1,1,13,15,22/07/2023,0,0,2,2,3,0,4,7,2,2,6,10,0,0,1,1,3,0,1,4
8862,116069,2023,USA,France,1,0,5,6,19/07/2023,0,0,1,1,2,0,1,3,1,5,2,8,0,0,0,0,0,2,0,2
8863,116069,2023,USA,Bulgaria,0,2,9,11,10/07/2023,0,0,1,1,5,0,1,6,1,3,2,6,1,0,1,2,3,2,0,5
8864,116069,2023,USA,France,0,0,0,0,09/07/2023,0,0,0,0,0,0,0,0,0,0,0,0,0,0,0,0,0,0,0,0
8865,116069,2023,USA,Argentina,0,4,7,11,08/07/2023,0,0,3,3,5,2,4,11,3,7,6,16,0,0,0,0,0,0,2,2
8866,116069,2023,USA,Cuba,1,2,6,9,06/07/2023,0,0,2,2,5,0,1,6,2,0,2,4,0,0,0,0,1,0,0,1
8867,116069,2023,Poland,USA,0,0,0,0,24/06/2023,0,0,0,0,0,0,0,0,0,0,0,0,0,0,0,0,0,0,0,0
8868,116069,2023,Iran,USA,2,3,9,14,23/06/2023,0,0,1,1,1,0,3,4,3,2,2,7,0,0,0,0,2,1,0,3
8869,116069,2023,USA,China,0,0,0,0,21/06/2023,0,0,0,0,0,0,0,0,0,0,0,0,0,0,0,0,0,0,0,0
8870,116069,2023,USA,Serbia,0,4,9,13,20/06/2023,0,0,2,2,3,2,4,9,6,6,8,20,0,0,0,0,6,2,0,8
8871,116069,2023,USA,Brazil,0,0,0,0,11/06/2023,0,0,0,0,0,0,0,0,0,0,0,0,0,0,0,0,0,0,0,0
8872,116069,2023,Canada,USA,1,1,6,8,11/06/2023,0,0,0,0,3,2,2,7,2,3,3,8,0,0,0,0,5,1,0,6
8873,116069,2023,Italy,USA,0,0,0,0,08/06/2023,0,0,0,0,0,0,0,0,0,0,0,0,0,0,0,0,0,0,0,0
8874,116069,2023,USA,Netherlands,0,5,7,12,07/06/2023,0,0,3,3,8,0,1,9,2,1,4,7,0,0,0,0,4,0,0,4
8875,119732,2023,Poland,USA,0,0,0,0,23/07/2023,0,0,4,4,0,0,0,0,0,0,0,0,6,1,13,20,4,4,1,9
8876,119732,2023,USA,Italy,0,0,0,0,22/07/2023,0,0,6,6,0,0,0,0,0,0,0,0,3,0,8,11,10,2,1,13
8877,119732,2023,USA,France,0,0,0,0,19/07/2023,0,0,10,10,0,0,0,0,0,0,0,0,3,3,13,19,10,10,0,20
8878,119732,2023,USA,Bulgaria,0,0,0,0,10/07/2023,0,0,4,4,0,0,0,0,0,0,0,0,2,1,6,9,5,4,0,9
8879,119732,2023,USA,France,0,0,0,0,09/07/2023,0,0,4,4,0,0,0,0,0,0,0,0,4,0,11,15,4,3,3,10
8880,119732,2023,USA,Argentina,0,0,0,0,08/07/2023,0,1,6,7,0,0,0,0,0,0,0,0,10,1,16,27,3,2,2,7
8881,119732,2023,USA,Cuba,0,0,0,0,06/07/2023,0,0,0,0,0,0,0,0,0,0,0,0,7,0,12,19,7,2,2,11
8882,119732,2023,Poland,USA,0,0,0,0,24/06/2023,0,0,8,8,0,0,0,0,0,0,0,0,2,0,10,12,1,1,0,2
8883,119732,2023,Iran,USA,0,0,0,0,23/06/2023,0,0,7,7,0,0,0,0,0,0,0,0,4,0,9,13,6,5,0,11
8884,119732,2023,USA,China,0,0,0,0,21/06/2023,0,0,0,0,0,0,0,0,0,0,0,0,0,0,0,0,0,0,0,0
8885,119732,2023,USA,Serbia,0,0,0,0,20/06/2023,0,0,8,8,0,0,0,0,0,0,0,0,5,1,7,13,8,3,0,11
8886,119732,2023,USA,Brazil,0,0,0,0,11/06/2023,0,0,7,7,0,0,0,0,0,0,0,0,3,0,14,17,3,3,2,8
8887,119732,2023,Canada,USA,0,0,0,0,11/06/2023,0,0,1,1,0,0,0,0,0,0,0,0,4,1,11,16,8,3,2,13
8888,119732,2023,Italy,USA,0,0,0,0,08/06/2023,0,0,3,3,0,0,0,0,0,0,0,0,2,3,8,13,10,2,1,13
8889,119732,2023,USA,Netherlands,0,0,0,0,07/06/2023,0,0,6,6,0,0,0,0,0,0,0,0,2,2,7,11,5,0,0,5
